1124, 1125, 1126, 1127, 1128, 1129, 1130, 1124, 1125, 1126, 1127, 1128, 1129, 1130, 1131, 1156, 1157, 1158, 1159, 1160, 1161, 1162, 1124, 1125, 1126, 1127, 1128, 1129, 1130, 1131, 1156, 1157, 1158, 1159, 1160, 1161, 1162, 1163, 1124, 1125, 1126, 1127, 1128, 1129, 1130, 1131, 1156, 1157, 1158, 1159, 1160, 1161, 1162, 1163, 1124, 1125, 1126, 1127, 1128, 1129, 1130, 1131, 1156, 1157, 1158, 1159, 1160, 1161, 1162, 1163, 1124, 1125, 1102, 1102, 1102, 1102, 1102, 1102, 1102, 1102
1156, 1157, 1158, 1159, 1160, 1161, 1162, 1126, 1127, 1128, 1129, 1130, 1131, 1156, 1157, 1158, 1159, 1160, 1161, 1162, 1163, 1124, 1126, 1127, 1128, 1129, 1130, 1131, 1156, 1157, 1158, 1159, 1160, 1161, 1162, 1163, 1124, 1125, 1126, 1127, 1128, 1129, 1130, 1131, 1156, 1157, 1158, 1159, 1160, 1161, 1162, 1163, 1124, 1125, 1126, 1127, 1128, 1129, 1130, 1131, 1156, 1157, 1158, 1159, 1160, 1161, 1162, 1163, 1124, 1125, 1126, 1127, 1102, 1102, 1102, 1102, 1102, 1102, 1102, 1102
1124, 1125, 1126, 1127, 1128, 1129, 1130, 1128, 1129, 1130, 1131, 1156, 1157, 1158, 1159, 1160, 1161, 1162, 1163, 1124, 1125, 1126, 1128, 1129, 1130, 1131, 1156, 1157, 1158, 1159, 1160, 1161, 1162, 1163, 1124, 1125, 1126, 1127, 1128, 1129, 1130, 1131, 1156, 1157, 1158, 1159, 1160, 1161, 1162, 1163, 1124, 1125, 1126, 1127, 1128, 1129, 1130, 1131, 1156, 1157, 1158, 1159, 1160, 1161, 1162, 1163, 1124, 1125, 1126, 1127, 1128, 1129, 1102, 1102, 1102, 1102, 1102, 1102, 1102, 1102
1156, 1157, 1158, 1159, 1160, 1161, 1162, 1130, 1131, 1156, 1157, 1158, 1159, 1160, 1161, 1162, 1163, 1124, 1125, 1126, 1127, 1128, 1130, 1131, 1156, 1157, 1158, 1159, 1160, 1161, 1162, 1163, 1124, 1125, 1126, 1127, 1128, 1129, 1130, 1131, 1156, 1157, 1158, 1159, 1160, 1161, 1162, 1163, 1124, 1125, 1126, 1127, 1128, 1129, 1130, 1131, 1156, 1157, 1158, 1159, 1160, 1161, 1162, 1163, 1124, 1125, 1126, 1127, 1128, 1129, 1130, 1131, 1102, 1102, 1102, 1102, 1102, 1102, 1102, 1102
1124, 1125, 1126, 1127, 1128, 1129, 1130, 1156, 1157, 1158, 1159, 1160, 1161, 1162, 1163, 1124, 1125, 1126, 1127, 1128, 1129, 1130, 1156, 1157, 1158, 1159, 1160, 1161, 1162, 1163, 1124, 1125, 1126, 1127, 1128, 1129, 1130, 1131, 1156, 1157, 1158, 1159, 1160, 1161, 1162, 1163, 1124, 1125, 1126, 1127, 1128, 1129, 1130, 1131, 1156, 1157, 1158, 1159, 1160, 1161, 1162, 1163, 1124, 1125, 1126, 1127, 1128, 1129, 1130, 1131, 1156, 1157, 1102, 1102, 1102, 1102, 1102, 1102, 1102, 1102
1156, 1157, 1158, 1159, 1160, 1161, 1162, 1158, 1159, 1160, 1161, 1162, 1163, 1124, 1125, 1126, 1127, 1128, 1129, 1130, 1131, 1156, 1158, 1159, 1160, 1161, 1162, 1163, 1124, 1125, 1126, 1127, 1128, 1129, 1130, 1131, 1156, 1157, 1158, 1159, 1160, 1161, 1162, 1163, 1124, 1125, 1126, 1127, 1128, 1129, 1130, 1131, 1156, 1157, 1158, 1159, 1160, 1161, 1162, 1163, 1124, 1125, 1126, 1127, 1128, 1129, 1130, 1131, 1156, 1157, 1158, 1159, 1102, 1102, 1102, 1102, 1102, 1102, 1102, 1102
1124, 1125, 1126, 1127, 1128, 1129, 1130, 1160, 1161, 1162, 1163, 1124, 1125, 1126, 1127, 1128, 1129, 1130, 1131, 1156, 1157, 1158, 1160, 1161, 1162, 1163, 1124, 1125, 1126, 1127, 1128, 1129, 1130, 1131, 1156, 1157, 1158, 1159, 1160, 1161, 1162, 1163, 1124, 1125, 1126, 1127, 1128, 1129, 1130, 1131, 1156, 1157, 1158, 1159, 1160, 1161, 1162, 1163, 1124, 1125, 1126, 1127, 1128, 1129, 1130, 1131, 1156, 1157, 1158, 1159, 1160, 1161, 1102, 1102, 1102, 1102, 1102, 1102, 1102, 1102
1156, 1157, 1158, 1159, 1160, 1161, 1162, 1162, 1163, 1124, 1125, 1126, 1127, 1128, 1129, 1130, 1131, 1156, 1157, 1158, 1159, 1160, 1162, 1163, 1124, 1125, 1126, 1127, 1128, 1129, 1130, 1131, 1156, 1157, 1158, 1159, 1160, 1161, 1162, 1163, 1124, 1125, 1126, 1127, 1128, 1129, 1130, 1131, 1156, 1157, 1158, 1159, 1160, 1161, 1162, 1163, 1124, 1125, 1126, 1127, 1128, 1129, 1130, 1131, 1156, 1157, 1158, 1159, 1160, 1161, 1162, 1163, 1102, 1102, 1102, 1102, 1102, 1102, 1102, 1102
1102, 1089, 1093, 1093, 1093, 1093, 1093, 1093, 1093, 1093, 1093, 1093, 1093, 1093, 1093, 1053, 1053, 1093, 1093, 1093, 1093, 1093, 1093, 1093, 1093, 1093, 1093, 1093, 1093, 1093, 1093, 1093, 1093, 1093, 1093, 1093, 1093, 1093, 1093, 1093, 1093, 1093, 1093, 1093, 1093, 1093, 1053, 1053, 1093, 1093, 1093, 1093, 1093, 1093, 1093, 1093, 1093, 1093, 1093, 1093, 1093, 1093, 1093, 1093, 1093, 1093, 1093, 1093, 1093, 1093, 1093, 1100, 1102, 1102, 1102, 1102, 1102, 1102, 1102, 1102
1102, 1103, 1028, 1028, 1028, 1028, 1028, 1028, 1028, 1053, 1053, 38, 39, 40, 41, 1052, 1052, 44, 45, 46, 47, 48, 49, 50, 51, 259, 260, 256, 257, 130, 131, 132, 1053, 1053, 201, 202, 203, 204, 205, 206, 1053, 1053, 201, 201, 201, 201, 1052, 1052, 201, 201, 201, 201, 230, 231, 232, 233, 234, 235, 236, 259, 260, 261, 262, 263, 264, 265, 266, 267, 268, 274, 275, 1106, 1102, 1102, 1102, 1102, 1102, 1102, 1102, 1102
1102, 1103, 1028, 1028, 1028, 1028, 1028, 1028, 1028, 1053, 1053, 70, 71, 72, 73, 74, 75, 76, 77, 78, 79, 80, 81, 82, 83, 291, 292, 288, 0, 1, 2, 3, 1053, 1053, 233, 234, 235, 236, 237, 238, 1053, 1053, 201, 201, 201, 201, 201, 201, 201, 201, 201, 201, 294, 295, 296, 297, 298, 299, 300, 323, 324, 325, 326, 327, 328, 329, 330, 331, 332, 306, 307, 1106, 1102, 1102, 1102, 1102, 1102, 1102, 1102, 1102
1102, 1103, 1028, 1028, 1028, 1028, 1028, 1028, 1028, 1053, 1053, 102, 103, 104, 105, 106, 107, 108, 109, 110, 111, 112, 113, 114, 115, 323, 324, 320, 32, 33, 34, 35, 1053, 1053, 265, 266, 267, 268, 269, 270, 1053, 1053, 46, 201, 202, 203, 204, 205, 206, 355, 201, 202, 203, 204, 205, 206, 362, 363, 364, 387, 388, 389, 390, 391, 392, 393, 394, 395, 396, 338, 339, 1106, 1102, 1102, 1102, 1102, 1102, 1102, 1102, 1102
1102, 1103, 1028, 1028, 1028, 1028, 1028, 1028, 1028, 1053, 1053, 134, 135, 136, 137, 138, 139, 140, 141, 142, 143, 144, 145, 0, 1, 2, 3, 4, 64, 65, 66, 67, 1053, 1053, 297, 298, 299, 300, 301, 302, 1053, 1053, 201, 233, 234, 235, 236, 237, 238, 201, 233, 234, 235, 236, 237, 238, 106, 107, 108, 131, 132, 133, 134, 135, 136, 137, 138, 139, 140, 370, 371, 1106, 1102, 1102, 1102, 1102, 1102, 1102, 1102, 1102
1102, 1103, 1028, 1028, 1028, 1028, 1028, 1028, 1028, 1053, 1053, 166, 167, 168, 169, 170, 171, 172, 173, 174, 175, 176, 177, 32, 33, 34, 35, 36, 96, 97, 98, 99, 1053, 1053, 329, 330, 331, 332, 333, 334, 1053, 1053, 201, 265, 266, 267, 268, 269, 270, 201, 265, 266, 267, 268, 269, 270, 170, 171, 172, 195, 196, 197, 198, 199, 200, 201, 202, 203, 204, 402, 403, 1106, 1102, 1102, 1102, 1102, 1102, 1102, 1102, 1102
1102, 1103, 1028, 1028, 1028, 1028, 1028, 1028, 1028, 1053, 1053, 198, 199, 200, 201, 202, 203, 204, 205, 206, 207, 208, 209, 64, 65, 66, 67, 68, 128, 129, 130, 131, 1053, 1053, 361, 362, 363, 364, 365, 366, 1053, 1053, 201, 297, 298, 299, 300, 301, 302, 201, 297, 298, 299, 300, 301, 302, 234, 235, 236, 259, 260, 261, 262, 263, 264, 265, 266, 267, 268, 434, 435, 1106, 1102, 1102, 1102, 1102, 1102, 1102, 1102, 1102
1102, 1103, 1028, 1028, 1028, 1028, 1028, 1028, 1028, 1053, 1053, 230, 231, 232, 201, 202, 203, 204, 205, 206, 239, 240, 201, 202, 203, 204, 205, 206, 104, 105, 162, 163, 1053, 1053, 100, 101, 102, 103, 104, 105, 1053, 1053, 201, 329, 330, 331, 332, 333, 334, 101, 329, 201, 202, 203, 204, 205, 206, 19, 300, 323, 324, 325, 326, 327, 328, 329, 330, 331, 332, 466, 467, 1106, 1102, 1102, 1102, 1102, 1102, 1102, 1102, 1102
1102, 1103, 1028, 1028, 1028, 1028, 1028, 1028, 1028, 1053, 1053, 262, 263, 264, 233, 234, 235, 236, 237, 238, 271, 272, 233, 234, 235, 236, 237, 238, 136, 137, 194, 195, 1053, 1053, 132, 133, 134, 135, 136, 137, 1053, 1053, 206, 361, 362, 363, 364, 365, 366, 311, 361, 233, 234, 235, 236, 237, 238, 51, 364, 387, 388, 389, 390, 391, 392, 393, 394, 395, 396, 498, 499, 1138, 1102, 1102, 1102, 1102, 1102, 1102, 1102, 1102
1102, 1103, 1028, 1028, 1028, 1028, 1028, 1028, 1028, 1053, 1053, 4, 5, 6, 265, 266, 267, 268, 269, 270, 13, 0, 265, 266, 267, 268, 269, 270, 168, 169, 213, 227, 1053, 1053, 164, 165, 166, 167, 168, 169, 1053, 1053, 101, 101, 101, 101, 340, 341, 342, 343, 344, 265, 266, 267, 268, 269, 270, 83, 108, 131, 132, 133, 134, 135, 136, 137, 138, 139, 140, 530, 531, 1074, 1105, 1102, 1102, 1102, 1102, 1102, 1102, 1102
1102, 1103, 1028, 1028, 1028, 1028, 1028, 1028, 1028, 1053, 1053, 2, 3, 4, 297, 298, 299, 300, 301, 302, 6, 7, 297, 298, 299, 300, 301, 302, 200, 201, 213, 259, 1053, 1053, 196, 197, 198, 199, 200, 201, 1053, 1053, 101, 101, 101, 101, 372, 373, 374, 375, 376, 297, 298, 299, 201, 202, 203, 204, 205, 206, 8, 9, 10, 11, 12, 13, 14, 15, 16, 17, 18, 1074, 1105, 1102, 1102, 1102, 1102, 1102, 1102, 1102
1102, 1103, 1028, 1028, 1028, 1028, 1028, 1028, 1028, 1053, 1053, 34, 35, 36, 329, 330, 331, 332, 333, 334, 38, 39, 329, 330, 331, 332, 333, 334, 232, 233, 213, 291, 1053, 1053, 228, 229, 230, 231, 232, 233, 1053, 1053, 101, 308, 309, 310, 311, 312, 313, 407, 408, 329, 330, 331, 233, 234, 235, 236, 237, 238, 40, 41, 42, 43, 44, 45, 46, 47, 48, 49, 50, 1074, 1105, 1102, 1102, 1102, 1102, 1102, 1102, 1102
1102, 1103, 1028, 1028, 1028, 1028, 1028, 1028, 1028, 1053, 1053, 66, 67, 68, 361, 362, 363, 364, 365, 366, 70, 71, 361, 362, 363, 364, 365, 366, 264, 265, 322, 323, 1053, 1053, 260, 261, 262, 263, 264, 265, 1053, 1053, 101, 340, 341, 342, 343, 344, 345, 439, 440, 361, 362, 363, 265, 266, 267, 268, 269, 270, 72, 73, 74, 75, 76, 77, 78, 79, 80, 81, 82, 1074, 1105, 1102, 1102, 1102, 1102, 1102, 1102, 1102
1102, 1103, 1028, 1028, 1028, 1028, 1028, 1028, 1028, 1053, 1053, 98, 99, 100, 101, 102, 103, 99, 100, 101, 102, 103, 35, 36, 37, 38, 39, 40, 352, 353, 354, 355, 1053, 1053, 358, 359, 242, 242, 179, 179, 1053, 1053, 101, 372, 373, 374, 375, 376, 377, 471, 472, 473, 101, 101, 297, 298, 299, 300, 301, 302, 104, 105, 106, 107, 108, 109, 110, 111, 112, 113, 114, 1074, 1105, 1102, 1102, 1102, 1102, 1102, 1102, 1102
1102, 1103, 1028, 1028, 1028, 1028, 1028, 1028, 1028, 1053, 1053, 130, 131, 132, 133, 134, 135, 131, 132, 133, 134, 135, 67, 68, 69, 70, 71, 72, 384, 385, 386, 387, 1053, 1053, 201, 202, 203, 204, 205, 206, 1053, 1053, 101, 404, 405, 406, 407, 408, 409, 101, 101, 101, 101, 101, 329, 330, 331, 332, 333, 334, 136, 201, 202, 203, 204, 205, 206, 143, 144, 145, 146, 1074, 1105, 1102, 1102, 1102, 1102, 1102, 1102, 1102
1102, 1103, 1028, 1028, 1028, 1028, 1028, 1028, 1028, 1053, 1053, 162, 163, 164, 165, 166, 167, 163, 164, 165, 166, 167, 99, 100, 101, 102, 103, 104, 416, 417, 418, 419, 1053, 1053, 233, 234, 235, 236, 237, 238, 1053, 1053, 101, 436, 437, 438, 439, 440, 441, 101, 201, 168, 160, 161, 361, 362, 363, 364, 365, 366, 168, 233, 234, 235, 236, 237, 238, 175, 176, 177, 178, 1074, 1105, 1102, 1102, 1102, 1102, 1102, 1102, 1102
1102, 1103, 1028, 1028, 1028, 1028, 1028, 1028, 1028, 1053, 1053, 100, 101, 102, 103, 104, 162, 163, 164, 165, 166, 167, 131, 132, 133, 134, 135, 136, 448, 449, 450, 451, 1053, 1053, 265, 266, 267, 268, 269, 270, 1053, 1053, 101, 468, 469, 470, 471, 472, 473, 101, 201, 200, 192, 201, 202, 203, 204, 205, 206, 199, 200, 265, 266, 267, 268, 269, 270, 207, 208, 209, 210, 1074, 1105, 1102, 1102, 1102, 1102, 1102, 1102, 1102
1102, 1103, 1028, 1028, 1028, 1028, 1028, 1028, 1028, 1053, 1053, 1053, 1053, 1053, 1053, 1053, 1053, 1053, 1053, 1053, 1053, 1053, 1053, 164, 165, 166, 167, 168, 480, 481, 482, 483, 1053, 1053, 297, 298, 299, 300, 301, 302, 1053, 1053, 1053, 1053, 1053, 1053, 1053, 1053, 1053, 1053, 1053, 232, 224, 233, 234, 235, 236, 237, 238, 1053, 1053, 1053, 1053, 1053, 1053, 1053, 1053, 1053, 1053, 1053, 1053, 1074, 1105, 1102, 1102, 1102, 1102, 1102, 1102, 1102
1102, 1103, 1028, 1028, 1028, 1028, 1028, 1028, 1028, 1053, 1053, 1053, 1053, 1053, 1053, 1053, 1053, 1053, 1053, 1053, 1053, 1053, 1053, 8, 9, 10, 11, 12, 512, 513, 514, 515, 1053, 1053, 329, 330, 331, 332, 333, 334, 1053, 1053, 1053, 1053, 1053, 1053, 1053, 1053, 1053, 1053, 1053, 264, 256, 265, 266, 267, 268, 269, 270, 1053, 1053, 1053, 1053, 1053, 1053, 1053, 1053, 1053, 1053, 1053, 1053, 1074, 1105, 1102, 1102, 1102, 1102, 1102, 1102, 1102
1102, 1103, 1028, 1028, 1028, 1028, 1028, 1028, 1028, 1028, 1028, 1028, 1028, 1028, 1028, 1028, 1028, 1028, 1028, 1028, 1028, 1028, 1028, 40, 41, 42, 43, 44, 45, 46, 47, 48, 1053, 1053, 361, 362, 363, 364, 365, 366, 201, 201, 201, 201, 201, 201, 201, 201, 201, 201, 201, 201, 288, 297, 298, 299, 300, 301, 302, 1028, 1028, 1028, 1028, 1028, 1028, 1028, 1028, 1028, 1028, 1028, 1028, 1074, 1105, 1102, 1102, 1102, 1102, 1102, 1102, 1102
1102, 1103, 1028, 1028, 1028, 1028, 1028, 1028, 1028, 1028, 1028, 1028, 1028, 1028, 1028, 1028, 1028, 1028, 1028, 1028, 1028, 1028, 1028, 72, 73, 74, 75, 76, 77, 78, 79, 80, 1053, 1053, 83, 272, 242, 201, 202, 203, 204, 205, 206, 201, 201, 202, 203, 204, 205, 206, 201, 201, 1, 329, 330, 331, 332, 333, 334, 1028, 1028, 1028, 1028, 1028, 1028, 1028, 1028, 1028, 1028, 1028, 1028, 1074, 1105, 1102, 1102, 1102, 1102, 1102, 1102, 1102
1102, 1103, 1028, 1028, 1028, 1028, 1028, 1028, 1028, 1028, 1028, 1028, 1028, 1028, 1028, 1028, 1028, 1028, 1028, 1028, 1028, 1028, 1028, 104, 105, 106, 107, 108, 109, 110, 111, 112, 1053, 1053, 201, 201, 201, 233, 234, 235, 236, 237, 238, 201, 233, 234, 235, 236, 237, 238, 359, 32, 33, 361, 362, 363, 364, 365, 366, 1028, 1028, 1028, 1028, 1028, 1028, 1028, 1028, 1028, 1028, 1028, 1028, 1074, 1105, 1102, 1102, 1102, 1102, 1102, 1102, 1102
1102, 1103, 1028, 1028, 1028, 1028, 1028, 1028, 1028, 1028, 1028, 1028, 1028, 1028, 1028, 1028, 1028, 1028, 1028, 1028, 1028, 1028, 1028, 136, 137, 138, 139, 140, 141, 142, 143, 144, 1053, 1053, 201, 201, 201, 265, 266, 267, 268, 269, 270, 201, 265, 266, 267, 268, 269, 270, 391, 64, 65, 66, 67, 68, 69, 70, 71, 1028, 1028, 1028, 1028, 1028, 1028, 1028, 1028, 1028, 1028, 1028, 1028, 1074, 1105, 1102, 1102, 1102, 1102, 1102, 1102, 1102
1102, 1103, 1028, 1028, 1028, 1028, 1028, 1028, 1028, 1028, 1028, 1028, 1028, 1028, 1028, 1028, 1028, 1028, 1028, 1028, 1028, 1028, 1028, 168, 169, 170, 171, 172, 173, 174, 175, 176, 1053, 1053, 179, 368, 242, 297, 298, 299, 300, 301, 302, 100, 297, 298, 299, 300, 301, 302, 423, 96, 97, 98, 99, 100, 101, 102, 103, 1028, 1028, 1028, 1028, 1028, 1028, 1028, 1028, 1028, 1028, 1028, 1028, 1074, 1105, 1102, 1102, 1102, 1102, 1102, 1102, 1102
1102, 1103, 1028, 1028, 1028, 1028, 1028, 1028, 1028, 1028, 1028, 1028, 1028, 1028, 1028, 1028, 1028, 1028, 1028, 1028, 1028, 1028, 1028, 200, 201, 202, 203, 204, 205, 206, 207, 208, 209, 210, 211, 400, 401, 329, 330, 331, 332, 333, 334, 132, 329, 330, 331, 332, 333, 334, 455, 128, 129, 130, 131, 132, 133, 134, 135, 1028, 1028, 1028, 1028, 1028, 1028, 1028, 1028, 1028, 1028, 1028, 1028, 1074, 1105, 1102, 1102, 1102, 1102, 1102, 1102, 1102
1102, 1103, 1028, 1028, 1028, 1028, 1028, 1028, 1028, 1028, 1028, 1028, 1028, 1028, 1028, 1028, 1028, 1028, 1028, 1028, 1028, 1028, 1028, 232, 233, 234, 235, 236, 237, 238, 239, 240, 241, 242, 243, 432, 433, 361, 362, 363, 364, 365, 366, 164, 361, 362, 363, 364, 365, 366, 487, 160, 161, 162, 163, 164, 165, 166, 167, 1028, 1028, 1028, 1028, 1028, 1028, 1028, 1028, 1028, 1028, 1028, 1028, 1074, 1105, 1102, 1102, 1102, 1102, 1102, 1102, 1102
1102, 1103, 1028, 1028, 1028, 1028, 1028, 1028, 1028, 1028, 1028, 1028, 1028, 1028, 1028, 1028, 1028, 1028, 1028, 1028, 1028, 1028, 1028, 264, 265, 266, 267, 268, 269, 270, 271, 272, 273, 274, 275, 464, 465, 466, 467, 192, 100, 101, 102, 103, 104, 105, 199, 200, 201, 101, 519, 192, 201, 202, 203, 204, 205, 206, 199, 1028, 1028, 1028, 1028, 1028, 1028, 1028, 1028, 1028, 1028, 1028, 1028, 1074, 1105, 1102, 1102, 1102, 1102, 1102, 1102, 1102
1102, 1103, 1028, 1028, 1028, 1028, 1028, 1028, 1028, 1028, 1028, 1028, 1028, 1028, 1028, 1028, 1028, 1028, 1028, 1028, 1028, 1028, 1028, 296, 297, 298, 299, 300, 301, 302, 303, 304, 305, 306, 307, 496, 497, 498, 499, 224, 132, 133, 134, 135, 136, 137, 231, 232, 233, 104, 105, 224, 233, 234, 235, 236, 237, 238, 231, 1028, 1028, 1028, 1028, 1028, 1028, 1028, 1028, 1028, 1028, 1028, 1028, 1074, 1105, 1102, 1102, 1102, 1102, 1102, 1102, 1102
1102, 1103, 1028, 1028, 1028, 1028, 1028, 1028, 1028, 1028, 1028, 1028, 1028, 1028, 1028, 1028, 1028, 1028, 1028, 1028, 1028, 1028, 1028, 102, 103, 104, 105, 332, 333, 334, 335, 336, 337, 338, 339, 528, 529, 530, 531, 256, 164, 165, 166, 167, 168, 169, 263, 264, 265, 136, 137, 256, 265, 266, 267, 268, 269, 270, 263, 1028, 1028, 1028, 1028, 1028, 1028, 1028, 1028, 1028, 1028, 1028, 1028, 1074, 1105, 1102, 1102, 1102, 1102, 1102, 1102, 1102
1102, 1103, 1028, 1028, 1028, 1028, 1028, 1028, 1028, 1028, 1028, 1028, 1028, 1028, 1028, 1028, 1028, 1028, 1028, 1028, 1028, 1028, 1028, 134, 135, 136, 137, 364, 365, 366, 367, 368, 369, 370, 371, 296, 297, 298, 299, 288, 196, 197, 198, 199, 200, 201, 105, 166, 167, 168, 169, 288, 297, 298, 299, 300, 301, 302, 295, 1028, 1028, 1028, 1028, 1028, 1028, 1028, 1028, 1028, 1028, 1028, 1028, 1074, 1105, 1102, 1102, 1102, 1102, 1102, 1102, 1102
1102, 1103, 1028, 1028, 1028, 1028, 1028, 1028, 1028, 1028, 1028, 1028, 1028, 1028, 1028, 1028, 1028, 1028, 1028, 1028, 1028, 1028, 1028, 166, 167, 168, 169, 396, 397, 398, 399, 400, 401, 402, 403, 360, 361, 362, 363, 320, 228, 229, 230, 231, 232, 233, 137, 198, 199, 200, 201, 320, 329, 330, 331, 332, 333, 334, 327, 1028, 1028, 1028, 1028, 1028, 1028, 1028, 1028, 1028, 1028, 1028, 1028, 1074, 1105, 1102, 1102, 1102, 1102, 1102, 1102, 1102
1102, 1103, 1028, 1028, 1028, 1028, 1028, 1028, 1028, 1028, 1028, 1028, 1028, 1028, 1028, 1028, 1028, 1028, 1028, 1028, 1028, 1028, 1028, 1028, 1028, 1028, 1028, 1028, 1028, 1028, 1028, 1028, 1028, 1028, 1028, 1028, 1028, 1028, 1028, 1028, 1028, 1028, 1028, 1028, 1028, 1028, 1028, 1028, 1028, 1028, 1028, 1028, 1028, 1028, 1028, 1028, 1028, 1028, 1028, 1028, 1028, 1028, 1028, 1028, 1028, 1028, 1028, 1028, 1028, 1028, 1028, 1074, 1105, 1102, 1102, 1102, 1102, 1102, 1102, 1102
1102, 1103, 1028, 1028, 1028, 1028, 1028, 1028, 1028, 1028, 1028, 1028, 1028, 1028, 1028, 1028, 1028, 1028, 1028, 1028, 1028, 1028, 1028, 1028, 1028, 1028, 1028, 1028, 1028, 1028, 1028, 1028, 1028, 1028, 1028, 1028, 1028, 1028, 1028, 1028, 1028, 1028, 1028, 1028, 1028, 1028, 1028, 1028, 1028, 1028, 1028, 1028, 1028, 1028, 1028, 1028, 1028, 1028, 1028, 1028, 1028, 1028, 1028, 1028, 1028, 1028, 1028, 1028, 1028, 1028, 1028, 1074, 1102, 1102, 1102, 1102, 1102, 1102, 1102, 1102
1102, 1103, 1028, 1028, 1028, 1028, 1028, 1028, 1028, 1028, 1028, 1028, 1028, 1028, 1028, 1028, 1028, 1028, 1028, 1028, 1028, 1028, 1028, 1028, 1028, 1028, 1028, 1028, 1028, 1028, 1028, 1028, 1028, 1028, 1028, 1028, 1028, 1028, 1028, 1028, 1028, 1028, 1028, 1028, 1028, 1028, 1028, 1028, 1028, 1028, 1028, 1028, 1028, 1028, 1028, 1028, 1028, 1028, 1028, 1028, 1028, 1028, 1028, 1028, 1028, 1028, 1028, 1028, 1028, 1028, 1028, 1138, 1102, 1102, 1102, 1102, 1102, 1102, 1102, 1102
1102, 1103, 1028, 1028, 1028, 1028, 1028, 1028, 1028, 1028, 1028, 1028, 1028, 1028, 1028, 1028, 1028, 1028, 1028, 1028, 1028, 1028, 1028, 1028, 1028, 1028, 1028, 1028, 1028, 1028, 1028, 1028, 1028, 1028, 1028, 1028, 1028, 1028, 1028, 1028, 1028, 1028, 1028, 1028, 1028, 1028, 1028, 1028, 1028, 1028, 1028, 1028, 1028, 1028, 1028, 1028, 1028, 1028, 1028, 1028, 1028, 1028, 1028, 1028, 1028, 1028, 1028, 1028, 1028, 1028, 1028, 1106, 1102, 1102, 1102, 1102, 1102, 1102, 1102, 1102
1102, 1103, 1028, 1028, 1028, 1028, 1028, 1028, 1028, 1028, 1028, 1028, 1028, 1028, 1028, 1028, 1028, 1028, 1028, 1028, 1028, 1028, 1028, 1028, 1028, 1028, 1028, 1028, 1028, 1028, 1028, 1028, 1028, 1028, 1028, 1028, 1028, 1028, 1028, 1028, 1028, 1028, 1028, 1028, 1028, 1028, 1028, 1028, 1028, 1028, 1028, 1028, 1028, 1028, 1028, 1028, 1028, 1028, 1028, 1028, 1028, 1028, 1028, 1028, 1028, 1028, 1028, 1028, 1028, 1028, 1028, 1106, 1102, 1102, 1102, 1102, 1102, 1102, 1102, 1102
1102, 1103, 1028, 1028, 1028, 1028, 1028, 1028, 1028, 1028, 1028, 1028, 1028, 1028, 1028, 1028, 1028, 1028, 1028, 1028, 1028, 1028, 1028, 1028, 1028, 1028, 1028, 1028, 1028, 1028, 1028, 1028, 1028, 1028, 1028, 1028, 1028, 1028, 1028, 1028, 1028, 1028, 1028, 1028, 1028, 1028, 1028, 1028, 1028, 1028, 1028, 1028, 1028, 1028, 1028, 1028, 1028, 1028, 1028, 1028, 1028, 1028, 1028, 1028, 1028, 1028, 1028, 1028, 1028, 1028, 1028, 1106, 1102, 1102, 1102, 1102, 1102, 1102, 1102, 1102
1102, 1103, 1028, 1028, 1028, 1028, 1028, 1028, 1028, 1028, 1028, 1028, 1028, 1028, 1028, 1028, 1028, 1028, 1028, 1028, 1028, 1028, 1028, 1028, 1028, 1028, 1028, 1028, 1028, 1028, 1028, 1028, 1028, 1028, 1028, 1028, 1028, 1028, 1028, 1028, 1028, 1028, 1028, 1028, 1028, 1028, 1028, 1028, 1028, 1028, 1028, 1028, 1028, 1028, 1028, 1028, 1028, 1028, 1028, 1028, 1028, 1028, 1028, 1028, 1028, 1028, 1028, 1028, 1028, 1028, 1028, 1106, 1102, 1102, 1102, 1102, 1102, 1102, 1102, 1102
1102, 1103, 1028, 1028, 1028, 1028, 1028, 1028, 1028, 1028, 1028, 1028, 1028, 1028, 1028, 1028, 1028, 1028, 1028, 1028, 1028, 1028, 1028, 1028, 1028, 1028, 1028, 1028, 1028, 1028, 1028, 1028, 1028, 1028, 1028, 1028, 1028, 1028, 1028, 1028, 1028, 1028, 1028, 1028, 1028, 1028, 1028, 1028, 1028, 1028, 1028, 1028, 1028, 1028, 1028, 1028, 1028, 1028, 1028, 1028, 1028, 1028, 1028, 1028, 1028, 1028, 1028, 1028, 1028, 1028, 1028, 1138, 1102, 1102, 1102, 1102, 1102, 1102, 1102, 1102
1102, 1103, 1028, 1028, 1028, 1028, 1028, 1028, 1028, 1028, 1028, 1028, 1028, 1028, 1028, 1028, 1028, 1028, 1028, 1028, 1028, 1028, 1028, 1028, 1028, 1028, 1028, 1028, 1028, 1028, 1028, 1028, 1028, 1028, 1028, 1028, 1028, 1028, 1028, 1028, 1028, 1028, 1028, 1028, 1028, 1028, 1028, 1028, 1028, 1028, 1028, 1028, 1028, 1028, 1028, 1028, 1028, 1028, 1028, 1028, 1028, 1028, 1028, 1028, 1028, 1028, 1028, 1028, 1028, 1028, 1028, 1138, 1102, 1102, 1102, 1102, 1102, 1102, 1102, 1102
1102, 1103, 1028, 1028, 1028, 1028, 1028, 1028, 1028, 1028, 1028, 1028, 1028, 1028, 1028, 1028, 1028, 1028, 1028, 1028, 1028, 1028, 1028, 1028, 1028, 1028, 1028, 1028, 1028, 1028, 1028, 1028, 1028, 1028, 1028, 1028, 1028, 1028, 1028, 1028, 1028, 1028, 1028, 1028, 1028, 1028, 1028, 1028, 1028, 1028, 1028, 1028, 1028, 1028, 1028, 1028, 1028, 1028, 1028, 1028, 1028, 1028, 1028, 1028, 1028, 1028, 1028, 1028, 1028, 1028, 1028, 1138, 1102, 1102, 1102, 1102, 1102, 1102, 1102, 1102
1102, 1103, 1028, 1028, 1028, 1028, 1028, 1028, 1028, 1028, 1028, 1028, 1028, 1028, 1028, 1028, 1028, 1028, 1028, 1028, 1028, 1028, 1028, 1028, 1028, 1028, 1028, 1028, 1028, 1028, 1028, 1028, 1028, 1028, 1028, 1028, 1028, 1028, 1028, 1028, 1028, 1028, 1028, 1028, 1028, 1028, 1028, 1028, 1028, 1028, 1028, 1028, 1028, 1028, 1028, 1028, 1028, 1028, 1028, 1028, 1028, 1028, 1028, 1028, 1028, 1028, 1028, 1028, 1028, 1028, 1028, 1138, 1102, 1102, 1102, 1102, 1102, 1102, 1102, 1102
1102, 1103, 1028, 1028, 1028, 1028, 1028, 1028, 1028, 1028, 1028, 1028, 1028, 1028, 1028, 1028, 1028, 1028, 1028, 1028, 1028, 1028, 1028, 1028, 1028, 1028, 1028, 1028, 1028, 1028, 1028, 1028, 1028, 1028, 1028, 1028, 1028, 1028, 1028, 1028, 1028, 1028, 1028, 1028, 1028, 1028, 1028, 1028, 1028, 1028, 1028, 1028, 1028, 1028, 1028, 1028, 1028, 1028, 1028, 1028, 1028, 1028, 1028, 1028, 1028, 1028, 1028, 1028, 1028, 1028, 1028, 1138, 1102, 1102, 1102, 1102, 1102, 1102, 1102, 1102
1102, 1103, 1028, 1028, 1028, 1028, 1028, 1028, 1028, 1028, 1028, 1028, 1028, 1028, 1028, 1028, 1028, 1028, 1028, 1028, 1028, 1028, 1028, 1028, 1028, 1028, 1028, 1028, 1028, 1028, 1028, 1028, 1028, 1028, 1028, 1028, 1028, 1028, 1028, 1028, 1028, 1028, 1028, 1028, 1028, 1028, 1028, 1028, 1028, 1028, 1028, 1028, 1028, 1028, 1028, 1028, 1028, 1028, 1028, 1028, 1028, 1028, 1028, 1028, 1028, 1028, 1028, 1028, 1028, 1028, 1028, 1138, 1102, 1102, 1102, 1102, 1102, 1102, 1102, 1102
1102, 1103, 1028, 1028, 1028, 1028, 1028, 1028, 1028, 1028, 1028, 1028, 1028, 1028, 1028, 1028, 1028, 1028, 1028, 1028, 1028, 1028, 1028, 1028, 1028, 1028, 1028, 1028, 1028, 1028, 1028, 1028, 1028, 1028, 1028, 1028, 1028, 1028, 1028, 1028, 1028, 1028, 1028, 1028, 1028, 1028, 1028, 1028, 1028, 1028, 1028, 1028, 1028, 1028, 1028, 1028, 1028, 1028, 1028, 1028, 1028, 1028, 1028, 1028, 1028, 1028, 1028, 1028, 1028, 1028, 1028, 1138, 1102, 1102, 1102, 1102, 1102, 1102, 1102, 1102
1102, 1103, 1028, 1028, 1028, 1028, 1028, 1028, 1028, 1028, 1028, 1028, 1028, 1028, 1028, 1028, 1028, 1028, 1028, 1028, 1028, 1028, 1028, 1028, 1028, 1028, 1028, 1028, 1028, 1028, 1028, 1028, 1028, 1028, 1028, 1028, 1028, 1028, 1028, 1028, 1028, 1028, 1028, 1028, 1028, 1028, 1028, 1028, 1028, 1028, 1028, 1028, 1028, 1028, 1028, 1028, 1028, 1028, 1028, 1028, 1028, 1028, 1028, 1028, 1028, 1028, 1028, 1028, 1028, 1028, 1028, 1138, 1102, 1102, 1102, 1102, 1102, 1102, 1102, 1102
1102, 1057, 1059, 1059, 1059, 1059, 1059, 1059, 1059, 1059, 1059, 1059, 1059, 1059, 1059, 1059, 1059, 1059, 1059, 1059, 1059, 1059, 1059, 1059, 1059, 1059, 1059, 1059, 1059, 1059, 1059, 1059, 1059, 1059, 1059, 1059, 1059, 1059, 1059, 1059, 1059, 1059, 1059, 1059, 1059, 1059, 1059, 1059, 1059, 1059, 1059, 1059, 1059, 1059, 1059, 1059, 1059, 1059, 1059, 1059, 1059, 1059, 1059, 1059, 1059, 1059, 1059, 1059, 1059, 1059, 1059, 1068, 1102, 1102, 1102, 1102, 1102, 1102, 1102, 1102
1102, 1102, 1102, 1102, 1102, 1102, 1102, 1102, 1102, 1102, 1102, 1102, 1102, 1102, 1102, 1102, 1102, 1102, 1102, 1102, 1102, 1102, 1102, 1102, 1102, 1102, 1102, 1102, 1102, 1102, 1102, 1102, 1102, 1102, 1102, 1102, 1102, 1102, 1102, 1102, 1102, 1102, 1102, 1102, 1102, 1102, 1102, 1102, 1102, 1102, 1102, 1102, 1102, 1102, 1102, 1102, 1102, 1102, 1102, 1102, 1102, 1102, 1102, 1102, 1102, 1102, 1102, 1102, 1102, 1102, 1102, 1102, 1102, 1102, 1102, 1102, 1102, 1102, 1102, 1102
1102, 1102, 1102, 1102, 1102, 1102, 1102, 1102, 1102, 1102, 1102, 1102, 1102, 1102, 1102, 1102, 1102, 1102, 1102, 1102, 1102, 1102, 1102, 1102, 1102, 1102, 1102, 1102, 1102, 1102, 1102, 1102, 1102, 1102, 1102, 1102, 1102, 1102, 1102, 1102, 1102, 1102, 1102, 1102, 1102, 1102, 1102, 1102, 1102, 1102, 1102, 1102, 1102, 1102, 1102, 1102, 1102, 1102, 1102, 1102, 1102, 1102, 1102, 1102, 1102, 1102, 1102, 1102, 1102, 1102, 1102, 1102, 1102, 1102, 1102, 1102, 1102, 1102, 1102, 1102
1102, 1102, 1102, 1102, 1102, 1102, 1102, 1102, 1102, 1102, 1102, 1102, 1102, 1102, 1102, 1102, 1102, 1102, 1102, 1102, 1102, 1102, 1102, 1102, 1102, 1102, 1102, 1102, 1102, 1102, 1102, 1102, 1102, 1102, 1102, 1102, 1102, 1102, 1102, 1102, 1102, 1102, 1102, 1102, 1102, 1102, 1102, 1102, 1102, 1102, 1102, 1102, 1102, 1102, 1102, 1102, 1102, 1102, 1102, 1102, 1102, 1102, 1102, 1102, 1102, 1102, 1102, 1102, 1102, 1102, 1102, 1102, 1102, 1102, 1102, 1102, 1102, 1102, 1102, 1102
1102, 1102, 1102, 1102, 1102, 1102, 1102, 1102, 1102, 1102, 1102, 1102, 1102, 1102, 1102, 1102, 1102, 1102, 1102, 1102, 1102, 1102, 1102, 1102, 1102, 1102, 1102, 1102, 1102, 1102, 1102, 1102, 1102, 1102, 1102, 1102, 1102, 1102, 1102, 1102, 1102, 1102, 1102, 1102, 1102, 1102, 1102, 1102, 1102, 1102, 1102, 1102, 1102, 1102, 1102, 1102, 1102, 1102, 1102, 1102, 1102, 1102, 1102, 1102, 1102, 1102, 1102, 1102, 1102, 1102, 1102, 1102, 1102, 1102, 1102, 1102, 1102, 1102, 1102, 1102
1102, 1102, 1102, 1102, 1102, 1102, 1102, 1102, 1102, 1102, 1102, 1102, 1102, 1102, 1102, 1102, 1102, 1102, 1102, 1102, 1102, 1102, 1102, 1102, 1102, 1102, 1102, 1102, 1102, 1102, 1102, 1102, 1102, 1102, 1102, 1102, 1102, 1102, 1102, 1102, 1102, 1102, 1102, 1102, 1102, 1102, 1102, 1102, 1102, 1102, 1102, 1102, 1102, 1102, 1102, 1102, 1102, 1102, 1102, 1102, 1102, 1102, 1102, 1102, 1102, 1102, 1102, 1102, 1102, 1102, 1102, 1102, 1102, 1102, 1102, 1102, 1102, 1102, 1102, 1102
