7759, 7759, 7759, 7759, 7759, 7759, 7759, 7759, 7759, 7759, 7759, 7759, 7759, 7759, 7759, 7759, 7759, 7759, 7759, 7759, 7759, 7759, 7759, 7759, 7759, 7759, 7759, 7759, 7759, 7759, 7759, 7759, 7759, 7759, 7759, 7759, 7759, 7759, 7759, 7759, 7759, 7759, 7759, 7759, 7759, 7759, 7759, 7759, 7759, 7759, 7759, 7759, 7759, 7759, 7759, 7759, 7759, 7759, 7759, 7759, 7759, 7759, 7759, 7759, 7759, 7759, 7759, 7759, 7759, 7759, 7759, 7759, 7759, 7759, 7759, 7759, 7759, 7759, 7759, 7759
7759, 7759, 7759, 7759, 7759, 7759, 7759, 7759, 7759, 7759, 7759, 7759, 7759, 7759, 7759, 7759, 7759, 7759, 7759, 7759, 7759, 7759, 7759, 7759, 7759, 7759, 7759, 7759, 7759, 7759, 7759, 7759, 7759, 7759, 7759, 7759, 7759, 7759, 7759, 7759, 7759, 7759, 7759, 7759, 7759, 7759, 7759, 7759, 7759, 7759, 7759, 7759, 7759, 7759, 7759, 7759, 7759, 7759, 7759, 7759, 7759, 7759, 7759, 7759, 7759, 7759, 7759, 7759, 7759, 7759, 7759, 7759, 7759, 7759, 7759, 7759, 7759, 7759, 7759, 7759
7759, 7759, 7759, 7759, 7759, 7759, 7759, 7759, 7759, 7759, 7759, 7759, 7759, 7759, 7759, 7759, 7759, 7759, 7759, 7759, 7759, 7759, 7759, 7759, 7759, 7759, 7759, 7759, 7759, 7759, 7759, 7759, 7759, 7759, 7759, 7759, 7759, 7759, 7759, 7759, 7759, 7759, 7759, 7759, 7759, 7759, 7759, 7759, 7759, 7759, 7759, 7759, 7759, 7759, 7759, 7759, 7759, 7759, 7759, 7759, 7759, 7759, 7759, 7759, 7759, 7759, 7759, 7759, 7759, 7759, 7759, 7759, 7759, 7759, 7759, 7759, 7759, 7759, 7759, 7759
7759, 7759, 7759, 7759, 7759, 7759, 7759, 7759, 7759, 7759, 7759, 7759, 7759, 7759, 7759, 7759, 7759, 7759, 7759, 7759, 7759, 7759, 7759, 7759, 7759, 7759, 7759, 7759, 7759, 7759, 7759, 7759, 7759, 7759, 7759, 7759, 7759, 7759, 7759, 7759, 7759, 7759, 7759, 7759, 7759, 7759, 7759, 7759, 7759, 7759, 7759, 7759, 7759, 7759, 7759, 7759, 7759, 7759, 7759, 7759, 7759, 7759, 7759, 7759, 7759, 7759, 7759, 7759, 7759, 7759, 7759, 7759, 7759, 7759, 7759, 7759, 7759, 7759, 7759, 7759
7759, 7759, 7759, 7759, 7759, 7759, 7759, 7759, 7759, 7759, 7759, 7759, 7759, 7759, 7759, 7759, 7759, 7759, 7759, 7759, 7759, 7759, 7759, 7759, 7759, 7759, 7759, 7759, 7759, 7759, 7759, 7759, 7759, 7759, 7759, 7759, 7759, 7759, 7759, 7759, 7759, 7759, 7759, 7759, 7759, 7759, 7759, 7759, 7759, 7759, 7759, 7759, 7759, 7759, 7759, 7759, 7759, 7759, 7759, 7759, 7759, 7759, 7759, 7759, 7759, 7759, 7759, 7759, 7759, 7759, 7759, 7759, 7759, 7759, 7759, 7759, 7759, 7759, 7759, 7759
7759, 7759, 7759, 7759, 7759, 7759, 7759, 7759, 7759, 7759, 7759, 7759, 7759, 7759, 7759, 7759, 7759, 7759, 7759, 7759, 7759, 7759, 7759, 7759, 7759, 7759, 7759, 7759, 7759, 7759, 7759, 7759, 7759, 7759, 7759, 7759, 7759, 7759, 7759, 7759, 7759, 7759, 7759, 7759, 7759, 7759, 7759, 7759, 7759, 7759, 7759, 7759, 7759, 7759, 7759, 7759, 7759, 7759, 7759, 7759, 7759, 7759, 7759, 7759, 7759, 7759, 7759, 7759, 7759, 7759, 7759, 7759, 7759, 7759, 7759, 7759, 7759, 7759, 7759, 7759
7759, 7759, 7759, 7759, 7759, 7759, 7759, 7759, 7759, 7759, 7759, 7759, 7759, 7759, 7759, 7759, 7759, 7759, 7759, 7759, 7759, 7759, 7759, 7759, 7759, 7759, 7759, 7759, 7759, 7759, 7759, 7759, 7759, 7759, 7759, 7759, 7759, 7759, 7759, 7759, 7759, 7759, 7759, 7759, 7759, 7759, 7759, 7759, 7759, 7759, 7759, 7759, 7759, 7759, 7759, 7759, 7759, 7759, 7759, 7759, 7759, 7759, 7759, 7759, 7759, 7759, 7759, 7759, 7759, 7759, 7759, 7759, 7759, 7759, 7759, 7759, 7759, 7759, 7759, 7759
7759, 7759, 7759, 7759, 7759, 7759, 7759, 7759, 7759, 7759, 7759, 7759, 7759, 7759, 7759, 7759, 7759, 7759, 7759, 7759, 7759, 7759, 7759, 7759, 7759, 7759, 7759, 7759, 7759, 7759, 7759, 7759, 7759, 7759, 7759, 7759, 7759, 7759, 7759, 7759, 7759, 7759, 7759, 7759, 7759, 7759, 7759, 7759, 7759, 7759, 7759, 7759, 7759, 7759, 7759, 7759, 7759, 7759, 7759, 7759, 7759, 7759, 7759, 7759, 7759, 7759, 7759, 7759, 7759, 7759, 7759, 7759, 7759, 7759, 7759, 7759, 7759, 7759, 7759, 7759
7759, 7759, 7759, 7759, 7759, 7759, 7759, 7759, 7759, 7759, 7759, 7759, 7759, 5685, 5686, 5366, 5367, 5368, 5369, 5370, 5371, 5372, 5373, 5374, 5375, 5376, 5377, 5378, 5379, 5380, 5381, 5382, 5383, 5364, 5365, 5366, 5367, 5368, 5369, 5370, 5371, 5372, 5373, 5374, 5375, 5376, 5377, 5378, 5379, 5380, 5381, 5382, 5383, 5364, 5365, 5366, 5367, 5368, 5369, 5370, 5371, 5372, 5686, 5687, 5375, 5376, 5377, 5378, 5379, 5380, 5381, 5382, 5383, 7759, 7759, 7759, 7759, 7759, 7759, 7759
7759, 7759, 7759, 7759, 7759, 7759, 7759, 7759, 7759, 7759, 7759, 7759, 7759, 5764, 5765, 5446, 5447, 5448, 5449, 5450, 5451, 5452, 5453, 5454, 5455, 5456, 5457, 5458, 5459, 5460, 5461, 5462, 5463, 5444, 5445, 5446, 5447, 5448, 5449, 5450, 5451, 5452, 5453, 5454, 5455, 5456, 5457, 5458, 5459, 5460, 5461, 5462, 5463, 5444, 5445, 5446, 5447, 5448, 5449, 5450, 5451, 5452, 5766, 5767, 5687, 5456, 5457, 5458, 5459, 5460, 5461, 5462, 5463, 1165, 1165, 1165, 1165, 1165, 1165, 1165
7759, 7759, 7759, 7759, 7759, 7759, 7759, 7759, 7759, 7759, 7759, 7759, 7759, 5844, 5845, 37, 38, 39, 40, 5040, 5040, 43, 44, 3927, 3928, 3929, 3930, 3931, 3932, 3933, 3934, 0, 0, 0, 0, 0, 0, 3927, 3928, 3929, 3930, 3931, 3932, 3933, 3934, 3927, 3928, 3929, 3930, 3931, 3932, 3933, 3934, 3927, 3928, 3929, 3930, 3931, 3932, 3933, 3934, 49, 50, 5766, 5767, 1074, 1165, 1165, 1165, 1165, 1165, 1165, 1165, 1165, 1165, 1165, 1165, 1165, 1165, 1165
7759, 7759, 7759, 7759, 7759, 7759, 7759, 7759, 7759, 7759, 7759, 7759, 7759, 5520, 5521, 3927, 3928, 3929, 3930, 3931, 3932, 3933, 3934, 4007, 4008, 4009, 4010, 4011, 4012, 4013, 4014, 0, 0, 0, 0, 0, 0, 4007, 4008, 4009, 4010, 4011, 4012, 4013, 4014, 4007, 4008, 4009, 4010, 4011, 4012, 4013, 4014, 4007, 4008, 4009, 4010, 4011, 4012, 4013, 3698, 3699, 3700, 5522, 5523, 1106, 1165, 1165, 1165, 1165, 1165, 1165, 1165, 1165, 1165, 1165, 1165, 1165, 1165, 1165
7759, 7759, 7759, 7759, 7759, 7759, 7759, 7759, 7759, 7759, 7759, 7759, 7759, 5600, 5601, 4007, 4008, 4009, 4010, 4011, 4012, 4013, 4014, 4087, 4088, 4089, 4090, 4091, 4092, 4093, 4094, 7774, 7775, 7775, 13, 14, 15, 4087, 4088, 4089, 4090, 4091, 4092, 4093, 4094, 4087, 4088, 4089, 4090, 4091, 4092, 4093, 4094, 4087, 4088, 4089, 4090, 4091, 4092, 4093, 3701, 3702, 3703, 5602, 5603, 1138, 1165, 1165, 1165, 1165, 1165, 1165, 1165, 1165, 1165, 1165, 1165, 1165, 1165, 1165
7759, 7759, 7759, 7759, 7759, 7759, 7759, 7759, 7759, 7759, 7759, 7759, 7759, 5680, 5681, 4087, 4088, 4089, 4090, 4091, 4092, 4093, 4094, 4167, 4168, 4169, 4170, 4171, 4172, 4173, 4174, 7774, 7775, 7775, 45, 46, 47, 4167, 4168, 4169, 4170, 4171, 4172, 4173, 4174, 4167, 4168, 4169, 4170, 4171, 4172, 4173, 4174, 4167, 4168, 4169, 4170, 4171, 4172, 4173, 3704, 3705, 3778, 5682, 5683, 1074, 1165, 1165, 1165, 1165, 1165, 1165, 1165, 1165, 1165, 1165, 1165, 1165, 1165, 1165
7759, 7759, 7759, 7759, 7759, 7759, 7759, 7759, 7759, 7759, 7759, 7759, 7759, 5760, 5761, 4167, 4168, 4169, 4170, 4171, 4172, 4173, 4174, 4247, 4248, 4249, 4250, 4251, 4252, 4253, 4254, 7854, 7855, 7775, 77, 3698, 3699, 3700, 3701, 3702, 4250, 4251, 4252, 4253, 4254, 4247, 4248, 4249, 4250, 4251, 4252, 4253, 4254, 4247, 4248, 4249, 4250, 4251, 4252, 4253, 3779, 3780, 3781, 5762, 5763, 1106, 1165, 1165, 1165, 1165, 1165, 1165, 1165, 1165, 1165, 1165, 1165, 1165, 1165, 1165
7759, 7759, 7759, 7759, 7759, 7759, 7759, 7759, 7759, 7759, 7759, 7759, 7759, 5840, 5841, 4247, 4248, 4249, 4250, 4251, 4252, 4253, 4254, 4327, 4328, 4329, 4330, 4331, 4332, 4333, 4334, 7774, 7775, 7775, 109, 3703, 3704, 3705, 3778, 3779, 4330, 4331, 4332, 4333, 4334, 4327, 4328, 4329, 4330, 4331, 4332, 4333, 4334, 4327, 4328, 4329, 4330, 4331, 4332, 4333, 3782, 3783, 3784, 5842, 5843, 1138, 1165, 1165, 1165, 1165, 1165, 1165, 1165, 1165, 1165, 1165, 1165, 1165, 1165, 1165
7759, 7759, 7759, 7759, 7759, 7759, 7759, 7759, 7759, 7759, 7759, 7759, 7759, 5920, 5921, 4327, 4328, 4329, 4330, 4331, 4332, 4333, 4334, 4407, 4408, 4409, 4410, 4411, 4412, 4413, 4414, 7854, 7855, 7775, 141, 142, 143, 4407, 4408, 4409, 4410, 4411, 4412, 4413, 4414, 4407, 4408, 4409, 4410, 4411, 4412, 4413, 4414, 4407, 4408, 4409, 4410, 4411, 4412, 4413, 3785, 3858, 3859, 5922, 5923, 1074, 1165, 1165, 1165, 1165, 1165, 1165, 1165, 1165, 1165, 1165, 1165, 1165, 1165, 1165
7759, 7759, 7759, 7759, 7759, 7759, 7759, 7759, 7759, 7759, 7759, 7759, 7759, 6000, 6001, 4407, 4408, 4409, 4410, 4411, 4412, 4413, 4414, 4487, 4488, 4489, 4490, 4491, 4492, 4493, 4494, 7774, 7775, 204, 173, 174, 175, 4487, 4488, 4489, 4490, 4491, 4492, 4493, 4494, 4487, 4488, 4489, 4490, 4491, 4492, 4493, 4494, 4487, 4488, 4489, 4490, 4491, 4492, 4493, 3860, 3861, 3862, 6002, 6003, 1106, 1165, 1165, 1165, 1165, 1165, 1165, 1165, 1165, 1165, 1165, 1165, 1165, 1165, 1165
7759, 7759, 7759, 7759, 7759, 7759, 7759, 7759, 7759, 7759, 7759, 7759, 7759, 6080, 6081, 3927, 3928, 3929, 3930, 3931, 3932, 3933, 3934, 4167, 4168, 4169, 4170, 4171, 4172, 4173, 4174, 7854, 7855, 204, 205, 206, 207, 3927, 3928, 3929, 3930, 3931, 3932, 3933, 3934, 3927, 3928, 3929, 3930, 3931, 3932, 3933, 3934, 3927, 3928, 3929, 3930, 3931, 3932, 3933, 3863, 3864, 3865, 6082, 6083, 1138, 1165, 1165, 1165, 1165, 1165, 1165, 1165, 1165, 1165, 1165, 1165, 1165, 1165, 1165
7759, 7759, 7759, 7759, 7759, 7759, 7759, 7759, 7759, 7759, 7759, 7759, 7759, 6160, 6161, 4007, 4008, 4009, 4010, 4011, 4012, 4013, 4014, 4247, 4248, 4249, 4250, 4251, 4252, 4253, 4254, 7776, 7777, 7778, 7779, 238, 239, 4007, 4008, 4009, 4010, 4011, 4012, 4013, 4014, 4007, 4008, 4009, 4010, 4011, 4012, 4013, 4014, 4007, 4008, 4009, 4010, 4011, 4012, 4013, 3938, 3939, 3940, 6162, 6163, 1074, 1165, 1165, 1165, 1165, 1165, 1165, 1165, 1165, 1165, 1165, 1165, 1165, 1165, 1165
7759, 7759, 7759, 7759, 7759, 7759, 7759, 7759, 7759, 7759, 7759, 7759, 7759, 6240, 6241, 4087, 4088, 4089, 4090, 4091, 4092, 4093, 4094, 4327, 4328, 4329, 4330, 4331, 4332, 4333, 4334, 7856, 7857, 7858, 7859, 270, 271, 4087, 4088, 4089, 4090, 4091, 4092, 4093, 4094, 4087, 4088, 4089, 4090, 4091, 4092, 4093, 4094, 4087, 4088, 4089, 4090, 4091, 4092, 4093, 3941, 3942, 3943, 6242, 6243, 1106, 1165, 1165, 1165, 1165, 1165, 1165, 1165, 1165, 1165, 1165, 1165, 1165, 1165, 1165
7759, 7759, 7759, 7759, 7759, 7759, 7759, 7759, 7759, 7759, 7759, 7759, 7759, 6320, 6321, 4167, 4168, 4169, 4170, 4171, 4172, 4173, 4174, 4407, 4408, 4409, 4410, 4411, 4412, 4413, 4414, 7936, 7937, 7938, 7939, 302, 303, 4167, 4168, 4169, 4170, 4171, 4172, 4173, 4174, 4167, 4168, 4169, 4170, 4171, 4172, 4173, 4174, 4167, 4168, 4169, 4170, 4171, 4172, 4173, 3944, 3945, 4018, 6322, 6323, 1138, 1165, 1165, 1165, 1165, 1165, 1165, 1165, 1165, 1165, 1165, 1165, 1165, 1165, 1165
7759, 7759, 7759, 7759, 7759, 7759, 7759, 7759, 7759, 7759, 7759, 7759, 7759, 6400, 6401, 4247, 4248, 4249, 4250, 4251, 4252, 4253, 4254, 4487, 4488, 4489, 4490, 4491, 4492, 4493, 4494, 8016, 8017, 8018, 8019, 334, 335, 4247, 4248, 4249, 4250, 4251, 4252, 4253, 4254, 4247, 4248, 4249, 4250, 4251, 4252, 4253, 4254, 4247, 4248, 4249, 4250, 4251, 4252, 4253, 4019, 4020, 4021, 6402, 6403, 1074, 1165, 1165, 1165, 1165, 1165, 1165, 1165, 1165, 1165, 1165, 1165, 1165, 1165, 1165
7759, 7759, 7759, 7759, 7759, 7759, 7759, 7759, 7759, 7759, 7759, 7759, 7759, 6480, 6481, 4327, 4328, 4329, 4330, 4331, 4332, 4333, 4334, 205, 3927, 3928, 3929, 3930, 3931, 3932, 3933, 3934, 7776, 7777, 7778, 7779, 367, 4327, 4328, 4329, 4330, 4331, 4332, 4333, 4334, 4327, 4328, 4329, 4330, 4331, 4332, 4333, 4334, 4327, 4328, 4329, 4330, 4331, 4332, 4333, 4022, 4023, 4024, 6482, 6483, 1106, 1165, 1165, 1165, 1165, 1165, 1165, 1165, 1165, 1165, 1165, 1165, 1165, 1165, 1165
7759, 7759, 7759, 7759, 7759, 7759, 7759, 7759, 7759, 7759, 7759, 7759, 7759, 6560, 6561, 4407, 4408, 4409, 4410, 4411, 4412, 4413, 4414, 237, 4007, 4008, 4009, 4010, 4011, 4012, 4013, 4014, 7856, 7857, 7858, 7859, 399, 4407, 4408, 4409, 4410, 4411, 4412, 4413, 4414, 4407, 4408, 4409, 4410, 4411, 4412, 4413, 4414, 4407, 4408, 4409, 4410, 4411, 4412, 4413, 4025, 4098, 4099, 6562, 6563, 1074, 1165, 1165, 1165, 1165, 1165, 1165, 1165, 1165, 1165, 1165, 1165, 1165, 1165, 1165
7759, 7759, 7759, 7759, 7759, 7759, 7759, 7759, 7759, 7759, 7759, 7759, 7759, 6640, 6641, 4487, 4488, 4489, 4490, 4491, 4492, 4493, 4494, 269, 4087, 4088, 4089, 4090, 4091, 4092, 4093, 4094, 7936, 7937, 7938, 7939, 7760, 4487, 4488, 4489, 4490, 4491, 4492, 4493, 4494, 4487, 4488, 4489, 4490, 4491, 4492, 4493, 4494, 4487, 4488, 4489, 4490, 4491, 4492, 4493, 4100, 4101, 4102, 6642, 6643, 1106, 1165, 1165, 1165, 1165, 1165, 1165, 1165, 1165, 1165, 1165, 1165, 1165, 1165, 1165
7759, 7759, 7759, 7759, 7759, 7759, 7759, 7759, 7759, 7759, 7759, 7759, 7759, 6720, 6721, 293, 294, 295, 296, 297, 298, 3698, 3699, 3700, 4167, 4168, 4169, 4170, 4171, 4172, 4173, 4174, 8016, 8017, 8018, 8019, 7760, 448, 449, 450, 451, 452, 453, 454, 455, 456, 457, 458, 459, 37, 3698, 3699, 3700, 3701, 3702, 3698, 3699, 3700, 3701, 3702, 4103, 4104, 4105, 6722, 6723, 1138, 1165, 1165, 1165, 1165, 1165, 1165, 1165, 1165, 1165, 1165, 1165, 1165, 1165, 1165
7759, 7759, 7759, 7759, 7759, 7759, 7759, 7759, 7759, 7759, 7759, 7759, 7759, 6800, 6801, 325, 7780, 7781, 7774, 7775, 330, 3701, 3702, 3703, 4247, 4248, 4249, 4250, 4251, 4252, 4253, 4254, 3930, 3931, 3932, 3933, 3934, 3927, 3928, 3929, 3930, 3931, 3932, 3933, 3934, 488, 489, 490, 491, 69, 3703, 3704, 3705, 3778, 3779, 3703, 3704, 3705, 3778, 3779, 4178, 4179, 4180, 6802, 6803, 1074, 1165, 1165, 1165, 1165, 1165, 1165, 1165, 1165, 1165, 1165, 1165, 1165, 1165, 1165
7759, 7759, 7759, 7759, 7759, 7759, 7759, 7759, 7759, 7759, 7759, 7759, 7759, 5360, 5361, 240, 7860, 7861, 7854, 7855, 362, 3704, 3705, 3778, 4327, 4328, 4329, 4330, 4331, 4332, 4333, 4334, 4010, 4011, 4012, 4013, 4014, 4007, 4008, 4009, 4010, 4011, 4012, 4013, 4014, 3927, 3928, 3929, 3930, 3931, 3932, 3933, 3934, 3927, 3928, 3929, 3930, 3931, 3932, 3933, 4181, 4182, 4183, 6882, 6883, 1106, 1165, 1165, 1165, 1165, 1165, 1165, 1165, 1165, 1165, 1165, 1165, 1165, 1165, 1165
7759, 7759, 7759, 7759, 7759, 7759, 7759, 7759, 7759, 7759, 7759, 7759, 7759, 5440, 5441, 37, 38, 39, 40, 41, 42, 3779, 3780, 3781, 4407, 4408, 4409, 4410, 4411, 4412, 4413, 4414, 4090, 4091, 4092, 4093, 4094, 4087, 4088, 4089, 4090, 4091, 4092, 4093, 4094, 4007, 4008, 4009, 4010, 4011, 4012, 4013, 4014, 4007, 4008, 4009, 4010, 4011, 4012, 4013, 3698, 3699, 3700, 5362, 5363, 1138, 1165, 1165, 1165, 1165, 1165, 1165, 1165, 1165, 1165, 1165, 1165, 1165, 1165, 1165
7759, 7759, 7759, 7759, 7759, 7759, 7759, 7759, 7759, 7759, 7759, 7759, 7759, 5520, 5521, 69, 3698, 3699, 3700, 3700, 3698, 3699, 3700, 4167, 4487, 4488, 4489, 4490, 4491, 4492, 4493, 4494, 4170, 4171, 4172, 4173, 4174, 4167, 4168, 4169, 4170, 4171, 4172, 4173, 4174, 4087, 4088, 4089, 4090, 4091, 4092, 4093, 4094, 4087, 4088, 4089, 4090, 4091, 4092, 4093, 3701, 3702, 3703, 5442, 5443, 1074, 1165, 1165, 1165, 1165, 1165, 1165, 1165, 1165, 1165, 1165, 1165, 1165, 1165, 1165
7759, 7759, 7759, 7759, 7759, 7759, 7759, 7759, 7759, 7759, 7759, 7759, 7759, 5600, 5601, 101, 3701, 3702, 3703, 3703, 3701, 3702, 3703, 4247, 4248, 4249, 4250, 4251, 4252, 4253, 4254, 4249, 4250, 4251, 4252, 4253, 4254, 4247, 4248, 4249, 4250, 4251, 4252, 4253, 4254, 4167, 4168, 4169, 4170, 4171, 4172, 4173, 4174, 4167, 4168, 4169, 4170, 4171, 4172, 4173, 3704, 3705, 3778, 5522, 5523, 1106, 1165, 1165, 1165, 1165, 1165, 1165, 1165, 1165, 1165, 1165, 1165, 1165, 1165, 1165
7759, 7759, 7759, 7759, 7759, 7759, 7759, 7759, 7759, 7759, 7759, 7759, 7759, 5680, 5681, 133, 3704, 3705, 3778, 3778, 3704, 3705, 3778, 4327, 4328, 4329, 4330, 4331, 4332, 4333, 4334, 4329, 4330, 4331, 4332, 4333, 4334, 4327, 4328, 4329, 4330, 4331, 4332, 4333, 4334, 4247, 4248, 4249, 4250, 4251, 4252, 4253, 4254, 4247, 4248, 4249, 4250, 4251, 4252, 4253, 3779, 3780, 3781, 5602, 5603, 1138, 1165, 1165, 1165, 1165, 1165, 1165, 1165, 1165, 1165, 1165, 1165, 1165, 1165, 1165
7759, 7759, 7759, 7759, 7759, 7759, 7759, 7759, 7759, 7759, 7759, 7759, 7759, 5760, 5761, 240, 3779, 3780, 3781, 3781, 3779, 3780, 3781, 4407, 4408, 4409, 4410, 4411, 4412, 4413, 4414, 4409, 4410, 4411, 4412, 4413, 4414, 4407, 4408, 4409, 4410, 4411, 4412, 4413, 4414, 4327, 4328, 4329, 4330, 4331, 4332, 4333, 4334, 4327, 4328, 4329, 4330, 4331, 4332, 4333, 3782, 3783, 3784, 5682, 5683, 1074, 1165, 1165, 1165, 1165, 1165, 1165, 1165, 1165, 1165, 1165, 1165, 1165, 1165, 1165
7759, 7759, 7759, 7759, 7759, 7759, 7759, 7759, 7759, 7759, 7759, 7759, 7759, 5840, 5841, 240, 7780, 7781, 7774, 7775, 202, 203, 204, 4487, 4488, 4489, 4490, 4491, 4492, 4493, 4494, 4489, 4490, 4491, 4492, 4493, 4494, 4487, 4488, 4489, 4490, 4491, 4492, 4493, 4494, 4407, 4408, 4409, 4410, 4411, 4412, 4413, 4414, 4407, 4408, 4409, 4410, 4411, 4412, 4413, 3698, 3699, 3700, 5762, 5763, 1106, 1165, 1165, 1165, 1165, 1165, 1165, 1165, 1165, 1165, 1165, 1165, 1165, 1165, 1165
7759, 7759, 7759, 7759, 7759, 7759, 7759, 7759, 7759, 7759, 7759, 7759, 7759, 6160, 6161, 229, 7860, 7861, 7854, 7855, 234, 235, 3927, 3928, 3929, 3930, 3931, 3932, 3933, 3934, 244, 338, 385, 386, 387, 388, 389, 3927, 3928, 3929, 3930, 3931, 3932, 3933, 3934, 4487, 4488, 4489, 4490, 4491, 4492, 4493, 4494, 4487, 4488, 4489, 4490, 4491, 4492, 4493, 3701, 3702, 3703, 5842, 5843, 1138, 1165, 1165, 1165, 1165, 1165, 1165, 1165, 1165, 1165, 1165, 1165, 1165, 1165, 1165
7759, 7759, 7759, 7759, 7759, 7759, 7759, 7759, 7759, 7759, 7759, 7759, 7759, 6240, 6241, 3927, 3928, 3929, 3930, 3931, 3932, 3933, 3934, 4008, 4009, 4010, 4011, 4012, 4013, 4014, 276, 7774, 7775, 7774, 7775, 7774, 7775, 4007, 4008, 4009, 4010, 4011, 4012, 4013, 4014, 3927, 3928, 3929, 3930, 3931, 3932, 3933, 3934, 3698, 3699, 3700, 3701, 3702, 3703, 3704, 3704, 3705, 3778, 5922, 5923, 1074, 1165, 1165, 1165, 1165, 1165, 1165, 1165, 1165, 1165, 1165, 1165, 1165, 1165, 1165
7759, 7759, 7759, 7759, 7759, 7759, 7759, 7759, 7759, 7759, 7759, 7759, 7759, 6320, 6321, 4007, 4008, 4009, 4010, 4011, 4012, 4013, 4014, 4088, 4089, 4090, 4091, 4092, 4093, 4094, 52, 7774, 7775, 7854, 7855, 7854, 7855, 4087, 4088, 4089, 4090, 4091, 4092, 4093, 4094, 4007, 4008, 4009, 4010, 4011, 4012, 4013, 4014, 3778, 3779, 3780, 3781, 3782, 3783, 3784, 3779, 3780, 3781, 6002, 6003, 1106, 1165, 1165, 1165, 1165, 1165, 1165, 1165, 1165, 1165, 1165, 1165, 1165, 1165, 1165
7759, 7759, 7759, 7759, 7759, 7759, 7759, 7759, 7759, 7759, 7759, 7759, 7759, 6400, 6401, 4087, 4088, 4089, 4090, 4091, 4092, 4093, 4094, 4168, 4169, 4170, 4171, 4172, 4173, 4174, 52, 7854, 7855, 3698, 3699, 3698, 3699, 3700, 4168, 4169, 4170, 4171, 4172, 4173, 4174, 4087, 4088, 4089, 4090, 4091, 4092, 4093, 4094, 3858, 3859, 3860, 3861, 3862, 3863, 3864, 3782, 3783, 3784, 6082, 6083, 1138, 1165, 1165, 1165, 1165, 1165, 1165, 1165, 1165, 1165, 1165, 1165, 1165, 1165, 1165
7759, 7759, 7759, 7759, 7759, 7759, 7759, 7759, 7759, 7759, 7759, 7759, 7759, 6480, 6481, 4167, 4168, 4169, 4170, 4171, 4172, 4173, 4174, 4248, 4249, 4250, 4251, 4252, 4253, 4254, 84, 7774, 7775, 3698, 3699, 3701, 3702, 3703, 4248, 4249, 4250, 4251, 4252, 4253, 4254, 4167, 4168, 4169, 4170, 4171, 4172, 4173, 4174, 3938, 3939, 3940, 3941, 3942, 3943, 3944, 3785, 3858, 3859, 6162, 6163, 1074, 1165, 1165, 1165, 1165, 1165, 1165, 1165, 1165, 1165, 1165, 1165, 1165, 1165, 1165
7759, 7759, 7759, 7759, 7759, 7759, 7759, 7759, 7759, 7759, 7759, 7759, 7759, 6560, 6561, 4247, 4248, 4249, 4250, 4251, 4252, 4253, 4254, 4328, 4329, 4330, 4331, 4332, 4333, 4334, 116, 7854, 7855, 3701, 3702, 3704, 3705, 3778, 4328, 4329, 4330, 4331, 4332, 4333, 4334, 4247, 4248, 4249, 4250, 4251, 4252, 4253, 4254, 4018, 4019, 4020, 4021, 4022, 4023, 4024, 3860, 3861, 3862, 6242, 6243, 1106, 1165, 1165, 1165, 1165, 1165, 1165, 1165, 1165, 1165, 1165, 1165, 1165, 1165, 1165
7759, 7759, 7759, 7759, 7759, 7759, 7759, 7759, 7759, 7759, 7759, 7759, 7759, 6640, 6641, 4327, 4328, 4329, 4330, 4331, 4332, 4333, 4334, 4408, 4409, 4410, 4411, 4412, 4413, 4414, 148, 7774, 7775, 3704, 3705, 3698, 3699, 3700, 4408, 4409, 4410, 4411, 4412, 4413, 4414, 4327, 4328, 4329, 4330, 4331, 4332, 4333, 4334, 4098, 4099, 4100, 4101, 4102, 4103, 4104, 3863, 3864, 3865, 6322, 6323, 1138, 1165, 1165, 1165, 1165, 1165, 1165, 1165, 1165, 1165, 1165, 1165, 1165, 1165, 1165
7759, 7759, 7759, 7759, 7759, 7759, 7759, 7759, 7759, 7759, 7759, 7759, 7759, 6720, 6721, 4407, 4408, 4409, 4410, 4411, 4412, 4413, 4414, 3928, 3929, 3930, 3931, 3932, 3933, 3934, 180, 7854, 7855, 204, 233, 3701, 3702, 3703, 4488, 4489, 4490, 4491, 4492, 4493, 4494, 4407, 4408, 4409, 4410, 4411, 4412, 4413, 4414, 4178, 4179, 4180, 4181, 4182, 4183, 4184, 3938, 3939, 3940, 6402, 6403, 1074, 1165, 1165, 1165, 1165, 1165, 1165, 1165, 1165, 1165, 1165, 1165, 1165, 1165, 1165
7759, 7759, 7759, 7759, 7759, 7759, 7759, 7759, 7759, 7759, 7759, 7759, 7759, 6800, 6801, 4487, 4488, 4489, 4490, 4491, 4492, 4493, 4494, 4008, 4009, 4010, 4011, 4012, 4013, 4014, 212, 7776, 7777, 7778, 7779, 3704, 3705, 3778, 3928, 3929, 3930, 3931, 3932, 3933, 3934, 4487, 4488, 4489, 4490, 4491, 4492, 4493, 4494, 4258, 4259, 4260, 4261, 4262, 4263, 4264, 3941, 3942, 3943, 6482, 6483, 1106, 1165, 1165, 1165, 1165, 1165, 1165, 1165, 1165, 1165, 1165, 1165, 1165, 1165, 1165
7759, 7759, 7759, 7759, 7759, 7759, 7759, 7759, 7759, 7759, 7759, 7759, 7759, 6880, 6881, 4007, 4008, 4009, 4010, 4011, 4012, 4013, 4014, 4088, 4089, 4090, 4091, 4092, 4093, 4094, 244, 7856, 7857, 7858, 7859, 3698, 3699, 3700, 4008, 4009, 4010, 4011, 4012, 4013, 4014, 3927, 3928, 3929, 3930, 3931, 3932, 3933, 3934, 3698, 3699, 3700, 3701, 3702, 3703, 3704, 3944, 3945, 4018, 6562, 6563, 1138, 1165, 1165, 1165, 1165, 1165, 1165, 1165, 1165, 1165, 1165, 1165, 1165, 1165, 1165
7759, 7759, 7759, 7759, 7759, 7759, 7759, 7759, 7759, 7759, 7759, 7759, 7759, 6960, 6961, 4087, 4088, 4089, 4090, 4091, 4092, 4093, 4094, 4168, 4169, 4170, 4171, 4172, 4173, 4174, 276, 7936, 7937, 7938, 7939, 3701, 3702, 3703, 4088, 4089, 4090, 4091, 4092, 4093, 4094, 4007, 4008, 4009, 4010, 4011, 4012, 4013, 4014, 3778, 3779, 3780, 3781, 3782, 3783, 3784, 4019, 4020, 4021, 6642, 6643, 1074, 1165, 1165, 1165, 1165, 1165, 1165, 1165, 1165, 1165, 1165, 1165, 1165, 1165, 1165
7759, 7759, 7759, 7759, 7759, 7759, 7759, 7759, 7759, 7759, 7759, 7759, 7759, 7040, 7041, 4167, 4168, 4169, 4170, 4171, 4172, 4173, 4174, 4248, 4249, 4250, 4251, 4252, 4253, 4254, 308, 8016, 8017, 8018, 8019, 3704, 3705, 3778, 4168, 4169, 4170, 4171, 4172, 4173, 4174, 4087, 4088, 4089, 4090, 4091, 4092, 4093, 4094, 3858, 3859, 3860, 3861, 3862, 3863, 3864, 4022, 4023, 4024, 6722, 6723, 1106, 1165, 1165, 1165, 1165, 1165, 1165, 1165, 1165, 1165, 1165, 1165, 1165, 1165, 1165
7759, 7759, 7759, 7759, 7759, 7759, 7759, 7759, 7759, 7759, 7759, 7759, 7759, 7120, 7121, 4247, 4248, 4249, 4250, 4251, 4252, 4253, 4254, 3928, 3929, 3930, 3931, 3932, 3933, 3934, 340, 7776, 7777, 7778, 7779, 3698, 3699, 3700, 4248, 4249, 4250, 4251, 4252, 4253, 4254, 4167, 4168, 4169, 4170, 4171, 4172, 4173, 4174, 3938, 3939, 3940, 3941, 3942, 3943, 3944, 4025, 4098, 4099, 6802, 6803, 1138, 1165, 1165, 1165, 1165, 1165, 1165, 1165, 1165, 1165, 1165, 1165, 1165, 1165, 1165
7759, 7759, 7759, 7759, 7759, 7759, 7759, 7759, 7759, 7759, 7759, 7759, 7759, 7200, 7201, 4327, 4328, 4329, 4330, 4331, 4332, 4333, 4334, 4008, 4009, 4010, 4011, 4012, 4013, 4014, 372, 7856, 7857, 7858, 7859, 3701, 3702, 3703, 4328, 4329, 4330, 4331, 4332, 4333, 4334, 4247, 4248, 4249, 4250, 4251, 4252, 4253, 4254, 4018, 4019, 4020, 4021, 4022, 4023, 4024, 4100, 4101, 4102, 6882, 6883, 1074, 1165, 1165, 1165, 1165, 1165, 1165, 1165, 1165, 1165, 1165, 1165, 1165, 1165, 1165
7759, 7759, 7759, 7759, 7759, 7759, 7759, 7759, 7759, 7759, 7759, 7759, 7759, 7280, 7281, 4407, 4408, 4409, 4410, 4411, 4412, 4413, 4414, 4088, 4089, 4090, 4091, 4092, 4093, 4094, 404, 7936, 7937, 7938, 7939, 3704, 3705, 3778, 4408, 4409, 4410, 4411, 4412, 4413, 4414, 4327, 4328, 4329, 4330, 4331, 4332, 4333, 4334, 4098, 4099, 4100, 4101, 4102, 4103, 4104, 4103, 4104, 4105, 5362, 5363, 1106, 1165, 1165, 1165, 1165, 1165, 1165, 1165, 1165, 1165, 1165, 1165, 1165, 1165, 1165
7759, 7759, 7759, 7759, 7759, 7759, 7759, 7759, 7759, 7759, 7759, 7759, 7759, 7360, 7361, 4487, 4488, 4489, 4490, 4491, 4492, 4493, 4494, 4168, 4169, 4170, 4171, 4172, 4173, 4174, 436, 8016, 8017, 8018, 8019, 138, 139, 4487, 4488, 4489, 4490, 4491, 4492, 4493, 4494, 4407, 4408, 4409, 4410, 4411, 4412, 4413, 4414, 4178, 4179, 4180, 4181, 4182, 4183, 4184, 4178, 4179, 4180, 5442, 5443, 1138, 1165, 1165, 1165, 1165, 1165, 1165, 1165, 1165, 1165, 1165, 1165, 1165, 1165, 1165
7759, 7759, 7759, 7759, 7759, 7759, 7759, 7759, 7759, 7759, 7759, 7759, 7759, 7440, 7441, 453, 454, 455, 456, 457, 458, 459, 4247, 4248, 4249, 4250, 4251, 4252, 4253, 3698, 3699, 3700, 7775, 7775, 195, 3698, 3699, 3700, 199, 200, 201, 202, 203, 204, 205, 4487, 4488, 4489, 4490, 4491, 4492, 4493, 4494, 4258, 4259, 4260, 4261, 4262, 4263, 4264, 4181, 4182, 4183, 5522, 5523, 1074, 1165, 1165, 1165, 1165, 1165, 1165, 1165, 1165, 1165, 1165, 1165, 1165, 1165, 1165
7759, 7759, 7759, 7759, 7759, 7759, 7759, 7759, 7759, 7759, 7759, 7759, 7759, 7520, 7521, 485, 486, 487, 488, 489, 490, 491, 4327, 4328, 4329, 4330, 4331, 4332, 4333, 3701, 3702, 3703, 235, 236, 237, 3701, 3702, 3698, 3699, 3700, 3701, 3702, 261, 262, 263, 264, 265, 401, 398, 485, 486, 487, 488, 489, 490, 491, 492, 493, 494, 495, 4184, 4185, 4258, 5602, 5603, 1106, 1165, 1165, 1165, 1165, 1165, 1165, 1165, 1165, 1165, 1165, 1165, 1165, 1165, 1165
7759, 7759, 7759, 7759, 7759, 7759, 7759, 7759, 7759, 7759, 7759, 7759, 7759, 5844, 5845, 517, 518, 519, 520, 5040, 5040, 523, 4407, 4408, 4409, 4410, 4411, 4412, 4413, 3704, 3705, 3778, 293, 294, 295, 3704, 3705, 3703, 3704, 3705, 3778, 3779, 303, 320, 0, 1, 2, 3, 4, 517, 518, 519, 520, 521, 312, 312, 312, 525, 526, 527, 4259, 4260, 4261, 5846, 5847, 1138, 1165, 1165, 1165, 1165, 1165, 1165, 1165, 1165, 1165, 1165, 1165, 1165, 1165, 1165
7759, 7759, 7759, 7759, 7759, 7759, 7759, 7759, 7759, 7759, 7759, 7759, 7759, 5924, 5925, 5526, 5527, 5528, 5529, 5530, 5531, 5532, 5539, 5539, 5539, 5539, 5539, 5539, 5539, 5539, 5541, 5542, 5543, 5543, 5524, 5525, 5526, 5527, 5528, 5529, 5530, 5531, 5532, 5533, 5534, 5535, 5536, 5537, 5538, 5539, 5540, 5541, 5542, 5543, 5524, 5525, 5526, 5527, 5528, 5529, 5530, 5531, 5532, 5926, 5927, 5535, 5536, 5537, 5538, 5539, 5540, 5541, 5542, 5543, 1165, 1165, 1165, 1165, 1165, 1165
7759, 7759, 7759, 7759, 7759, 7759, 7759, 7759, 7759, 7759, 7759, 7759, 7759, 5924, 5925, 5606, 5607, 5608, 5609, 5610, 5611, 5612, 5613, 5614, 5615, 5616, 5617, 5618, 5619, 5620, 5621, 5622, 5623, 5623, 5604, 5605, 5606, 5607, 5608, 5609, 5610, 5611, 5612, 5613, 5614, 5615, 5616, 5617, 5618, 5619, 5620, 5621, 5622, 5623, 5604, 5605, 5606, 5607, 5608, 5609, 5610, 5611, 5612, 5613, 5614, 5615, 5616, 5617, 5618, 5619, 5620, 5621, 5622, 5623, 1165, 1165, 1165, 1165, 1165, 1165
7759, 7759, 7759, 7759, 7759, 7759, 7759, 7759, 7759, 7759, 7759, 7759, 7759, 7759, 7759, 7759, 7759, 7759, 7759, 7759, 1167, 1168, 1169, 1167, 1168, 1169, 1167, 1168, 1169, 1167, 1168, 1169, 1167, 1168, 1169, 1167, 1168, 1169, 1167, 1168, 1169, 1167, 1168, 1169, 1167, 1168, 1169, 1167, 1168, 1169, 1167, 1168, 1169, 1167, 1168, 1169, 1167, 1168, 1169, 1167, 1168, 1169, 1167, 5922, 5923, 1165, 1165, 1165, 1165, 1165, 1165, 1165, 1165, 1165, 1165, 1165, 1165, 1165, 1165, 1165
7759, 7759, 7759, 7759, 7759, 7759, 7759, 7759, 7759, 7759, 7759, 7759, 7759, 7759, 7759, 7759, 7759, 7759, 7759, 7759, 1167, 1168, 1169, 1167, 1168, 1169, 1167, 1168, 1169, 1167, 1168, 1169, 1167, 1168, 1169, 1167, 1168, 1169, 1167, 1168, 1169, 1167, 1168, 1169, 1167, 1168, 1169, 1167, 1168, 1169, 1167, 1168, 1169, 1167, 1168, 1169, 1167, 1168, 1169, 1167, 1168, 1169, 1167, 6002, 6003, 1165, 1165, 1165, 1165, 1165, 1165, 1165, 1165, 1165, 1165, 1165, 1165, 1165, 1165, 1165
7759, 7759, 7759, 7759, 7759, 7759, 7759, 7759, 7759, 7759, 7759, 7759, 7759, 7759, 7759, 7759, 7759, 7759, 7759, 7759, 1167, 1168, 1169, 1167, 1168, 1169, 1167, 1168, 1169, 1167, 1168, 1169, 1167, 1168, 1169, 1167, 1168, 1169, 1167, 1168, 1169, 1167, 1168, 1169, 1167, 1168, 1169, 1167, 1168, 1169, 1167, 1168, 1169, 1167, 1168, 1169, 1167, 1168, 1169, 1167, 1168, 1169, 1167, 6082, 6083, 7759, 7759, 7759, 7759, 7759, 7759, 7759, 7759, 7759, 7759, 7759, 7759, 7759, 7759, 7759
7759, 7759, 7759, 7759, 7759, 7759, 7759, 7759, 7759, 7759, 7759, 7759, 7759, 7759, 7759, 7759, 7759, 7759, 7759, 7759, 7759, 7759, 7759, 7759, 7759, 7759, 7759, 7759, 7759, 7759, 7759, 7759, 7759, 7759, 7759, 7759, 7759, 7759, 7759, 7759, 7759, 7759, 7759, 7759, 7759, 7759, 7759, 7759, 7759, 7759, 7759, 7759, 7759, 7759, 7759, 7759, 7759, 7759, 7759, 7759, 7759, 7759, 7759, 6162, 6163, 7759, 7759, 7759, 7759, 7759, 7759, 7759, 7759, 7759, 7759, 7759, 7759, 7759, 7759, 7759
