2559, 2559, 2559, 2559, 2559, 2559, 2559, 2559, 2559, 2559, 2559, 2559, 2559, 2559, 2559, 2559, 2559, 2559, 2559, 2559, 2559, 2559, 2559, 2559, 2559, 2559, 2559, 2559, 2559, 2559, 2559, 2559, 2559, 2559, 2559, 2559, 2559, 2559, 2559, 2559, 2559, 2559, 2559, 2559, 2559, 2559, 2559, 2559, 2559, 2559, 2559, 2559, 2559, 2559, 2559, 2559, 2559, 2559, 2559, 2559, 2559, 2559, 2559, 2559, 2559, 2559, 2559, 2559, 2559, 2559, 2559, 2559, 2559, 2559, 2559, 2559, 2559, 2559, 2559, 2559
2559, 2559, 2559, 2559, 2559, 2559, 2559, 2559, 2559, 2559, 2559, 2559, 2559, 2559, 2559, 2559, 2559, 2559, 2559, 2559, 2559, 2559, 2559, 2559, 2559, 2559, 2559, 2559, 2559, 2559, 2559, 2559, 2559, 2559, 2559, 2559, 2559, 2559, 2559, 2559, 2559, 2559, 2559, 2559, 2559, 2559, 2559, 2559, 2559, 2559, 2559, 2559, 2559, 2559, 2559, 2559, 2559, 2559, 2559, 2559, 2559, 2559, 2559, 2559, 2559, 2559, 2559, 2559, 2559, 2559, 2559, 2559, 2559, 2559, 2559, 2559, 2559, 2559, 2559, 2559
2559, 2559, 2559, 2559, 2559, 2559, 2559, 2559, 2559, 2559, 2559, 2559, 2559, 2559, 2559, 2559, 2559, 2559, 2559, 2559, 2559, 2559, 2559, 2559, 2559, 2559, 2559, 2559, 2559, 2559, 2559, 2559, 2559, 2559, 2559, 2559, 2559, 2559, 2559, 2559, 2559, 2559, 2559, 2559, 2559, 2559, 2559, 2559, 2559, 2559, 2559, 2559, 2559, 2559, 2559, 2559, 2559, 2559, 2559, 2559, 2559, 2559, 2559, 2559, 2559, 2559, 2559, 2559, 2559, 2559, 2559, 2559, 2559, 2559, 2559, 2559, 2559, 2559, 2559, 2559
2559, 2559, 2559, 2559, 2559, 2559, 2559, 2559, 2559, 2559, 2559, 2559, 2559, 2559, 2559, 2559, 2559, 2559, 2559, 2559, 2559, 2559, 2559, 2559, 2559, 2559, 2559, 2559, 2559, 2559, 2559, 2559, 2559, 2559, 2559, 2559, 2559, 2559, 2559, 2559, 2559, 2559, 2559, 2559, 2559, 2559, 2559, 2559, 2559, 2559, 2559, 2559, 2559, 2559, 2559, 2559, 2559, 2559, 2559, 2559, 2559, 2559, 2559, 2559, 2559, 2559, 2559, 2559, 2559, 2559, 2559, 2559, 2559, 2559, 2559, 2559, 2559, 2559, 2559, 2559
2559, 2559, 2559, 2559, 2559, 2559, 2559, 2559, 2559, 2559, 2559, 2559, 2559, 2559, 2559, 2559, 2559, 2559, 2559, 2559, 2559, 2559, 2559, 2559, 2559, 2559, 2559, 2559, 2559, 2559, 2559, 2559, 2559, 2559, 2559, 2559, 2559, 2559, 2559, 2559, 2559, 2559, 2559, 2559, 2559, 2559, 2559, 2559, 2559, 2559, 2559, 2559, 2559, 2559, 2559, 2559, 2559, 2559, 2559, 2559, 2559, 2559, 2559, 2559, 2559, 2559, 2559, 2559, 2559, 2559, 2559, 2559, 2559, 2559, 2559, 2559, 2559, 2559, 2559, 2559
2559, 2559, 2559, 2559, 2559, 2559, 2559, 2559, 2559, 2559, 2559, 2559, 2559, 2559, 2559, 2559, 2559, 2559, 2559, 2559, 2559, 2559, 2559, 2559, 2559, 2559, 2559, 2559, 2559, 2559, 2559, 2559, 2559, 2559, 2559, 2559, 2559, 2559, 2559, 2559, 2559, 2559, 2559, 2559, 2559, 2559, 2559, 2559, 2559, 2559, 2559, 2559, 2559, 2559, 2559, 2559, 2559, 2559, 2559, 2559, 2559, 2559, 2559, 2559, 2559, 2559, 2559, 2559, 2559, 2559, 2559, 2559, 2559, 2559, 2559, 2559, 2559, 2559, 2559, 2559
2559, 2559, 2559, 2559, 2559, 2559, 2559, 2559, 2559, 2559, 2559, 2559, 2559, 2559, 2559, 2559, 2559, 2559, 2559, 2559, 2559, 2559, 2559, 2559, 2559, 2559, 2559, 2559, 2559, 2559, 2559, 2559, 2559, 2559, 2559, 2559, 2559, 2559, 2559, 2559, 2559, 2559, 2559, 2559, 2559, 2559, 2559, 2559, 2559, 2559, 2559, 2559, 2559, 2559, 2559, 2559, 2559, 2559, 2559, 2559, 2559, 2559, 2559, 2559, 2559, 2559, 2559, 2559, 2559, 2559, 2559, 2559, 2559, 2559, 2559, 2559, 2559, 2559, 2559, 2559
2559, 2559, 2559, 2559, 2559, 2559, 2559, 2559, 2559, 2559, 2559, 2559, 2559, 2559, 2559, 2559, 2559, 2559, 2559, 2559, 2559, 2559, 2559, 2559, 2559, 2559, 2559, 2559, 2559, 2559, 2559, 2559, 2559, 2559, 2559, 2559, 2559, 2559, 2559, 2559, 2559, 2559, 2559, 2559, 2559, 2559, 2559, 2559, 2559, 2559, 2559, 2559, 2559, 2559, 2559, 2559, 2559, 2559, 2559, 2559, 2559, 2559, 2559, 2559, 2559, 2559, 2559, 2559, 2559, 2559, 2559, 2559, 2559, 2559, 2559, 2559, 2559, 2559, 2559, 2559
2559, 2559, 2559, 2559, 2559, 2559, 2559, 2559, 2559, 2559, 2559, 2559, 2559, 2559, 2559, 2559, 2559, 2559, 2559, 2559, 2559, 2559, 2559, 2559, 2559, 2559, 2559, 2559, 2559, 2559, 2559, 2559, 2559, 2559, 2559, 2559, 2559, 2559, 2559, 2559, 2559, 2559, 2559, 2559, 2559, 2559, 2559, 2559, 2559, 2559, 2559, 2559, 2559, 2559, 2559, 2559, 2559, 2559, 2559, 2559, 2559, 2559, 2559, 2559, 2559, 2559, 2559, 2559, 2559, 2559, 2559, 2559, 2559, 2559, 2559, 2559, 2559, 2559, 2559, 2559
2559, 2559, 2559, 2559, 2559, 2559, 2559, 2559, 2559, 2559, 2559, 2559, 2559, 2559, 2559, 2559, 2559, 2559, 2559, 2559, 2559, 2559, 2559, 2559, 2559, 2559, 2559, 2559, 2559, 2559, 2559, 2559, 2559, 2559, 2559, 2559, 2559, 2559, 2559, 2559, 2559, 2559, 2559, 2559, 2559, 2559, 2559, 2559, 2559, 2559, 2559, 2559, 2559, 2559, 2559, 2559, 2559, 2559, 2559, 2559, 2559, 2559, 2559, 2559, 2559, 2559, 2559, 2559, 2559, 2559, 2559, 2559, 2559, 2559, 2559, 2559, 2559, 2559, 2559, 2559
2559, 2559, 2559, 2559, 2559, 2559, 2559, 2559, 2559, 2559, 2559, 2559, 2559, 2559, 2559, 2559, 2559, 2559, 2559, 2559, 2559, 2559, 2559, 2559, 2559, 2559, 2559, 2559, 2559, 2559, 2559, 2559, 2559, 2559, 2559, 2559, 2559, 2559, 2559, 2559, 2559, 2559, 2559, 2559, 2559, 2559, 2559, 2559, 2559, 2559, 2559, 2559, 2559, 2559, 2559, 2559, 2559, 2559, 2559, 2559, 2559, 2559, 2559, 2559, 2559, 2559, 2559, 2559, 2559, 2559, 2559, 2559, 2559, 2559, 2559, 2559, 2559, 2559, 2559, 2559
2559, 2559, 2559, 2559, 2559, 2559, 2559, 2559, 2559, 2559, 2559, 2559, 2559, 2559, 2559, 2559, 2559, 2559, 2559, 2559, 2559, 2559, 2559, 2559, 2559, 2559, 2559, 2559, 2559, 2559, 2559, 2559, 2559, 2559, 2559, 2559, 2559, 2559, 2559, 2559, 2559, 2559, 2559, 2559, 2559, 2559, 2559, 2559, 2559, 2559, 2559, 2559, 2559, 2559, 2559, 2559, 2559, 2559, 2559, 2559, 2559, 2559, 2559, 2559, 2559, 2559, 2559, 2559, 2559, 2559, 2559, 2559, 2559, 2559, 2559, 2559, 2559, 2559, 2559, 2559
2559, 2559, 2559, 2559, 2559, 2559, 2559, 2559, 2559, 2559, 2559, 2559, 2559, 896, 897, 898, 899, 900, 901, 902, 903, 904, 905, 906, 902, 903, 904, 905, 906, 907, 908, 909, 910, 911, 912, 913, 914, 915, 916, 917, 916, 917, 914, 915, 916, 917, 903, 904, 905, 906, 907, 908, 909, 910, 911, 912, 913, 914, 915, 916, 917, 915, 916, 917, 918, 919, 920, 921, 922, 923, 924, 925, 926, 927, 2559, 2559, 2559, 2559, 2559, 2559
2559, 2559, 2559, 2559, 2559, 2559, 2559, 2559, 2559, 2559, 2559, 2559, 2559, 928, 929, 930, 931, 932, 933, 934, 935, 936, 937, 938, 934, 935, 936, 937, 938, 939, 940, 941, 942, 943, 944, 945, 946, 947, 948, 949, 948, 949, 946, 947, 948, 949, 935, 936, 937, 938, 939, 940, 941, 942, 943, 944, 945, 946, 947, 948, 949, 947, 948, 949, 950, 951, 952, 953, 954, 955, 956, 957, 958, 959, 2559, 2559, 2559, 2559, 2559, 2559
2559, 2559, 2559, 2559, 2559, 2559, 2559, 2559, 2559, 2559, 2559, 2559, 2559, 960, 961, 962, 963, 964, 965, 966, 967, 968, 969, 970, 966, 967, 968, 969, 970, 971, 972, 973, 974, 975, 976, 977, 978, 979, 980, 981, 980, 981, 978, 979, 980, 981, 967, 968, 969, 970, 971, 972, 973, 974, 975, 976, 977, 978, 979, 980, 981, 979, 980, 981, 982, 983, 984, 985, 986, 987, 988, 989, 990, 991, 2559, 2559, 2559, 2559, 2559, 2559
2559, 2559, 2559, 2559, 2559, 2559, 2559, 2559, 2559, 2559, 2559, 2559, 2559, 1088, 1089, 1090, 34, 401, 1103, 1103, 401, 2, 697, 697, 1747, 1748, 7, 8, 9, 10, 11, 12, 13, 14, 15, 16, 17, 18, 19, 10, 11, 12, 13, 413, 413, 16, 17, 18, 0, 1, 2, 0, 1, 2, 3, 4, 5, 6, 7, 8, 1747, 1748, 11, 12, 13, 14, 15, 16, 17, 18, 19, 1091, 1092, 1093, 2559, 2559, 2559, 2559, 2559, 2559
2559, 2559, 2559, 2559, 2559, 2559, 2559, 2559, 2559, 2559, 2559, 2559, 2559, 1120, 1121, 1122, 66, 401, 401, 401, 401, 34, 697, 697, 1779, 1780, 39, 40, 41, 42, 43, 44, 45, 46, 47, 48, 49, 50, 51, 42, 43, 44, 45, 413, 413, 48, 49, 50, 32, 33, 34, 32, 33, 34, 35, 36, 37, 38, 39, 40, 1779, 1780, 43, 44, 45, 46, 47, 48, 49, 50, 51, 1123, 1124, 1125, 2559, 2559, 2559, 2559, 2559, 2559
2559, 2559, 2559, 2559, 2559, 2559, 2559, 2559, 2559, 2559, 2559, 2559, 2559, 1152, 1153, 1154, 98, 99, 100, 64, 65, 66, 697, 697, 1747, 1748, 71, 72, 73, 74, 75, 76, 77, 78, 79, 80, 81, 82, 83, 74, 75, 76, 77, 78, 79, 80, 81, 82, 64, 65, 66, 64, 65, 66, 67, 68, 69, 70, 71, 72, 73, 74, 75, 76, 77, 78, 79, 80, 81, 82, 83, 1155, 1156, 1157, 2559, 2559, 2559, 2559, 2559, 2559
2559, 2559, 2559, 2559, 2559, 2559, 2559, 2559, 2559, 2559, 2559, 2559, 2559, 1184, 1185, 1186, 0, 1, 2, 96, 97, 98, 697, 697, 1779, 1780, 103, 104, 105, 106, 107, 108, 109, 110, 111, 112, 113, 114, 115, 106, 107, 108, 109, 110, 111, 112, 113, 114, 96, 97, 98, 96, 97, 98, 99, 100, 101, 102, 103, 104, 105, 106, 107, 108, 109, 110, 111, 112, 113, 114, 115, 1187, 1188, 1189, 2559, 2559, 2559, 2559, 2559, 2559
2559, 2559, 2559, 2559, 2559, 2559, 2559, 2559, 2559, 2559, 2559, 2559, 2559, 1216, 1217, 1218, 32, 33, 34, 128, 129, 130, 697, 697, 1747, 1748, 135, 136, 137, 138, 139, 140, 141, 142, 143, 144, 145, 146, 147, 138, 139, 140, 141, 142, 143, 144, 145, 146, 128, 1747, 1748, 128, 129, 130, 131, 132, 133, 134, 135, 136, 137, 138, 139, 140, 141, 142, 143, 144, 145, 146, 147, 1219, 1220, 1221, 2559, 2559, 2559, 2559, 2559, 2559
2559, 2559, 2559, 2559, 2559, 2559, 2559, 2559, 2559, 2559, 2559, 2559, 2559, 1248, 1249, 1250, 64, 65, 66, 160, 161, 162, 697, 697, 1779, 1780, 167, 168, 169, 170, 171, 172, 173, 174, 175, 176, 177, 178, 179, 170, 171, 172, 173, 174, 175, 176, 177, 178, 160, 1779, 1780, 160, 161, 162, 163, 164, 165, 166, 167, 168, 169, 170, 171, 172, 173, 174, 175, 176, 177, 178, 179, 1251, 1252, 1253, 2559, 2559, 2559, 2559, 2559, 2559
2559, 2559, 2559, 2559, 2559, 2559, 2559, 2559, 2559, 2559, 2559, 2559, 2559, 1280, 1281, 1282, 96, 97, 98, 192, 193, 194, 697, 697, 1747, 1748, 199, 200, 201, 202, 203, 204, 205, 206, 207, 208, 209, 210, 211, 202, 203, 204, 205, 206, 207, 208, 209, 210, 192, 1747, 1748, 192, 193, 194, 195, 196, 197, 198, 199, 200, 201, 202, 203, 204, 205, 206, 207, 208, 209, 210, 211, 1283, 1284, 1285, 2559, 2559, 2559, 2559, 2559, 2559
2559, 2559, 2559, 2559, 2559, 2559, 2559, 2559, 2559, 2559, 2559, 2559, 2559, 1312, 1313, 1314, 128, 129, 130, 224, 225, 226, 227, 228, 1779, 1780, 231, 232, 233, 234, 235, 236, 237, 238, 239, 240, 241, 242, 243, 234, 235, 236, 237, 238, 239, 240, 241, 242, 224, 1779, 1780, 224, 225, 226, 227, 228, 229, 230, 231, 232, 233, 234, 235, 236, 237, 238, 239, 240, 241, 242, 243, 1315, 1316, 1317, 2559, 2559, 2559, 2559, 2559, 2559
2559, 2559, 2559, 2559, 2559, 2559, 2559, 2559, 2559, 2559, 2559, 2559, 2559, 1088, 1089, 1090, 160, 161, 162, 256, 257, 258, 259, 260, 261, 262, 263, 264, 265, 266, 267, 268, 269, 270, 271, 272, 273, 274, 275, 266, 267, 268, 269, 270, 271, 272, 273, 274, 256, 1747, 1748, 1747, 1748, 1747, 1748, 1747, 1748, 1747, 1748, 1747, 1748, 1747, 1748, 1747, 1748, 268, 268, 272, 273, 274, 275, 1091, 1092, 1093, 2559, 2559, 2559, 2559, 2559, 2559
2559, 2559, 2559, 2559, 2559, 2559, 2559, 2559, 2559, 2559, 2559, 2559, 2559, 1120, 1121, 1122, 192, 193, 194, 288, 289, 290, 291, 292, 293, 294, 295, 296, 297, 298, 299, 300, 301, 302, 303, 304, 305, 306, 307, 298, 299, 300, 301, 302, 0, 1, 2, 3, 4, 1779, 1780, 1779, 1780, 1779, 1780, 1779, 1780, 1779, 1780, 1779, 1780, 1779, 1780, 1779, 1780, 268, 268, 23, 24, 306, 307, 1123, 1124, 1125, 2559, 2559, 2559, 2559, 2559, 2559
2559, 2559, 2559, 2559, 2559, 2559, 2559, 2559, 2559, 2559, 2559, 2559, 2559, 1152, 1153, 1154, 224, 225, 226, 320, 321, 322, 323, 324, 325, 326, 327, 328, 329, 330, 331, 332, 333, 334, 335, 336, 337, 338, 339, 330, 331, 332, 333, 334, 32, 33, 34, 35, 36, 1747, 1748, 39, 40, 41, 42, 43, 44, 45, 46, 47, 48, 49, 50, 1747, 1748, 268, 268, 55, 56, 338, 339, 1155, 1156, 1157, 2559, 2559, 2559, 2559, 2559, 2559
2559, 2559, 2559, 2559, 2559, 2559, 2559, 2559, 2559, 2559, 2559, 2559, 2559, 1184, 1185, 1186, 256, 257, 258, 352, 353, 354, 355, 356, 357, 358, 359, 360, 361, 362, 363, 364, 365, 366, 367, 368, 369, 370, 371, 362, 363, 364, 365, 366, 64, 65, 66, 67, 68, 1779, 1780, 71, 72, 73, 74, 75, 76, 77, 78, 79, 80, 81, 82, 1779, 1780, 268, 268, 87, 88, 370, 371, 1187, 1188, 1189, 2559, 2559, 2559, 2559, 2559, 2559
2559, 2559, 2559, 2559, 2559, 2559, 2559, 2559, 2559, 2559, 2559, 2559, 2559, 1216, 1217, 1218, 288, 289, 290, 384, 385, 386, 387, 388, 389, 390, 391, 392, 393, 394, 395, 396, 397, 398, 399, 400, 401, 402, 403, 394, 395, 396, 397, 398, 96, 97, 98, 99, 1747, 1747, 1748, 103, 104, 105, 106, 107, 108, 109, 110, 111, 112, 113, 114, 115, 116, 117, 118, 119, 120, 402, 403, 1219, 1220, 1221, 2559, 2559, 2559, 2559, 2559, 2559
2559, 2559, 2559, 2559, 2559, 2559, 2559, 2559, 2559, 2559, 2559, 2559, 2559, 1248, 1249, 1250, 320, 321, 322, 416, 417, 418, 419, 420, 1747, 1748, 423, 424, 425, 426, 268, 268, 1747, 1748, 1747, 1748, 268, 268, 435, 426, 427, 316, 316, 430, 128, 129, 130, 131, 1779, 1779, 1780, 135, 136, 137, 138, 139, 140, 141, 142, 508, 508, 302, 146, 147, 148, 149, 150, 151, 152, 434, 435, 1251, 1252, 1253, 2559, 2559, 2559, 2559, 2559, 2559
2559, 2559, 2559, 2559, 2559, 2559, 2559, 2559, 2559, 2559, 2559, 2559, 2559, 1280, 1281, 1282, 352, 353, 354, 448, 449, 450, 451, 452, 1779, 1780, 0, 1, 2, 3, 268, 268, 1779, 1780, 1779, 1780, 268, 268, 221, 221, 14, 316, 316, 17, 18, 19, 316, 316, 1747, 1748, 24, 5, 6, 7, 8, 9, 10, 11, 12, 508, 508, 302, 16, 17, 18, 19, 20, 21, 22, 23, 24, 1283, 1284, 1285, 2559, 2559, 2559, 2559, 2559, 2559
2559, 2559, 2559, 2559, 2559, 2559, 2559, 2559, 2559, 2559, 2559, 2559, 2559, 1312, 1313, 1314, 384, 385, 386, 0, 1, 2, 697, 697, 1747, 1748, 0, 1, 2, 3, 221, 221, 221, 221, 221, 377, 377, 221, 221, 221, 14, 15, 16, 17, 18, 286, 316, 316, 1779, 1780, 4, 5, 6, 7, 8, 9, 10, 11, 508, 508, 302, 302, 302, 17, 18, 19, 20, 21, 22, 23, 24, 1315, 1316, 1317, 2559, 2559, 2559, 2559, 2559, 2559
2559, 2559, 2559, 2559, 2559, 2559, 2559, 2559, 2559, 2559, 2559, 2559, 2559, 1088, 1089, 1090, 416, 417, 418, 32, 33, 34, 697, 697, 1779, 1780, 32, 33, 34, 35, 36, 37, 38, 39, 40, 377, 377, 43, 44, 45, 46, 47, 633, 633, 50, 286, 1747, 1748, 1747, 1748, 36, 37, 38, 39, 40, 41, 42, 43, 508, 508, 302, 302, 302, 49, 50, 51, 52, 53, 54, 55, 56, 1091, 1092, 1093, 2559, 2559, 2559, 2559, 2559, 2559
2559, 2559, 2559, 2559, 2559, 2559, 2559, 2559, 2559, 2559, 2559, 2559, 2559, 1120, 1121, 1122, 448, 449, 450, 64, 65, 66, 697, 697, 277, 277, 64, 65, 66, 67, 68, 69, 70, 71, 72, 73, 74, 75, 76, 77, 78, 79, 633, 633, 82, 286, 1779, 1780, 1779, 1780, 316, 316, 70, 71, 72, 73, 74, 75, 1747, 1748, 508, 508, 302, 81, 82, 83, 84, 85, 86, 87, 88, 1123, 1124, 1125, 2559, 2559, 2559, 2559, 2559, 2559
2559, 2559, 2559, 2559, 2559, 2559, 2559, 2559, 2559, 2559, 2559, 2559, 2559, 1152, 1153, 1154, 0, 1, 2, 96, 97, 98, 697, 697, 277, 277, 96, 97, 98, 99, 100, 101, 102, 103, 104, 105, 106, 107, 108, 109, 110, 111, 1747, 1748, 1747, 1748, 286, 97, 98, 99, 1747, 1748, 316, 103, 104, 105, 106, 107, 1779, 1780, 1747, 1748, 302, 113, 114, 115, 116, 117, 118, 119, 120, 1155, 1156, 1157, 2559, 2559, 2559, 2559, 2559, 2559
2559, 2559, 2559, 2559, 2559, 2559, 2559, 2559, 2559, 2559, 2559, 2559, 2559, 1184, 1185, 1186, 32, 33, 34, 128, 129, 130, 131, 184, 221, 221, 128, 129, 130, 131, 132, 133, 134, 135, 136, 137, 138, 139, 341, 341, 142, 143, 1779, 1780, 1779, 1780, 286, 129, 130, 131, 1779, 1780, 316, 135, 136, 137, 138, 139, 140, 141, 1779, 1780, 144, 145, 146, 147, 148, 149, 150, 151, 152, 1187, 1188, 1189, 2559, 2559, 2559, 2559, 2559, 2559
2559, 2559, 2559, 2559, 2559, 2559, 2559, 2559, 2559, 2559, 2559, 2559, 2559, 1216, 1217, 1218, 64, 65, 66, 67, 68, 69, 70, 184, 184, 73, 160, 161, 162, 163, 164, 165, 166, 167, 168, 169, 170, 171, 341, 341, 174, 175, 1747, 1748, 178, 179, 160, 286, 286, 163, 164, 165, 166, 167, 168, 169, 170, 171, 172, 173, 1747, 1748, 176, 177, 178, 179, 180, 181, 182, 183, 184, 1219, 1220, 1221, 2559, 2559, 2559, 2559, 2559, 2559
2559, 2559, 2559, 2559, 2559, 2559, 2559, 2559, 2559, 2559, 2559, 2559, 2559, 1248, 1249, 1250, 96, 97, 98, 99, 100, 101, 697, 697, 1747, 1748, 1747, 1748, 1747, 1748, 1747, 1748, 198, 199, 200, 201, 202, 203, 1747, 1748, 1747, 1748, 1779, 1780, 210, 211, 192, 286, 286, 195, 196, 197, 198, 199, 200, 201, 202, 203, 204, 205, 1779, 1780, 208, 209, 210, 211, 212, 213, 214, 215, 216, 1251, 1252, 1253, 2559, 2559, 2559, 2559, 2559, 2559
2559, 2559, 2559, 2559, 2559, 2559, 2559, 2559, 2559, 2559, 2559, 2559, 2559, 1088, 1089, 1090, 128, 129, 130, 131, 132, 133, 697, 697, 1779, 1780, 1779, 1780, 1779, 1780, 1779, 1780, 230, 231, 232, 233, 1747, 1748, 1779, 1780, 1779, 1780, 1747, 1748, 242, 243, 224, 225, 226, 227, 228, 229, 230, 231, 232, 233, 234, 235, 236, 237, 1747, 1748, 240, 241, 242, 243, 244, 245, 246, 247, 248, 1091, 1092, 1093, 2559, 2559, 2559, 2559, 2559, 2559
2559, 2559, 2559, 2559, 2559, 2559, 2559, 2559, 2559, 2559, 2559, 2559, 2559, 1120, 1121, 1122, 148, 149, 150, 151, 152, 153, 213, 214, 215, 216, 256, 257, 258, 259, 260, 261, 262, 263, 264, 265, 1779, 1780, 268, 269, 270, 271, 1779, 1780, 274, 275, 256, 257, 258, 259, 260, 261, 262, 263, 264, 265, 266, 267, 268, 269, 1779, 1780, 272, 273, 274, 275, 276, 277, 278, 279, 280, 1123, 1124, 1125, 2559, 2559, 2559, 2559, 2559, 2559
2559, 2559, 2559, 2559, 2559, 2559, 2559, 2559, 2559, 2559, 2559, 2559, 2559, 1152, 1153, 1154, 180, 181, 182, 183, 184, 185, 245, 246, 247, 248, 288, 289, 290, 291, 292, 293, 294, 295, 296, 297, 1747, 1748, 300, 301, 302, 303, 304, 305, 306, 307, 288, 289, 290, 291, 292, 293, 294, 295, 296, 297, 298, 299, 300, 301, 1747, 1748, 304, 305, 306, 307, 308, 309, 310, 311, 312, 1155, 1156, 1157, 2559, 2559, 2559, 2559, 2559, 2559
2559, 2559, 2559, 2559, 2559, 2559, 2559, 2559, 2559, 2559, 2559, 2559, 2559, 1184, 1185, 1186, 212, 213, 214, 215, 216, 217, 136, 265, 266, 267, 320, 321, 322, 323, 324, 325, 326, 327, 328, 329, 1779, 1780, 332, 333, 334, 335, 336, 337, 338, 339, 320, 321, 322, 323, 324, 325, 326, 327, 328, 329, 330, 331, 332, 333, 1779, 1780, 336, 337, 338, 339, 340, 341, 342, 343, 344, 1187, 1188, 1189, 2559, 2559, 2559, 2559, 2559, 2559
2559, 2559, 2559, 2559, 2559, 2559, 2559, 2559, 2559, 2559, 2559, 2559, 2559, 1216, 1217, 1218, 244, 245, 246, 247, 248, 249, 168, 297, 298, 299, 352, 353, 354, 355, 356, 357, 358, 359, 360, 361, 1747, 1748, 364, 365, 366, 367, 368, 369, 370, 371, 352, 353, 354, 355, 356, 357, 358, 359, 360, 361, 362, 363, 364, 365, 1747, 1748, 368, 369, 370, 371, 372, 373, 374, 375, 376, 1219, 1220, 1221, 2559, 2559, 2559, 2559, 2559, 2559
2559, 2559, 2559, 2559, 2559, 2559, 2559, 2559, 2559, 2559, 2559, 2559, 2559, 1248, 1249, 1250, 276, 277, 278, 279, 280, 281, 200, 329, 330, 331, 384, 385, 386, 387, 388, 389, 390, 391, 392, 393, 1779, 1780, 396, 397, 398, 399, 400, 401, 402, 403, 384, 385, 386, 387, 388, 389, 390, 391, 392, 393, 394, 395, 396, 397, 1779, 1780, 400, 401, 402, 403, 404, 405, 406, 407, 408, 1251, 1252, 1253, 2559, 2559, 2559, 2559, 2559, 2559
2559, 2559, 2559, 2559, 2559, 2559, 2559, 2559, 2559, 2559, 2559, 2559, 2559, 1280, 1281, 1282, 308, 309, 310, 311, 312, 313, 314, 315, 0, 0, 416, 417, 418, 419, 420, 421, 422, 423, 424, 425, 1747, 1748, 428, 429, 430, 431, 432, 433, 434, 435, 416, 417, 418, 419, 420, 421, 422, 423, 424, 425, 426, 427, 428, 429, 1747, 1748, 432, 433, 434, 435, 436, 437, 438, 439, 440, 1283, 1284, 1285, 2559, 2559, 2559, 2559, 2559, 2559
2559, 2559, 2559, 2559, 2559, 2559, 2559, 2559, 2559, 2559, 2559, 2559, 2559, 1312, 1313, 1314, 340, 341, 342, 343, 344, 345, 346, 347, 0, 0, 448, 449, 450, 451, 452, 453, 454, 455, 456, 457, 1779, 1780, 460, 461, 462, 463, 464, 465, 466, 467, 448, 449, 450, 451, 452, 453, 454, 455, 456, 457, 458, 459, 460, 461, 1779, 1780, 464, 465, 466, 467, 468, 469, 470, 471, 472, 1315, 1316, 1317, 2559, 2559, 2559, 2559, 2559, 2559
2559, 2559, 2559, 2559, 2559, 2559, 2559, 2559, 2559, 2559, 2559, 2559, 2559, 992, 993, 994, 995, 996, 997, 998, 999, 1000, 1001, 1002, 1003, 1004, 1005, 1006, 1000, 1001, 1002, 1003, 1004, 1005, 1006, 1007, 1008, 1009, 1010, 1011, 1012, 1013, 1014, 1015, 1014, 1015, 1003, 1004, 1005, 1006, 1007, 1008, 1009, 1010, 1011, 1012, 1013, 1014, 1015, 1009, 1010, 1011, 1012, 1013, 1014, 1015, 1016, 1017, 1018, 1019, 1020, 1021, 1022, 1023, 2559, 2559, 2559, 2559, 2559, 2559
2559, 2559, 2559, 2559, 2559, 2559, 2559, 2559, 2559, 2559, 2559, 2559, 2559, 1024, 1025, 1026, 1027, 1028, 1029, 1030, 1031, 1032, 1033, 1034, 1035, 1036, 1037, 1038, 1032, 1033, 1034, 1035, 1036, 1037, 1038, 1039, 1040, 1041, 1042, 1043, 1044, 1045, 1046, 1047, 1046, 1047, 1035, 1036, 1037, 1038, 1039, 1040, 1041, 1042, 1043, 1044, 1045, 1046, 1047, 1041, 1042, 1043, 1044, 1045, 1046, 1047, 1048, 1049, 1050, 1051, 1052, 1053, 1054, 1055, 2559, 2559, 2559, 2559, 2559, 2559
2559, 2559, 2559, 2559, 2559, 2559, 2559, 2559, 2559, 2559, 2559, 2559, 2559, 1056, 1057, 1058, 1059, 1060, 1061, 1062, 1063, 1064, 1065, 1066, 1067, 1068, 1069, 1070, 1064, 1065, 1066, 1067, 1068, 1069, 1070, 1071, 1072, 1073, 1074, 1075, 1076, 1077, 1078, 1079, 1078, 1079, 1067, 1068, 1069, 1070, 1071, 1072, 1073, 1074, 1075, 1076, 1077, 1078, 1079, 1073, 1074, 1075, 1076, 1077, 1078, 1079, 1080, 1081, 1082, 1083, 1084, 1085, 1086, 1087, 2559, 2559, 2559, 2559, 2559, 2559
2559, 2559, 2559, 2559, 2559, 2559, 2559, 2559, 2559, 2559, 2559, 2559, 2559, 2559, 2559, 2559, 2559, 2559, 2559, 2559, 2559, 2559, 2559, 2559, 2559, 2559, 2559, 2559, 2559, 2559, 2559, 2559, 2559, 2559, 2559, 2559, 2559, 2559, 2559, 2559, 2559, 2559, 2559, 2559, 2559, 2559, 2559, 2559, 2559, 2559, 2559, 2559, 2559, 2559, 2559, 2559, 2559, 2559, 2559, 2559, 2559, 2559, 2559, 2559, 2559, 2559, 2559, 2559, 2559, 2559, 2559, 2559, 2559, 2559, 2559, 2559, 2559, 2559, 2559, 2559
2559, 2559, 2559, 2559, 2559, 2559, 2559, 2559, 2559, 2559, 2559, 2559, 2559, 2559, 2559, 2559, 2559, 2559, 2559, 2559, 2559, 2559, 2559, 2559, 2559, 2559, 2559, 2559, 2559, 2559, 2559, 2559, 2559, 2559, 2559, 2559, 2559, 2559, 2559, 2559, 2559, 2559, 2559, 2559, 2559, 2559, 2559, 2559, 2559, 2559, 2559, 2559, 2559, 2559, 2559, 2559, 2559, 2559, 2559, 2559, 2559, 2559, 2559, 2559, 2559, 2559, 2559, 2559, 2559, 2559, 2559, 2559, 2559, 2559, 2559, 2559, 2559, 2559, 2559, 2559
2559, 2559, 2559, 2559, 2559, 2559, 2559, 2559, 2559, 2559, 2559, 2559, 2559, 2559, 2559, 2559, 2559, 2559, 2559, 2559, 2559, 2559, 2559, 2559, 2559, 2559, 2559, 2559, 2559, 2559, 2559, 2559, 2559, 2559, 2559, 2559, 2559, 2559, 2559, 2559, 2559, 2559, 2559, 2559, 2559, 2559, 2559, 2559, 2559, 2559, 2559, 2559, 2559, 2559, 2559, 2559, 2559, 2559, 2559, 2559, 2559, 2559, 2559, 2559, 2559, 2559, 2559, 2559, 2559, 2559, 2559, 2559, 2559, 2559, 2559, 2559, 2559, 2559, 2559, 2559
2559, 2559, 2559, 2559, 2559, 2559, 2559, 2559, 2559, 2559, 2559, 2559, 2559, 2559, 2559, 2559, 2559, 2559, 2559, 2559, 2559, 2559, 2559, 2559, 2559, 2559, 2559, 2559, 2559, 2559, 2559, 2559, 2559, 2559, 2559, 2559, 2559, 2559, 2559, 2559, 2559, 2559, 2559, 2559, 2559, 2559, 2559, 2559, 2559, 2559, 2559, 2559, 2559, 2559, 2559, 2559, 2559, 2559, 2559, 2559, 2559, 2559, 2559, 2559, 2559, 2559, 2559, 2559, 2559, 2559, 2559, 2559, 2559, 2559, 2559, 2559, 2559, 2559, 2559, 2559
2559, 2559, 2559, 2559, 2559, 2559, 2559, 2559, 2559, 2559, 2559, 2559, 2559, 2559, 2559, 2559, 2559, 2559, 2559, 2559, 2559, 2559, 2559, 2559, 2559, 2559, 2559, 2559, 2559, 2559, 2559, 2559, 2559, 2559, 2559, 2559, 2559, 2559, 2559, 2559, 2559, 2559, 2559, 2559, 2559, 2559, 2559, 2559, 2559, 2559, 2559, 2559, 2559, 2559, 2559, 2559, 2559, 2559, 2559, 2559, 2559, 2559, 2559, 2559, 2559, 2559, 2559, 2559, 2559, 2559, 2559, 2559, 2559, 2559, 2559, 2559, 2559, 2559, 2559, 2559
2559, 2559, 2559, 2559, 2559, 2559, 2559, 2559, 2559, 2559, 2559, 2559, 2559, 2559, 2559, 2559, 2559, 2559, 2559, 2559, 2559, 2559, 2559, 2559, 2559, 2559, 2559, 2559, 2559, 2559, 2559, 2559, 2559, 2559, 2559, 2559, 2559, 2559, 2559, 2559, 2559, 2559, 2559, 2559, 2559, 2559, 2559, 2559, 2559, 2559, 2559, 2559, 2559, 2559, 2559, 2559, 2559, 2559, 2559, 2559, 2559, 2559, 2559, 2559, 2559, 2559, 2559, 2559, 2559, 2559, 2559, 2559, 2559, 2559, 2559, 2559, 2559, 2559, 2559, 2559
2559, 2559, 2559, 2559, 2559, 2559, 2559, 2559, 2559, 2559, 2559, 2559, 2559, 2559, 2559, 2559, 2559, 2559, 2559, 2559, 2559, 2559, 2559, 2559, 2559, 2559, 2559, 2559, 2559, 2559, 2559, 2559, 2559, 2559, 2559, 2559, 2559, 2559, 2559, 2559, 2559, 2559, 2559, 2559, 2559, 2559, 2559, 2559, 2559, 2559, 2559, 2559, 2559, 2559, 2559, 2559, 2559, 2559, 2559, 2559, 2559, 2559, 2559, 2559, 2559, 2559, 2559, 2559, 2559, 2559, 2559, 2559, 2559, 2559, 2559, 2559, 2559, 2559, 2559, 2559
2559, 2559, 2559, 2559, 2559, 2559, 2559, 2559, 2559, 2559, 2559, 2559, 2559, 2559, 2559, 2559, 2559, 2559, 2559, 2559, 2559, 2559, 2559, 2559, 2559, 2559, 2559, 2559, 2559, 2559, 2559, 2559, 2559, 2559, 2559, 2559, 2559, 2559, 2559, 2559, 2559, 2559, 2559, 2559, 2559, 2559, 2559, 2559, 2559, 2559, 2559, 2559, 2559, 2559, 2559, 2559, 2559, 2559, 2559, 2559, 2559, 2559, 2559, 2559, 2559, 2559, 2559, 2559, 2559, 2559, 2559, 2559, 2559, 2559, 2559, 2559, 2559, 2559, 2559, 2559
2559, 2559, 2559, 2559, 2559, 2559, 2559, 2559, 2559, 2559, 2559, 2559, 2559, 2559, 2559, 2559, 2559, 2559, 2559, 2559, 2559, 2559, 2559, 2559, 2559, 2559, 2559, 2559, 2559, 2559, 2559, 2559, 2559, 2559, 2559, 2559, 2559, 2559, 2559, 2559, 2559, 2559, 2559, 2559, 2559, 2559, 2559, 2559, 2559, 2559, 2559, 2559, 2559, 2559, 2559, 2559, 2559, 2559, 2559, 2559, 2559, 2559, 2559, 2559, 2559, 2559, 2559, 2559, 2559, 2559, 2559, 2559, 2559, 2559, 2559, 2559, 2559, 2559, 2559, 2559
2559, 2559, 2559, 2559, 2559, 2559, 2559, 2559, 2559, 2559, 2559, 2559, 2559, 2559, 2559, 2559, 2559, 2559, 2559, 2559, 2559, 2559, 2559, 2559, 2559, 2559, 2559, 2559, 2559, 2559, 2559, 2559, 2559, 2559, 2559, 2559, 2559, 2559, 2559, 2559, 2559, 2559, 2559, 2559, 2559, 2559, 2559, 2559, 2559, 2559, 2559, 2559, 2559, 2559, 2559, 2559, 2559, 2559, 2559, 2559, 2559, 2559, 2559, 2559, 2559, 2559, 2559, 2559, 2559, 2559, 2559, 2559, 2559, 2559, 2559, 2559, 2559, 2559, 2559, 2559
2559, 2559, 2559, 2559, 2559, 2559, 2559, 2559, 2559, 2559, 2559, 2559, 2559, 2559, 2559, 2559, 2559, 2559, 2559, 2559, 2559, 2559, 2559, 2559, 2559, 2559, 2559, 2559, 2559, 2559, 2559, 2559, 2559, 2559, 2559, 2559, 2559, 2559, 2559, 2559, 2559, 2559, 2559, 2559, 2559, 2559, 2559, 2559, 2559, 2559, 2559, 2559, 2559, 2559, 2559, 2559, 2559, 2559, 2559, 2559, 2559, 2559, 2559, 2559, 2559, 2559, 2559, 2559, 2559, 2559, 2559, 2559, 2559, 2559, 2559, 2559, 2559, 2559, 2559, 2559
2559, 2559, 2559, 2559, 2559, 2559, 2559, 2559, 2559, 2559, 2559, 2559, 2559, 2559, 2559, 2559, 2559, 2559, 2559, 2559, 2559, 2559, 2559, 2559, 2559, 2559, 2559, 2559, 2559, 2559, 2559, 2559, 2559, 2559, 2559, 2559, 2559, 2559, 2559, 2559, 2559, 2559, 2559, 2559, 2559, 2559, 2559, 2559, 2559, 2559, 2559, 2559, 2559, 2559, 2559, 2559, 2559, 2559, 2559, 2559, 2559, 2559, 2559, 2559, 2559, 2559, 2559, 2559, 2559, 2559, 2559, 2559, 2559, 2559, 2559, 2559, 2559, 2559, 2559, 2559
