0, 0, 0, 0, 0, 0, 0, 0, 0, 0, 0, 0, 0, 0, 0, 0, 0, 0, 0, 0, 0, 0, 0, 0, 0, 0, 0, 0, 0, 0, 0, 0, 0, 0, 0, 0, 0, 0, 0, 0, 0, 0, 0, 0, 0, 0, 0, 0, 0, 0, 0, 0, 0, 0, 0, 0, 0, 0, 0, 0, 0, 0, 0, 0, 0, 0, 0, 0, 0, 0, 0, 0, 0, 0, 0, 0, 0, 0, 0, 0
0, 0, 0, 0, 0, 0, 0, 0, 0, 0, 0, 0, 0, 0, 0, 0, 0, 0, 0, 0, 0, 0, 0, 0, 0, 0, 0, 0, 0, 0, 0, 0, 0, 0, 0, 0, 0, 0, 0, 0, 0, 0, 0, 0, 0, 0, 0, 0, 0, 0, 0, 0, 0, 0, 0, 0, 0, 0, 0, 0, 0, 0, 0, 0, 0, 0, 0, 0, 0, 0, 0, 0, 0, 0, 0, 0, 0, 0, 0, 0
0, 0, 0, 0, 0, 0, 0, 0, 0, 0, 0, 0, 0, 0, 0, 0, 0, 0, 0, 0, 0, 0, 0, 0, 0, 0, 0, 0, 0, 0, 0, 0, 0, 0, 0, 0, 0, 0, 0, 0, 0, 0, 0, 0, 0, 0, 0, 0, 0, 0, 0, 0, 0, 0, 0, 0, 0, 0, 0, 0, 0, 0, 0, 0, 0, 0, 0, 0, 0, 0, 0, 0, 0, 0, 0, 0, 0, 0, 0, 0
0, 0, 0, 0, 0, 0, 0, 0, 0, 0, 0, 0, 0, 0, 0, 0, 0, 0, 0, 0, 0, 0, 0, 0, 0, 0, 0, 0, 0, 0, 0, 0, 0, 0, 0, 0, 0, 0, 0, 0, 0, 0, 0, 0, 0, 0, 0, 0, 0, 0, 0, 0, 0, 0, 0, 0, 0, 0, 0, 0, 0, 0, 0, 0, 0, 0, 0, 0, 0, 0, 0, 0, 0, 0, 0, 0, 0, 0, 0, 0
0, 0, 0, 0, 0, 0, 0, 0, 0, 0, 0, 0, 0, 0, 0, 0, 0, 0, 0, 0, 0, 0, 0, 0, 0, 0, 0, 0, 0, 0, 0, 0, 0, 0, 0, 0, 0, 0, 0, 0, 0, 0, 0, 0, 0, 0, 0, 0, 0, 0, 0, 0, 0, 0, 0, 0, 0, 0, 0, 0, 0, 0, 0, 0, 0, 0, 0, 0, 0, 0, 0, 0, 0, 0, 0, 0, 0, 0, 0, 0
0, 0, 0, 0, 0, 0, 0, 0, 0, 0, 0, 0, 0, 0, 0, 0, 0, 0, 0, 0, 0, 0, 0, 0, 0, 0, 0, 0, 0, 0, 0, 0, 0, 0, 0, 0, 0, 0, 0, 0, 0, 0, 0, 0, 0, 0, 0, 0, 0, 0, 0, 0, 0, 0, 0, 0, 0, 0, 0, 0, 0, 0, 0, 0, 0, 0, 0, 0, 0, 0, 0, 0, 0, 0, 0, 0, 0, 0, 0, 0
0, 0, 0, 0, 0, 0, 0, 0, 0, 0, 0, 0, 0, 0, 0, 0, 0, 0, 0, 0, 0, 0, 0, 0, 0, 0, 0, 0, 0, 0, 0, 0, 0, 0, 0, 0, 0, 0, 0, 0, 0, 0, 0, 0, 0, 0, 0, 0, 0, 0, 0, 0, 0, 0, 0, 0, 0, 0, 0, 0, 0, 0, 0, 0, 0, 0, 0, 0, 0, 0, 0, 0, 0, 0, 0, 0, 0, 0, 0, 0
0, 0, 0, 0, 0, 0, 0, 0, 0, 0, 0, 0, 0, 0, 0, 0, 0, 0, 0, 0, 0, 0, 0, 0, 0, 0, 0, 0, 0, 0, 0, 0, 0, 0, 0, 0, 0, 0, 0, 0, 0, 0, 0, 0, 0, 0, 0, 0, 0, 0, 0, 0, 0, 0, 0, 0, 0, 0, 0, 0, 0, 0, 0, 0, 0, 0, 0, 0, 0, 0, 0, 0, 0, 0, 0, 0, 0, 0, 0, 0
0, 0, 0, 0, 0, 0, 0, 0, 0, 0, 0, 0, 0, 0, 0, 0, 0, 0, 0, 0, 0, 0, 0, 0, 0, 0, 0, 0, 0, 0, 0, 0, 0, 0, 0, 0, 0, 0, 0, 0, 0, 0, 0, 0, 0, 0, 0, 0, 0, 0, 0, 0, 0, 0, 0, 0, 0, 0, 0, 0, 0, 0, 0, 0, 0, 0, 0, 0, 0, 0, 0, 0, 0, 0, 0, 0, 0, 0, 0, 0
0, 0, 0, 0, 0, 0, 0, 0, 0, 0, 0, 0, 0, 0, 0, 0, 0, 0, 0, 0, 0, 0, 0, 0, 0, 0, 0, 0, 0, 0, 0, 0, 0, 0, 0, 0, 0, 0, 0, 0, 0, 0, 0, 0, 0, 0, 0, 0, 0, 0, 0, 0, 0, 0, 0, 0, 0, 0, 0, 0, 0, 0, 0, 0, 0, 0, 0, 0, 0, 0, 0, 0, 0, 0, 0, 0, 0, 0, 0, 0
0, 0, 0, 0, 0, 0, 0, 0, 0, 0, 0, 0, 0, 0, 0, 0, 0, 0, 0, 0, 0, 1094, 1095, 0, 0, 0, 0, 0, 0, 0, 0, 0, 0, 0, 0, 0, 0, 0, 0, 0, 0, 0, 0, 0, 0, 0, 0, 0, 0, 0, 0, 0, 0, 0, 0, 0, 0, 1094, 1095, 0, 0, 0, 0, 0, 0, 0, 0, 0, 0, 0, 0, 0, 0, 0, 0, 0, 0, 0, 0, 0
0, 0, 0, 0, 0, 0, 0, 0, 0, 0, 0, 0, 0, 0, 0, 0, 0, 0, 0, 0, 0, 1096, 1097, 0, 0, 0, 0, 0, 0, 0, 0, 0, 0, 0, 0, 0, 0, 0, 0, 0, 0, 0, 0, 0, 0, 0, 0, 0, 0, 0, 0, 0, 0, 0, 0, 0, 0, 1096, 1097, 0, 0, 0, 0, 0, 0, 0, 0, 0, 0, 0, 0, 0, 0, 0, 0, 0, 0, 0, 0, 0
0, 0, 0, 0, 0, 0, 0, 0, 0, 0, 0, 0, 0, 0, 0, 0, 0, 0, 0, 0, 0, 1098, 1099, 0, 0, 0, 0, 0, 0, 0, 0, 0, 0, 0, 0, 0, 0, 0, 0, 0, 0, 0, 0, 0, 0, 0, 0, 0, 0, 0, 0, 0, 0, 0, 0, 0, 0, 1098, 1099, 0, 0, 0, 0, 0, 0, 0, 0, 0, 0, 0, 0, 0, 0, 0, 0, 0, 0, 0, 0, 0
0, 0, 0, 0, 0, 0, 0, 0, 0, 0, 0, 0, 0, 0, 0, 0, 0, 0, 0, 0, 0, 1100, 1101, 0, 0, 0, 0, 0, 0, 0, 0, 1094, 1095, 1094, 1095, 0, 0, 0, 0, 0, 0, 0, 0, 1094, 1095, 1094, 1095, 0, 0, 0, 0, 0, 0, 0, 0, 0, 0, 1100, 1101, 0, 0, 0, 0, 0, 0, 0, 0, 0, 0, 0, 0, 0, 0, 0, 0, 0, 0, 0, 0, 0
0, 0, 0, 0, 0, 0, 0, 0, 0, 0, 0, 0, 0, 0, 0, 0, 0, 0, 0, 0, 0, 1094, 1095, 0, 0, 0, 0, 0, 0, 0, 1094, 1096, 1097, 1096, 1097, 0, 0, 0, 0, 0, 0, 0, 0, 1096, 1097, 1096, 1094, 1095, 0, 0, 0, 0, 0, 0, 0, 0, 0, 1094, 1095, 0, 0, 0, 0, 0, 0, 0, 0, 0, 0, 0, 0, 0, 0, 0, 0, 0, 0, 0, 0, 0
0, 0, 0, 0, 0, 0, 0, 0, 0, 0, 0, 0, 0, 0, 0, 0, 0, 0, 0, 0, 0, 1096, 1097, 0, 0, 0, 0, 0, 0, 1094, 1096, 1097, 0, 1094, 1095, 0, 0, 0, 0, 0, 0, 0, 0, 1094, 1095, 0, 1096, 1094, 1095, 0, 0, 0, 0, 0, 0, 0, 0, 1096, 1097, 0, 0, 0, 0, 0, 0, 0, 0, 0, 0, 0, 0, 0, 0, 0, 0, 0, 0, 0, 0, 0
0, 0, 0, 0, 0, 0, 0, 0, 0, 0, 0, 0, 0, 0, 0, 0, 0, 0, 0, 0, 0, 1098, 1099, 0, 0, 0, 0, 1094, 1095, 1096, 1097, 0, 0, 1096, 1097, 0, 0, 0, 0, 0, 0, 0, 0, 1096, 1097, 0, 0, 1096, 1097, 1094, 1095, 0, 0, 0, 0, 0, 0, 1098, 1099, 0, 0, 0, 0, 0, 0, 0, 0, 0, 0, 0, 0, 0, 0, 0, 0, 0, 0, 0, 0, 0
0, 0, 0, 0, 0, 0, 0, 0, 0, 0, 0, 0, 0, 0, 0, 0, 0, 0, 0, 0, 0, 1100, 1101, 0, 0, 0, 0, 1096, 1097, 0, 0, 0, 0, 0, 1094, 1095, 0, 0, 0, 0, 0, 0, 1094, 1095, 0, 0, 0, 0, 0, 1096, 1097, 0, 0, 0, 0, 0, 0, 1100, 1101, 0, 0, 0, 0, 0, 0, 0, 0, 0, 0, 0, 0, 0, 0, 0, 0, 0, 0, 0, 0, 0
0, 0, 0, 0, 0, 0, 0, 0, 0, 0, 0, 0, 0, 0, 0, 0, 0, 0, 0, 0, 0, 1094, 1095, 0, 0, 0, 0, 1098, 1099, 0, 0, 0, 0, 0, 1096, 1097, 0, 0, 0, 0, 0, 0, 1096, 1097, 0, 0, 0, 0, 0, 1098, 1099, 0, 0, 0, 0, 0, 0, 1094, 1095, 0, 0, 0, 0, 0, 0, 0, 0, 0, 0, 0, 0, 0, 0, 0, 0, 0, 0, 0, 0, 0
0, 0, 0, 0, 0, 0, 0, 0, 0, 0, 0, 0, 0, 0, 0, 0, 0, 0, 0, 0, 0, 1096, 1097, 0, 0, 0, 0, 1100, 1101, 0, 0, 0, 0, 0, 0, 1094, 1095, 0, 0, 0, 0, 1094, 1095, 0, 0, 0, 0, 0, 0, 1100, 1101, 0, 0, 0, 0, 0, 0, 1096, 1097, 0, 0, 0, 0, 0, 0, 0, 0, 0, 0, 0, 0, 0, 0, 0, 0, 0, 0, 0, 0, 0
0, 0, 0, 0, 0, 0, 0, 0, 0, 0, 0, 0, 0, 0, 0, 0, 0, 0, 0, 0, 0, 1098, 1099, 0, 0, 0, 0, 1094, 1095, 0, 0, 0, 0, 0, 0, 1096, 1097, 0, 0, 0, 0, 1096, 1097, 0, 0, 0, 0, 0, 0, 1094, 1095, 0, 0, 0, 0, 0, 0, 1098, 1099, 0, 0, 0, 0, 0, 0, 0, 0, 0, 0, 0, 0, 0, 0, 0, 0, 0, 0, 0, 0, 0
0, 0, 0, 0, 0, 0, 0, 0, 0, 0, 0, 0, 0, 0, 0, 0, 0, 0, 0, 0, 0, 1100, 1101, 0, 0, 0, 0, 1094, 1095, 0, 0, 0, 0, 0, 0, 0, 1094, 1095, 0, 0, 1094, 1095, 0, 0, 0, 0, 0, 0, 0, 1096, 1097, 0, 0, 0, 0, 0, 0, 1100, 1101, 0, 0, 0, 0, 0, 0, 0, 0, 0, 0, 0, 0, 0, 0, 0, 0, 0, 0, 0, 0, 0
0, 0, 0, 0, 0, 0, 0, 0, 0, 0, 0, 0, 0, 0, 0, 0, 0, 0, 0, 0, 0, 1094, 1095, 0, 0, 0, 0, 1096, 1097, 0, 0, 0, 0, 0, 0, 0, 1096, 1097, 0, 0, 1096, 1097, 0, 0, 0, 0, 0, 0, 0, 1098, 1099, 0, 0, 0, 0, 0, 0, 1094, 1095, 0, 0, 0, 0, 0, 0, 0, 0, 0, 0, 0, 0, 0, 0, 0, 0, 0, 0, 0, 0, 0
0, 0, 0, 0, 0, 0, 0, 0, 0, 0, 0, 0, 0, 0, 0, 0, 0, 0, 0, 0, 0, 1096, 1097, 0, 0, 0, 0, 1098, 1099, 0, 0, 0, 0, 0, 0, 0, 0, 1094, 1095, 1094, 1095, 0, 0, 0, 0, 0, 0, 0, 0, 1100, 1101, 0, 0, 0, 0, 0, 0, 1096, 1097, 0, 0, 0, 0, 0, 0, 0, 0, 0, 0, 0, 0, 0, 0, 0, 0, 0, 0, 0, 0, 0
0, 0, 0, 0, 0, 0, 0, 0, 0, 0, 0, 0, 0, 0, 0, 0, 0, 0, 0, 0, 0, 1098, 1099, 0, 0, 0, 0, 1100, 1094, 1094, 1095, 0, 0, 0, 0, 0, 0, 1096, 1097, 1096, 1097, 0, 0, 0, 0, 0, 0, 1094, 1095, 1095, 1095, 1095, 0, 0, 0, 0, 0, 1098, 1099, 0, 0, 0, 0, 0, 0, 0, 0, 0, 0, 0, 0, 0, 0, 0, 0, 0, 0, 0, 0, 0
0, 0, 0, 0, 0, 0, 0, 0, 0, 0, 0, 0, 0, 0, 0, 0, 0, 0, 0, 0, 0, 1094, 1095, 0, 0, 0, 1094, 1095, 1094, 1096, 1097, 0, 0, 0, 0, 0, 0, 0, 1098, 1099, 0, 0, 0, 0, 0, 0, 0, 1096, 1097, 1097, 1097, 1097, 0, 0, 0, 0, 0, 1100, 1101, 0, 0, 0, 0, 0, 0, 0, 0, 0, 0, 0, 0, 0, 0, 0, 0, 0, 0, 0, 0, 0
0, 0, 0, 0, 0, 0, 0, 0, 0, 0, 0, 0, 0, 0, 0, 0, 0, 0, 0, 0, 0, 1096, 1097, 0, 0, 0, 1096, 1097, 1096, 1097, 1094, 1095, 0, 0, 0, 0, 0, 0, 1100, 1101, 0, 0, 0, 0, 0, 0, 1094, 1096, 1097, 0, 0, 1094, 1095, 0, 0, 0, 0, 1094, 1095, 0, 0, 0, 0, 0, 0, 0, 0, 0, 0, 0, 0, 0, 0, 0, 0, 0, 0, 0, 0, 0
0, 0, 0, 0, 0, 0, 0, 0, 0, 0, 0, 0, 0, 0, 0, 0, 0, 0, 0, 0, 0, 1098, 1099, 0, 0, 1094, 1095, 0, 0, 0, 1096, 1097, 1095, 0, 0, 0, 0, 0, 1094, 1095, 0, 0, 0, 0, 0, 1094, 1096, 1097, 0, 0, 0, 1096, 1097, 0, 0, 0, 0, 1096, 1097, 0, 0, 0, 0, 0, 0, 0, 0, 0, 0, 0, 0, 0, 0, 0, 0, 0, 0, 0, 0, 0
0, 0, 0, 0, 0, 0, 0, 0, 0, 0, 0, 0, 0, 0, 0, 0, 0, 0, 0, 0, 0, 1100, 1101, 0, 0, 1096, 1097, 0, 0, 0, 0, 1096, 1097, 0, 0, 0, 0, 1094, 1095, 1094, 1095, 0, 0, 0, 0, 1096, 1097, 0, 0, 0, 0, 1098, 1099, 0, 0, 0, 0, 1098, 1099, 0, 0, 0, 0, 0, 0, 0, 0, 0, 0, 0, 0, 0, 0, 0, 0, 0, 0, 0, 0, 0
0, 0, 0, 0, 0, 0, 0, 0, 0, 0, 0, 0, 0, 0, 0, 0, 0, 0, 0, 0, 0, 1094, 1095, 0, 0, 1098, 1099, 0, 0, 0, 0, 1098, 1099, 0, 0, 0, 0, 1096, 1097, 1096, 1097, 0, 0, 0, 0, 1098, 1099, 0, 0, 0, 0, 1100, 1101, 0, 0, 0, 0, 1100, 1101, 0, 0, 0, 0, 0, 0, 0, 0, 0, 0, 0, 0, 0, 0, 0, 0, 0, 0, 0, 0, 0
0, 0, 0, 0, 0, 0, 0, 0, 0, 0, 0, 0, 0, 0, 0, 0, 0, 0, 0, 0, 0, 1096, 1097, 0, 0, 1100, 1101, 0, 0, 0, 0, 1100, 1101, 0, 0, 0, 0, 0, 1096, 1097, 0, 0, 0, 0, 0, 1100, 1101, 0, 0, 0, 0, 1094, 1095, 0, 0, 0, 0, 1094, 1095, 0, 0, 0, 0, 0, 0, 0, 0, 0, 0, 0, 0, 0, 0, 0, 0, 0, 0, 0, 0, 0
0, 0, 0, 0, 0, 0, 0, 0, 0, 0, 0, 0, 0, 0, 0, 0, 0, 0, 0, 0, 0, 1098, 1099, 0, 0, 1094, 1095, 0, 0, 0, 0, 1094, 1095, 0, 0, 0, 0, 0, 1098, 1099, 0, 0, 0, 0, 0, 1094, 1095, 0, 0, 0, 0, 1094, 1095, 0, 0, 0, 0, 1096, 1097, 0, 0, 0, 0, 0, 0, 0, 0, 0, 0, 0, 0, 0, 0, 0, 0, 0, 0, 0, 0, 0
0, 0, 0, 0, 0, 0, 0, 0, 0, 0, 0, 0, 0, 0, 0, 0, 0, 0, 0, 0, 0, 1100, 1101, 0, 0, 1094, 1095, 0, 0, 0, 0, 1096, 1097, 0, 0, 0, 0, 0, 1100, 1101, 0, 0, 0, 0, 0, 1096, 1097, 0, 0, 0, 0, 1096, 1097, 0, 0, 0, 0, 1098, 1099, 0, 0, 0, 0, 0, 0, 0, 0, 0, 0, 0, 0, 0, 0, 0, 0, 0, 0, 0, 0, 0
0, 0, 0, 0, 0, 0, 0, 0, 0, 0, 0, 0, 0, 0, 0, 0, 0, 0, 0, 0, 0, 1094, 1095, 0, 0, 1094, 1095, 0, 0, 0, 0, 1098, 1099, 0, 0, 0, 0, 1094, 1095, 1094, 1095, 0, 0, 0, 0, 1098, 1099, 0, 0, 0, 0, 1094, 1095, 0, 0, 0, 0, 1100, 1101, 0, 0, 0, 0, 0, 0, 0, 0, 0, 0, 0, 0, 0, 0, 0, 0, 0, 0, 0, 0, 0
0, 0, 0, 0, 0, 0, 0, 0, 0, 0, 0, 0, 0, 0, 0, 0, 0, 0, 0, 0, 0, 1096, 1097, 0, 0, 1096, 1097, 0, 0, 0, 0, 1100, 1101, 0, 0, 0, 0, 1096, 1097, 1096, 1097, 0, 0, 0, 0, 1100, 1101, 0, 0, 0, 0, 1096, 1097, 0, 0, 0, 0, 1094, 1095, 0, 0, 0, 0, 0, 0, 0, 0, 0, 0, 0, 0, 0, 0, 0, 0, 0, 0, 0, 0, 0
0, 0, 0, 0, 0, 0, 0, 0, 0, 0, 0, 0, 0, 0, 0, 0, 0, 0, 0, 0, 0, 1098, 1099, 0, 0, 1098, 1099, 0, 0, 0, 0, 1094, 1095, 0, 0, 0, 1094, 1095, 0, 0, 1094, 1095, 0, 0, 0, 1094, 1095, 0, 0, 0, 0, 1098, 1099, 0, 0, 0, 0, 1096, 1097, 0, 0, 0, 0, 0, 0, 0, 0, 0, 0, 0, 0, 0, 0, 0, 0, 0, 0, 0, 0, 0
0, 0, 0, 0, 0, 0, 0, 0, 0, 0, 0, 0, 0, 0, 0, 0, 0, 0, 0, 0, 0, 1100, 1101, 0, 0, 1100, 1101, 0, 0, 0, 1094, 1095, 1097, 0, 0, 0, 1096, 1097, 0, 0, 1096, 1097, 0, 0, 0, 1096, 1094, 1095, 0, 0, 0, 1100, 1101, 0, 0, 0, 0, 1098, 1099, 0, 0, 0, 0, 0, 0, 0, 0, 0, 0, 0, 0, 0, 0, 0, 0, 0, 0, 0, 0, 0
0, 0, 0, 0, 0, 0, 0, 0, 0, 0, 0, 0, 0, 0, 0, 0, 0, 0, 0, 0, 0, 1094, 1095, 0, 0, 1094, 1095, 0, 0, 1094, 1096, 1097, 0, 0, 0, 0, 1094, 1095, 0, 0, 1094, 1095, 0, 0, 0, 0, 1096, 1097, 1095, 0, 0, 1094, 1095, 0, 0, 0, 0, 1100, 1101, 0, 0, 0, 0, 0, 0, 0, 0, 0, 0, 0, 0, 0, 0, 0, 0, 0, 0, 0, 0, 0
0, 0, 0, 0, 0, 0, 0, 0, 0, 0, 0, 0, 0, 0, 0, 0, 0, 0, 0, 0, 0, 1094, 1095, 0, 0, 1096, 1094, 1095, 1094, 1096, 1097, 0, 0, 0, 0, 0, 1096, 1097, 0, 0, 1096, 1097, 0, 0, 0, 0, 0, 1096, 1097, 1095, 1094, 1095, 1097, 0, 0, 0, 0, 1094, 1095, 0, 0, 0, 0, 0, 0, 0, 0, 0, 0, 0, 0, 0, 0, 0, 0, 0, 0, 0, 0, 0
0, 0, 0, 0, 0, 0, 0, 0, 0, 0, 0, 0, 0, 0, 0, 0, 0, 0, 0, 0, 0, 1096, 1097, 0, 0, 0, 1096, 1097, 1096, 1097, 0, 0, 0, 0, 0, 1094, 1095, 0, 0, 0, 0, 1094, 1095, 0, 0, 0, 0, 0, 1096, 1097, 1096, 1097, 0, 0, 0, 0, 0, 1096, 1097, 0, 0, 0, 0, 0, 0, 0, 0, 0, 0, 0, 0, 0, 0, 0, 0, 0, 0, 0, 0, 0
0, 0, 0, 0, 0, 0, 0, 0, 0, 0, 0, 0, 0, 0, 0, 0, 0, 0, 0, 0, 0, 1098, 1099, 0, 0, 0, 0, 1098, 1099, 0, 0, 0, 0, 0, 0, 1094, 1095, 0, 0, 0, 0, 1096, 1097, 0, 0, 0, 0, 0, 0, 1098, 1099, 0, 0, 0, 0, 0, 0, 1098, 1099, 0, 0, 0, 0, 0, 0, 0, 0, 0, 0, 0, 0, 0, 0, 0, 0, 0, 0, 0, 0, 0
0, 0, 0, 0, 0, 0, 0, 0, 0, 0, 0, 0, 0, 0, 0, 0, 0, 0, 0, 0, 0, 1100, 1101, 0, 0, 0, 0, 1100, 1101, 0, 0, 0, 0, 0, 0, 1094, 1095, 0, 0, 0, 0, 1094, 1095, 0, 0, 0, 0, 0, 0, 1100, 1101, 0, 0, 0, 0, 0, 0, 1100, 1101, 0, 0, 0, 0, 0, 0, 0, 0, 0, 0, 0, 0, 0, 0, 0, 0, 0, 0, 0, 0, 0
0, 0, 0, 0, 0, 0, 0, 0, 0, 0, 0, 0, 0, 0, 0, 0, 0, 0, 0, 0, 0, 1094, 1095, 0, 0, 0, 0, 1094, 1095, 0, 0, 0, 0, 0, 1094, 1096, 1097, 0, 0, 0, 0, 1096, 1097, 1095, 0, 0, 0, 0, 0, 1094, 1095, 0, 0, 0, 0, 0, 0, 1094, 1095, 0, 0, 0, 0, 0, 0, 0, 0, 0, 0, 0, 0, 0, 0, 0, 0, 0, 0, 0, 0, 0
0, 0, 0, 0, 0, 0, 0, 0, 0, 0, 0, 0, 0, 0, 0, 0, 0, 0, 0, 0, 0, 1096, 1097, 0, 0, 0, 0, 1096, 1097, 0, 0, 0, 0, 0, 1094, 1095, 0, 0, 0, 0, 0, 0, 1094, 1095, 0, 0, 0, 0, 0, 1096, 1097, 0, 0, 0, 0, 0, 0, 1096, 1097, 0, 0, 0, 0, 0, 0, 0, 0, 0, 0, 0, 0, 0, 0, 0, 0, 0, 0, 0, 0, 0
0, 0, 0, 0, 0, 0, 0, 0, 0, 0, 0, 0, 0, 0, 0, 0, 0, 0, 0, 0, 0, 1098, 1099, 0, 0, 0, 0, 1098, 1099, 0, 0, 0, 0, 0, 1096, 1097, 0, 0, 0, 0, 0, 0, 1096, 1097, 0, 0, 0, 0, 0, 1098, 1099, 0, 0, 0, 0, 0, 0, 1098, 1099, 0, 0, 0, 0, 0, 0, 0, 0, 0, 0, 0, 0, 0, 0, 0, 0, 0, 0, 0, 0, 0
0, 0, 0, 0, 0, 0, 0, 0, 0, 0, 0, 0, 0, 0, 0, 0, 0, 0, 0, 0, 0, 1100, 1101, 0, 0, 0, 0, 1100, 1101, 0, 0, 0, 0, 0, 1098, 1099, 0, 0, 0, 0, 0, 0, 1098, 1099, 0, 0, 0, 0, 0, 1100, 1101, 0, 0, 0, 0, 0, 0, 1100, 1101, 0, 0, 0, 0, 0, 0, 0, 0, 0, 0, 0, 0, 0, 0, 0, 0, 0, 0, 0, 0, 0
0, 0, 0, 0, 0, 0, 0, 0, 0, 0, 0, 0, 0, 0, 0, 0, 0, 0, 0, 0, 0, 1094, 1095, 0, 0, 0, 0, 1094, 1095, 0, 0, 0, 0, 0, 1100, 1101, 0, 0, 0, 0, 0, 0, 1100, 1101, 0, 0, 0, 0, 0, 1094, 1095, 0, 0, 0, 0, 0, 0, 1094, 1095, 0, 0, 0, 0, 0, 0, 0, 0, 0, 0, 0, 0, 0, 0, 0, 0, 0, 0, 0, 0, 0
0, 0, 0, 0, 0, 0, 0, 0, 0, 0, 0, 0, 0, 0, 0, 0, 0, 0, 0, 0, 0, 1096, 1097, 0, 0, 0, 0, 1096, 1097, 0, 0, 0, 0, 0, 1094, 1095, 0, 0, 0, 0, 0, 0, 1094, 1095, 0, 0, 0, 0, 0, 1096, 1097, 0, 0, 0, 0, 0, 0, 1096, 1097, 0, 0, 0, 0, 0, 0, 0, 0, 0, 0, 0, 0, 0, 0, 0, 0, 0, 0, 0, 0, 0
0, 0, 0, 0, 0, 0, 0, 0, 0, 0, 0, 0, 0, 0, 0, 0, 0, 0, 0, 0, 0, 1098, 1099, 0, 0, 0, 0, 1094, 1095, 1096, 1097, 1098, 1099, 1100, 1096, 1097, 0, 0, 0, 0, 0, 0, 1096, 1097, 1095, 1096, 1097, 1098, 1099, 1100, 1101, 0, 0, 0, 0, 0, 0, 1098, 1099, 0, 0, 0, 0, 0, 0, 0, 0, 0, 0, 0, 0, 0, 0, 0, 0, 0, 0, 0, 0, 0
0, 0, 0, 0, 0, 0, 0, 0, 0, 0, 0, 0, 0, 0, 0, 0, 0, 0, 0, 0, 0, 1100, 1101, 0, 0, 0, 0, 1094, 1095, 1096, 1097, 1098, 1099, 1100, 1101, 0, 0, 0, 0, 0, 0, 0, 0, 1094, 1095, 1096, 1097, 1098, 1099, 1100, 1101, 0, 0, 0, 0, 0, 0, 1100, 1101, 0, 0, 0, 0, 0, 0, 0, 0, 0, 0, 0, 0, 0, 0, 0, 0, 0, 0, 0, 0, 0
0, 0, 0, 0, 0, 0, 0, 0, 0, 0, 0, 0, 0, 0, 0, 0, 0, 0, 0, 0, 0, 1094, 1095, 0, 0, 0, 0, 0, 0, 0, 0, 0, 0, 0, 0, 0, 0, 0, 0, 0, 0, 0, 0, 0, 0, 0, 0, 0, 0, 0, 0, 0, 0, 0, 0, 0, 0, 1094, 1095, 0, 0, 0, 0, 0, 0, 0, 0, 0, 0, 0, 0, 0, 0, 0, 0, 0, 0, 0, 0, 0
0, 0, 0, 0, 0, 0, 0, 0, 0, 0, 0, 0, 0, 0, 0, 0, 0, 0, 0, 0, 0, 1096, 1097, 0, 0, 0, 0, 0, 0, 0, 0, 0, 0, 0, 0, 0, 0, 0, 0, 0, 0, 0, 0, 0, 0, 0, 0, 0, 0, 0, 0, 0, 0, 0, 0, 0, 0, 1096, 1097, 0, 0, 0, 0, 0, 0, 0, 0, 0, 0, 0, 0, 0, 0, 0, 0, 0, 0, 0, 0, 0
0, 0, 0, 0, 0, 0, 0, 0, 0, 0, 0, 0, 0, 0, 0, 0, 0, 0, 0, 0, 0, 1098, 1099, 1094, 1095, 1096, 1097, 1098, 1099, 1100, 1094, 1095, 1096, 1097, 1098, 1099, 1100, 1101, 1094, 1095, 1096, 1097, 1098, 1099, 1100, 1101, 1099, 1100, 1101, 1094, 1095, 1096, 1097, 1098, 1099, 1100, 1101, 1098, 1099, 0, 0, 0, 0, 0, 0, 0, 0, 0, 0, 0, 0, 0, 0, 0, 0, 0, 0, 0, 0, 0
0, 0, 0, 0, 0, 0, 0, 0, 0, 0, 0, 0, 0, 0, 0, 0, 0, 0, 0, 0, 0, 1100, 1101, 1094, 1095, 1096, 1097, 1098, 1099, 1100, 1094, 1095, 1096, 1097, 1098, 1099, 1100, 1101, 1094, 1095, 1096, 1097, 1098, 1099, 1100, 1101, 1099, 1100, 1101, 1094, 1095, 1096, 1097, 1098, 1099, 1100, 1101, 1100, 1101, 0, 0, 0, 0, 0, 0, 0, 0, 0, 0, 0, 0, 0, 0, 0, 0, 0, 0, 0, 0, 0
0, 0, 0, 0, 0, 0, 0, 0, 0, 0, 0, 0, 0, 0, 0, 0, 0, 0, 0, 0, 0, 0, 0, 0, 0, 0, 0, 0, 0, 0, 0, 0, 0, 0, 0, 0, 0, 0, 0, 0, 0, 0, 0, 0, 0, 0, 0, 0, 0, 0, 0, 0, 0, 0, 0, 0, 0, 0, 0, 0, 0, 0, 0, 0, 0, 0, 0, 0, 0, 0, 0, 0, 0, 0, 0, 0, 0, 0, 0, 0
0, 0, 0, 0, 0, 0, 0, 0, 0, 0, 0, 0, 0, 0, 0, 0, 0, 0, 0, 0, 0, 0, 0, 0, 0, 0, 0, 0, 0, 0, 0, 0, 0, 0, 0, 0, 0, 0, 0, 0, 0, 0, 0, 0, 0, 0, 0, 0, 0, 0, 0, 0, 0, 0, 0, 0, 0, 0, 0, 0, 0, 0, 0, 0, 0, 0, 0, 0, 0, 0, 0, 0, 0, 0, 0, 0, 0, 0, 0, 0
0, 0, 0, 0, 0, 0, 0, 0, 0, 0, 0, 0, 0, 0, 0, 0, 0, 0, 0, 0, 0, 0, 0, 0, 0, 0, 0, 0, 0, 0, 0, 0, 0, 0, 0, 0, 0, 0, 0, 0, 0, 0, 0, 0, 0, 0, 0, 0, 0, 0, 0, 0, 0, 0, 0, 0, 0, 0, 0, 0, 0, 0, 0, 0, 0, 0, 0, 0, 0, 0, 0, 0, 0, 0, 0, 0, 0, 0, 0, 0
0, 0, 0, 0, 0, 0, 0, 0, 0, 0, 0, 0, 0, 0, 0, 0, 0, 0, 0, 0, 0, 0, 0, 0, 0, 0, 0, 0, 0, 0, 0, 0, 0, 0, 0, 0, 0, 0, 0, 0, 0, 0, 0, 0, 0, 0, 0, 0, 0, 0, 0, 0, 0, 0, 0, 0, 0, 0, 0, 0, 0, 0, 0, 0, 0, 0, 0, 0, 0, 0, 0, 0, 0, 0, 0, 0, 0, 0, 0, 0
0, 0, 0, 0, 0, 0, 0, 0, 0, 0, 0, 0, 0, 0, 0, 0, 0, 0, 0, 0, 0, 0, 0, 0, 0, 0, 0, 0, 0, 0, 0, 0, 0, 0, 0, 0, 0, 0, 0, 0, 0, 0, 0, 0, 0, 0, 0, 0, 0, 0, 0, 0, 0, 0, 0, 0, 0, 0, 0, 0, 0, 0, 0, 0, 0, 0, 0, 0, 0, 0, 0, 0, 0, 0, 0, 0, 0, 0, 0, 0
0, 0, 0, 0, 0, 0, 0, 0, 0, 0, 0, 0, 0, 0, 0, 0, 0, 0, 0, 0, 0, 0, 0, 0, 0, 0, 0, 0, 0, 0, 0, 0, 0, 0, 0, 0, 0, 0, 0, 0, 0, 0, 0, 0, 0, 0, 0, 0, 0, 0, 0, 0, 0, 0, 0, 0, 0, 0, 0, 0, 0, 0, 0, 0, 0, 0, 0, 0, 0, 0, 0, 0, 0, 0, 0, 0, 0, 0, 0, 0
