1102, 1102, 1102, 1102, 1102, 1102, 1102, 1102, 1102, 1102, 1102, 1102, 1102, 1102, 1102, 1102, 1102, 1102, 1102, 1102, 1102, 1102, 1102, 1102, 1102, 1102, 1102, 1136, 1136, 1102, 1102, 1102, 1102, 1102, 1102, 1102, 1102, 1102, 1102, 1102, 1102, 1102, 1102, 1102, 1102, 1102, 1102, 1102, 1102, 1102, 1102, 1102, 1102, 1102, 1102, 1102, 1102, 1102, 1102, 1102, 1102, 1102, 1102, 1102, 1102, 1102, 1102, 1102, 1102, 1102, 1102, 1102, 1102, 1102, 1102, 1102, 1102, 1102, 1102, 1102
1102, 1102, 1102, 1102, 1102, 1102, 1072, 1072, 1102, 1102, 1102, 1102, 1102, 1102, 1102, 1102, 1102, 1102, 1102, 1102, 1102, 1102, 1102, 1102, 1102, 1102, 1102, 1136, 1136, 1102, 1102, 1102, 1102, 1102, 1102, 1102, 1102, 1102, 1102, 1102, 1102, 1102, 1102, 1102, 1102, 1102, 1102, 1102, 1102, 1102, 1102, 1102, 1102, 1102, 1102, 1102, 1102, 1102, 1102, 1102, 1102, 1102, 1102, 1102, 1102, 1102, 1102, 1102, 1102, 1102, 1102, 1102, 1102, 1102, 1102, 1102, 1102, 1102, 1102, 1102
1102, 1102, 1102, 1102, 1102, 1102, 1072, 1072, 1102, 1102, 1102, 1102, 1102, 1102, 1102, 1102, 1102, 1102, 1102, 1102, 1102, 1102, 1102, 1102, 1102, 1102, 1102, 1102, 1102, 1102, 1102, 1102, 1102, 1102, 1102, 1102, 1102, 1102, 1102, 1102, 1102, 1102, 1102, 1102, 1102, 1102, 1102, 1102, 1102, 1102, 1102, 1102, 1102, 1102, 1102, 1102, 1102, 1102, 1102, 1102, 1102, 1102, 1102, 1102, 1102, 1102, 1102, 1102, 1102, 1102, 1102, 1102, 1102, 1102, 1102, 1102, 1102, 1102, 1102, 1102
1102, 1102, 1102, 1102, 1102, 1102, 1102, 1102, 1102, 1102, 1102, 1102, 1102, 1102, 1102, 1102, 1102, 1102, 1102, 1102, 1102, 1102, 1102, 1102, 1102, 1102, 1102, 1102, 1102, 1102, 1102, 1102, 1102, 1102, 1102, 1102, 1102, 1102, 1102, 1102, 1102, 1102, 1102, 1102, 1102, 1102, 1102, 1102, 1102, 1102, 1102, 1102, 1102, 1102, 1102, 1102, 1102, 1102, 1102, 1102, 1102, 1102, 1102, 1102, 1102, 1102, 1102, 1102, 1102, 1102, 1102, 1102, 1102, 1102, 1102, 1102, 1102, 1102, 1102, 1102
1102, 1102, 1102, 1102, 1102, 1102, 1102, 1102, 1102, 1102, 1102, 1102, 1102, 1102, 1102, 1102, 1102, 1102, 1102, 1102, 1102, 1102, 1102, 1102, 1102, 1102, 1102, 1102, 1102, 1102, 1102, 1102, 1102, 1102, 1102, 1102, 1102, 1102, 1102, 1102, 1102, 1102, 1102, 1102, 1102, 1102, 1102, 1102, 1102, 1102, 1102, 1102, 1102, 1102, 1102, 1102, 1102, 1102, 1102, 1102, 1102, 1102, 1102, 1102, 1102, 1102, 1102, 1102, 1102, 1102, 1102, 1102, 1102, 1102, 1102, 1102, 1102, 1102, 1102, 1102
1102, 1102, 1102, 1102, 1102, 1102, 1102, 1102, 1102, 1102, 1102, 1102, 1102, 1102, 1102, 1102, 1102, 1102, 1102, 1102, 1102, 1102, 1102, 1102, 1102, 1102, 1102, 1102, 1102, 1102, 1102, 1102, 1102, 1102, 1102, 1102, 1102, 1102, 1102, 1102, 1102, 1102, 1102, 1102, 1102, 1102, 1102, 1102, 1102, 1102, 1102, 1102, 1102, 1102, 1102, 1102, 1102, 1102, 1102, 1102, 1102, 1102, 1102, 1102, 1102, 1102, 1102, 1102, 1102, 1102, 1102, 1102, 1102, 1102, 1102, 1102, 1102, 1102, 1102, 1102
1102, 1102, 1102, 1102, 1102, 1102, 1102, 1102, 1102, 1102, 1102, 1102, 1102, 1102, 1102, 1102, 1102, 1102, 1102, 1102, 1102, 1102, 1102, 1102, 1102, 1102, 1102, 1102, 1102, 1102, 1102, 1102, 1102, 1102, 1102, 1102, 1102, 1102, 1102, 1102, 1102, 1102, 1102, 1102, 1102, 1102, 1102, 1102, 1102, 1102, 1102, 1102, 1102, 1102, 1102, 1102, 1102, 1102, 1102, 1102, 1102, 1102, 1102, 1102, 1102, 1102, 1102, 1102, 1102, 1102, 1102, 1102, 1102, 1102, 1102, 1102, 1102, 1102, 1102, 1102
1102, 1102, 1102, 1102, 1102, 1102, 1102, 1102, 1102, 1102, 1102, 1102, 1102, 1102, 1102, 1102, 1102, 1102, 1102, 1102, 1102, 1102, 1102, 1102, 1102, 1102, 1102, 1102, 1102, 1102, 1102, 1102, 1102, 1102, 1102, 1102, 1102, 1102, 1102, 1102, 1102, 1102, 1102, 1102, 1102, 1102, 1102, 1102, 1102, 1102, 1102, 1102, 1102, 1102, 1102, 1102, 1102, 1102, 1102, 1102, 1102, 1102, 1102, 1102, 1102, 1102, 1102, 1102, 1102, 1102, 1102, 1102, 1102, 1102, 1102, 1102, 1102, 1102, 1102, 1102
1102, 1102, 1102, 1102, 1102, 1102, 1102, 1102, 1102, 1102, 1102, 1102, 1102, 1102, 1102, 1102, 1102, 1102, 1102, 1102, 1102, 1102, 1102, 1102, 1102, 1102, 1102, 1102, 1102, 1102, 1102, 1102, 1102, 1102, 1102, 1102, 1102, 1102, 1102, 1102, 1102, 1102, 1102, 1102, 1102, 1102, 1102, 1102, 1102, 1102, 1102, 1102, 1102, 1102, 1102, 1102, 1102, 1102, 1102, 1102, 1102, 1102, 1102, 1102, 1102, 1102, 1102, 1102, 1102, 1102, 1102, 1102, 1102, 1102, 1102, 1102, 1102, 1102, 1102, 1102
1102, 1102, 1102, 1102, 1102, 1102, 1102, 1102, 1102, 1102, 1102, 1102, 1102, 1102, 1102, 1102, 1102, 1102, 1102, 1102, 1102, 1102, 1102, 1102, 1102, 1102, 1102, 1102, 1102, 1102, 1102, 1102, 1102, 1102, 1102, 1102, 1102, 1102, 1102, 1102, 1102, 1102, 1102, 1102, 1102, 1102, 1102, 1102, 1102, 1102, 1102, 1102, 1102, 1102, 1102, 1102, 1102, 1102, 1102, 1102, 1102, 1102, 1102, 1102, 1102, 1102, 1102, 1102, 1102, 1102, 1102, 1102, 1102, 1102, 1102, 1102, 1102, 1102, 1102, 1102
1102, 1102, 1102, 1102, 1102, 1102, 1102, 1102, 1102, 1102, 1102, 1102, 1102, 1102, 1102, 1102, 1102, 1102, 1102, 1102, 1102, 1102, 1102, 1102, 1102, 1102, 1102, 1102, 1102, 1102, 1102, 1102, 1102, 1102, 1102, 1102, 1102, 1102, 1102, 1102, 1102, 1102, 1102, 1102, 1102, 1102, 1102, 1102, 1102, 1102, 1102, 1102, 1102, 1102, 1102, 1102, 1102, 1102, 1102, 1102, 1102, 1102, 1102, 1102, 1102, 1102, 1102, 1102, 1102, 1102, 1102, 1102, 1102, 1102, 1102, 1102, 1102, 1102, 1102, 1102
1102, 1102, 1102, 1102, 1102, 1102, 1102, 1102, 1102, 1102, 1102, 1102, 1102, 1102, 1102, 1102, 1102, 1102, 1102, 1102, 1102, 1102, 1102, 1102, 1102, 1102, 1102, 1073, 1073, 1073, 1073, 1073, 1102, 1102, 1102, 1102, 1102, 1102, 1102, 1102, 1102, 1102, 1102, 1102, 1102, 1102, 1102, 1102, 1102, 1102, 1102, 1102, 1102, 1102, 1102, 1102, 1102, 1102, 1102, 1102, 1102, 1102, 1102, 1102, 1102, 1102, 1102, 1102, 1102, 1102, 1102, 1102, 1102, 1102, 1102, 1102, 1102, 1102, 1102, 1102
1102, 1102, 1102, 1102, 1102, 1102, 1102, 1102, 1102, 1102, 1102, 1102, 1102, 1102, 1102, 1102, 1102, 1102, 1102, 1073, 1073, 1102, 1102, 1102, 1102, 1102, 1102, 1073, 1073, 1073, 1136, 1073, 1102, 1102, 1102, 1102, 1102, 1102, 1102, 1102, 1102, 1102, 1102, 1102, 1102, 1102, 1102, 1102, 1102, 1102, 1102, 1102, 1102, 1102, 1102, 1102, 1102, 1102, 1102, 1102, 1102, 1102, 1102, 1102, 1102, 1102, 1102, 1102, 1102, 1102, 1102, 1102, 1102, 1102, 1102, 1102, 1102, 1102, 1102, 1102
1102, 1102, 1102, 1102, 1102, 1102, 1102, 1102, 1102, 1102, 1102, 1102, 1102, 1102, 1102, 1102, 1102, 1102, 1102, 1102, 1073, 1102, 1102, 1102, 1102, 1102, 1102, 1102, 1073, 1073, 1073, 1073, 1102, 1102, 1102, 1102, 1102, 1102, 1102, 1102, 1102, 1102, 1102, 1102, 1102, 1102, 1102, 1102, 1102, 1102, 1102, 1102, 1102, 1102, 1102, 1102, 1102, 1102, 1102, 1102, 1102, 1102, 1102, 1102, 1102, 1102, 1102, 1102, 1102, 1102, 1102, 1102, 1102, 1102, 1102, 1102, 1102, 1102, 1102, 1102
1102, 1102, 1102, 1102, 1102, 1102, 1102, 1102, 1102, 1102, 1102, 1102, 1102, 1102, 1102, 1089, 1090, 1090, 1095, 1095, 1095, 1095, 1095, 1095, 1095, 1095, 1095, 1095, 1095, 1095, 1095, 1095, 1095, 1095, 1095, 1095, 1095, 1095, 1095, 1096, 1096, 1053, 1053, 1095, 1095, 1095, 1095, 1095, 1091, 1091, 1091, 1091, 1091, 1091, 1091, 1091, 1091, 1091, 1091, 1091, 1091, 1091, 1091, 1091, 1091, 1091, 1091, 1091, 1091, 1091, 1091, 1100, 1102, 1102, 1102, 1102, 1102, 1102, 1102, 1102
1102, 1102, 1102, 1102, 1102, 1102, 1102, 1102, 1102, 1102, 1102, 1102, 1102, 1102, 1102, 1071, 34, 35, 147, 147, 332, 333, 334, 335, 147, 147, 147, 1053, 1053, 147, 147, 147, 147, 147, 147, 147, 147, 147, 147, 728, 728, 1052, 1052, 147, 147, 147, 147, 147, 8, 9, 10, 11, 12, 13, 14, 15, 16, 17, 18, 19, 20, 21, 22, 23, 24, 25, 26, 27, 28, 29, 19, 1074, 1102, 1102, 1102, 1102, 1102, 1102, 1102, 1102
1102, 1102, 1102, 1102, 1102, 1102, 1102, 1102, 1102, 1102, 1102, 1102, 1102, 1102, 1102, 1071, 66, 67, 68, 32, 364, 365, 366, 367, 33, 34, 35, 1053, 1053, 38, 39, 40, 41, 42, 43, 44, 45, 46, 47, 48, 32, 33, 34, 35, 36, 37, 38, 39, 40, 41, 42, 43, 44, 45, 46, 47, 48, 49, 50, 51, 52, 53, 54, 55, 56, 57, 58, 59, 60, 61, 51, 1074, 1102, 1102, 1102, 1102, 1102, 1102, 1102, 1102
1102, 1102, 1102, 1102, 1102, 1102, 1102, 1102, 1102, 1102, 1102, 1102, 1102, 1102, 1102, 1071, 98, 99, 100, 64, 396, 397, 398, 399, 65, 66, 67, 68, 69, 70, 71, 72, 73, 74, 75, 76, 77, 78, 79, 80, 64, 65, 66, 67, 68, 69, 70, 71, 72, 73, 74, 75, 76, 77, 78, 79, 80, 81, 82, 83, 84, 85, 86, 87, 88, 89, 90, 91, 92, 93, 83, 1074, 1102, 1102, 1102, 1102, 1102, 1102, 1102, 1102
1102, 1102, 1102, 1102, 1102, 1102, 1102, 1102, 1102, 1102, 1102, 1102, 1102, 1102, 1102, 1071, 0, 1, 2, 96, 428, 429, 430, 431, 97, 98, 99, 100, 101, 102, 103, 104, 105, 106, 107, 108, 109, 0, 1, 2, 96, 97, 98, 99, 100, 101, 102, 103, 104, 105, 106, 107, 108, 109, 110, 111, 112, 113, 114, 115, 116, 117, 118, 119, 120, 121, 122, 123, 124, 125, 115, 1074, 1105, 1102, 1102, 1102, 1102, 1102, 1102, 1102
1102, 1102, 1102, 1102, 1102, 1102, 1102, 1102, 1102, 1102, 1102, 1102, 1102, 1102, 1102, 1071, 32, 33, 34, 128, 129, 130, 697, 128, 129, 130, 131, 132, 133, 134, 135, 136, 137, 138, 139, 140, 141, 32, 33, 34, 128, 129, 130, 131, 132, 133, 1053, 1053, 136, 137, 138, 139, 140, 141, 142, 143, 144, 145, 146, 147, 148, 149, 150, 151, 152, 153, 154, 155, 156, 157, 147, 1074, 1105, 1102, 1102, 1102, 1102, 1102, 1102, 1102
1102, 1102, 1102, 1102, 1102, 1102, 1102, 1102, 1102, 1102, 1102, 1102, 1102, 1102, 1102, 1071, 64, 65, 66, 160, 161, 162, 697, 0, 1, 2, 3, 4, 5, 6, 7, 8, 9, 10, 11, 12, 13, 64, 65, 66, 160, 161, 162, 163, 164, 165, 1053, 1053, 168, 169, 170, 171, 172, 173, 174, 175, 176, 177, 178, 179, 180, 181, 182, 183, 184, 185, 186, 187, 188, 189, 179, 1106, 1105, 1102, 1102, 1102, 1102, 1102, 1102, 1102
1102, 1102, 1102, 1102, 1102, 1102, 1102, 1102, 1102, 1102, 1102, 1102, 1102, 1102, 1102, 1071, 96, 97, 98, 192, 193, 194, 697, 32, 33, 34, 35, 36, 37, 38, 39, 40, 41, 42, 1053, 1053, 45, 96, 97, 98, 192, 193, 194, 195, 196, 197, 198, 199, 200, 201, 202, 203, 204, 205, 206, 207, 208, 209, 210, 211, 212, 213, 332, 333, 334, 335, 218, 219, 220, 221, 211, 1106, 1105, 1102, 1102, 1102, 1102, 1102, 1102, 1102
1102, 1102, 1102, 1102, 1102, 1102, 1102, 1102, 1102, 1102, 1102, 1102, 1102, 1102, 1102, 1071, 128, 129, 130, 224, 225, 226, 227, 64, 65, 66, 67, 68, 69, 70, 71, 72, 73, 74, 1053, 1053, 77, 128, 129, 130, 224, 225, 226, 227, 228, 229, 230, 231, 232, 233, 234, 235, 236, 1053, 1053, 409, 409, 241, 242, 243, 244, 245, 364, 365, 366, 367, 250, 251, 252, 253, 243, 1106, 1102, 1102, 1102, 1102, 1102, 1102, 1102, 1102
1102, 1102, 1102, 1102, 1102, 1102, 1102, 1102, 1102, 1102, 1102, 1102, 1102, 1102, 1102, 1071, 160, 161, 162, 256, 257, 258, 259, 96, 1053, 1053, 99, 100, 101, 102, 103, 104, 1053, 1053, 107, 108, 109, 160, 332, 333, 334, 335, 258, 259, 260, 261, 262, 263, 264, 265, 266, 267, 268, 1053, 1053, 409, 409, 273, 274, 275, 276, 277, 396, 397, 398, 399, 282, 283, 284, 285, 275, 1106, 1102, 1102, 1102, 1102, 1102, 1102, 1102, 1102
1102, 1102, 1102, 1102, 1102, 1102, 1102, 1102, 1102, 1102, 1102, 1102, 1102, 1102, 1102, 1071, 311, 311, 194, 288, 289, 290, 291, 128, 1053, 1053, 131, 132, 133, 134, 135, 136, 1053, 1053, 139, 140, 141, 192, 364, 365, 366, 367, 290, 291, 292, 293, 294, 295, 296, 297, 298, 299, 300, 301, 302, 303, 304, 305, 306, 307, 308, 309, 428, 429, 430, 431, 314, 315, 316, 317, 307, 1106, 1105, 1102, 1102, 1102, 1102, 1102, 1102, 1102
1102, 1102, 1102, 1102, 1102, 1102, 1102, 1102, 1102, 1102, 1102, 1102, 1102, 1102, 1102, 1071, 311, 311, 226, 320, 321, 322, 323, 160, 1053, 1053, 163, 164, 165, 166, 1053, 1053, 169, 170, 171, 172, 173, 224, 396, 397, 398, 399, 322, 323, 324, 325, 326, 327, 328, 329, 330, 331, 332, 333, 334, 335, 336, 337, 338, 339, 340, 341, 342, 343, 344, 345, 346, 347, 348, 349, 339, 1106, 1105, 1102, 1102, 1102, 1102, 1102, 1102, 1102
1102, 1102, 1102, 1102, 1102, 1102, 1102, 1102, 1102, 1102, 1102, 1102, 1102, 1102, 1102, 1071, 1053, 1053, 258, 352, 353, 354, 355, 192, 1053, 1053, 195, 196, 197, 198, 1053, 1053, 201, 202, 203, 204, 0, 256, 428, 429, 430, 431, 354, 355, 356, 357, 358, 359, 360, 361, 362, 363, 364, 365, 366, 367, 368, 369, 370, 371, 372, 373, 374, 375, 376, 377, 378, 379, 380, 381, 371, 1106, 1105, 1102, 1102, 1102, 1102, 1102, 1102, 1102
1102, 1102, 1102, 1072, 1072, 1072, 1072, 1072, 1072, 1072, 1072, 1072, 1072, 1102, 1102, 1071, 1053, 1053, 290, 384, 385, 386, 387, 224, 1053, 1053, 227, 228, 229, 230, 1053, 1053, 233, 234, 235, 236, 332, 333, 334, 335, 335, 385, 386, 387, 388, 389, 390, 391, 392, 393, 394, 395, 396, 397, 398, 399, 400, 401, 402, 403, 404, 405, 406, 407, 408, 409, 410, 411, 412, 413, 403, 1106, 1105, 1102, 1102, 1102, 1102, 1102, 1102, 1102
1072, 1072, 1072, 1072, 1072, 1072, 1072, 1072, 1072, 1072, 1072, 1072, 1072, 1102, 1102, 1103, 1053, 1053, 322, 416, 417, 418, 419, 256, 1053, 1053, 1053, 1053, 1053, 1053, 1053, 1053, 265, 266, 267, 268, 364, 365, 366, 367, 367, 417, 418, 419, 420, 421, 422, 423, 424, 425, 426, 427, 428, 429, 430, 431, 432, 433, 434, 435, 436, 437, 438, 439, 440, 441, 442, 443, 444, 445, 435, 1106, 1102, 1102, 1102, 1102, 1102, 1102, 1102, 1102
1072, 1072, 1072, 1072, 1072, 1072, 1072, 1072, 1072, 1072, 1072, 1072, 1072, 1072, 1102, 1103, 352, 353, 354, 448, 449, 450, 0, 1, 1053, 1053, 1053, 1053, 1053, 1053, 1053, 1053, 10, 11, 12, 13, 396, 397, 398, 399, 399, 449, 450, 451, 452, 453, 454, 455, 456, 457, 458, 459, 460, 461, 462, 463, 464, 465, 466, 467, 468, 469, 470, 471, 472, 473, 474, 475, 476, 477, 24, 1106, 1102, 1102, 1102, 1102, 1102, 1102, 1102, 1102
1072, 1072, 1072, 1072, 1072, 1072, 1072, 1072, 1072, 1072, 1072, 1072, 1072, 1072, 1102, 1103, 384, 385, 386, 0, 1, 2, 32, 33, 405, 405, 405, 405, 405, 405, 1053, 1053, 42, 43, 44, 45, 428, 429, 430, 431, 431, 406, 482, 483, 484, 485, 486, 487, 488, 489, 490, 491, 492, 493, 494, 332, 333, 334, 335, 499, 500, 501, 502, 503, 504, 505, 506, 507, 508, 509, 24, 1106, 1102, 1102, 1102, 1102, 1102, 1102, 1102, 1102
1072, 1072, 1072, 1072, 1072, 1072, 1072, 1072, 1072, 1072, 1072, 1072, 1072, 1072, 1102, 1103, 416, 417, 418, 32, 33, 34, 64, 65, 405, 405, 405, 405, 405, 405, 1053, 1053, 305, 305, 76, 77, 128, 416, 417, 418, 406, 406, 514, 515, 516, 517, 518, 519, 1053, 1053, 522, 523, 524, 525, 526, 332, 333, 334, 335, 531, 532, 533, 534, 535, 536, 537, 538, 539, 540, 541, 56, 1106, 1102, 1102, 1102, 1102, 1102, 1102, 1102, 1102
1072, 1072, 1072, 1072, 1072, 1072, 1072, 1072, 1072, 1072, 1072, 1072, 1072, 1072, 1102, 1103, 448, 449, 450, 64, 65, 66, 96, 97, 98, 99, 100, 101, 102, 103, 1053, 1053, 305, 305, 108, 109, 160, 448, 449, 450, 406, 406, 546, 547, 548, 549, 550, 551, 1053, 1053, 554, 555, 556, 557, 558, 364, 365, 366, 367, 563, 564, 565, 566, 567, 568, 569, 570, 571, 572, 573, 88, 1106, 1102, 1102, 1102, 1102, 1102, 1102, 1102, 1102
1072, 1072, 1072, 1072, 1072, 1072, 1072, 1072, 1072, 1072, 1072, 1072, 1072, 1072, 1102, 1103, 0, 1, 2, 96, 97, 98, 128, 129, 130, 131, 132, 133, 134, 135, 1053, 1053, 138, 139, 140, 141, 192, 480, 481, 1053, 1053, 1053, 485, 486, 487, 488, 489, 490, 491, 492, 493, 494, 495, 496, 497, 396, 397, 398, 399, 502, 503, 504, 505, 506, 507, 508, 509, 117, 118, 119, 120, 1106, 1102, 1102, 1102, 1102, 1102, 1102, 1102, 1102
1072, 1072, 1072, 1072, 1072, 1072, 1072, 1072, 1072, 1072, 1072, 1072, 1072, 1072, 1102, 1103, 343, 343, 34, 128, 129, 130, 160, 161, 162, 163, 164, 165, 166, 167, 1053, 1053, 170, 171, 172, 173, 224, 512, 513, 1053, 1053, 1053, 517, 518, 519, 520, 521, 522, 523, 524, 525, 526, 527, 528, 529, 428, 429, 430, 431, 534, 535, 536, 537, 538, 539, 540, 541, 149, 150, 151, 152, 1106, 1102, 1102, 1102, 1102, 1102, 1102, 1102, 1102
1072, 1072, 1072, 1072, 1072, 1072, 1072, 1072, 1072, 1072, 1072, 1072, 1072, 1072, 1102, 1103, 765, 765, 765, 765, 765, 765, 765, 765, 194, 195, 196, 197, 198, 199, 1053, 1053, 202, 203, 204, 205, 256, 544, 545, 546, 406, 406, 549, 550, 551, 552, 553, 554, 555, 556, 557, 558, 559, 560, 561, 562, 563, 564, 565, 566, 567, 568, 569, 570, 571, 572, 573, 181, 182, 183, 184, 1106, 1102, 1102, 1102, 1102, 1102, 1102, 1102, 1102
1072, 1072, 1072, 1072, 1072, 1072, 1072, 1072, 1072, 1072, 1072, 1072, 1072, 1072, 1102, 1103, 765, 765, 765, 765, 765, 765, 765, 765, 343, 343, 228, 229, 230, 231, 1053, 1053, 234, 235, 236, 237, 288, 289, 290, 291, 406, 406, 294, 295, 296, 297, 298, 299, 300, 301, 302, 303, 305, 305, 1053, 1053, 308, 309, 310, 311, 312, 313, 314, 315, 316, 317, 212, 213, 214, 215, 216, 1106, 1102, 1102, 1102, 1102, 1102, 1102, 1102, 1102
1072, 1072, 1072, 1072, 1072, 1072, 1072, 1072, 1072, 1072, 1072, 1072, 1072, 1072, 1102, 1103, 1053, 1053, 1053, 1053, 1053, 1053, 1053, 1053, 343, 343, 260, 261, 262, 263, 1053, 1053, 266, 267, 268, 269, 320, 321, 322, 323, 324, 325, 326, 327, 328, 329, 330, 331, 332, 333, 334, 335, 305, 305, 1053, 1053, 340, 341, 342, 343, 344, 345, 346, 347, 348, 349, 244, 245, 246, 247, 248, 1106, 1102, 1102, 1102, 1102, 1102, 1102, 1102, 1102
1072, 1072, 1072, 1072, 1072, 1072, 1072, 1072, 1072, 1072, 1072, 1072, 1072, 1072, 1102, 1103, 1053, 1053, 1053, 1053, 1053, 1053, 1053, 1053, 290, 291, 292, 293, 294, 295, 1053, 1053, 298, 305, 305, 1053, 1053, 353, 354, 355, 356, 357, 358, 359, 360, 361, 362, 363, 364, 365, 366, 367, 368, 369, 1053, 1053, 372, 373, 374, 375, 376, 377, 378, 379, 380, 381, 276, 277, 278, 279, 280, 1106, 1102, 1102, 1102, 1102, 1102, 1102, 1102, 1102
1072, 1072, 1072, 1072, 1072, 1072, 1072, 1072, 1072, 1072, 1072, 1072, 1072, 1072, 1102, 1103, 180, 181, 182, 183, 184, 185, 1053, 1053, 322, 323, 324, 325, 326, 327, 1053, 1053, 330, 305, 305, 1053, 1053, 385, 386, 387, 388, 389, 390, 391, 392, 393, 394, 395, 396, 397, 398, 399, 400, 401, 409, 409, 404, 405, 406, 407, 408, 409, 410, 411, 412, 413, 308, 309, 310, 311, 312, 1106, 1102, 1102, 1102, 1102, 1102, 1102, 1102, 1102
1072, 1072, 1072, 1072, 1072, 1072, 1072, 1072, 1072, 1072, 1072, 1072, 1072, 1072, 1102, 1103, 212, 213, 214, 215, 216, 217, 437, 437, 437, 437, 356, 357, 358, 359, 1053, 1053, 362, 363, 364, 365, 416, 417, 418, 419, 420, 421, 422, 423, 424, 425, 426, 427, 428, 429, 430, 431, 432, 433, 409, 409, 436, 437, 438, 439, 440, 441, 442, 443, 444, 445, 340, 341, 342, 343, 344, 1106, 1102, 1102, 1102, 1102, 1102, 1102, 1102, 1102
1072, 1072, 1072, 1072, 1072, 1072, 1072, 1072, 1072, 1072, 1072, 1072, 1072, 1072, 1102, 1103, 244, 245, 246, 247, 248, 249, 437, 437, 437, 437, 388, 389, 390, 391, 1053, 1053, 1053, 1053, 1053, 1053, 1053, 1053, 1053, 1053, 1053, 1053, 1053, 1053, 1053, 1053, 1053, 1053, 1053, 1053, 1053, 1053, 1053, 1053, 1053, 1053, 1053, 1053, 1053, 1053, 1053, 1053, 1053, 1053, 1053, 1053, 1053, 1053, 1053, 1053, 1053, 1106, 1102, 1102, 1102, 1102, 1102, 1102, 1102, 1102
1072, 1072, 1072, 1072, 1072, 1072, 1072, 1072, 1072, 1072, 1072, 1072, 1072, 1072, 1102, 1103, 276, 277, 278, 279, 280, 281, 437, 437, 437, 437, 420, 421, 422, 423, 1053, 1053, 1053, 1053, 1053, 1053, 1053, 1053, 1053, 1053, 1053, 1053, 1053, 1053, 1053, 1053, 1053, 1053, 1053, 1053, 1053, 1053, 1053, 1053, 1053, 1053, 1053, 1053, 1053, 1053, 1053, 1053, 1053, 1053, 1053, 1053, 1053, 1053, 1053, 1053, 1053, 1106, 1102, 1102, 1102, 1102, 1102, 1102, 1102, 1102
1072, 1072, 1072, 1072, 1072, 1072, 1072, 1072, 1072, 1072, 1072, 1072, 1072, 1072, 1102, 1103, 69, 70, 71, 72, 73, 74, 75, 76, 77, 78, 79, 80, 81, 82, 83, 84, 85, 86, 87, 88, 361, 362, 363, 364, 365, 366, 367, 368, 369, 370, 371, 372, 373, 374, 375, 421, 422, 423, 424, 425, 426, 427, 428, 429, 430, 431, 432, 433, 434, 435, 436, 437, 438, 439, 440, 1106, 1102, 1102, 1102, 1102, 1102, 1102, 1102, 1102
1072, 1072, 1072, 1072, 1072, 1072, 1072, 1072, 1072, 1072, 1072, 1072, 1072, 1072, 1102, 1103, 101, 102, 103, 104, 105, 106, 107, 108, 109, 110, 111, 112, 113, 114, 115, 116, 117, 118, 119, 120, 393, 394, 421, 422, 423, 424, 425, 426, 427, 428, 429, 430, 431, 432, 433, 421, 422, 423, 424, 425, 426, 427, 428, 429, 430, 431, 432, 433, 434, 435, 436, 437, 438, 439, 440, 1106, 1102, 1102, 1102, 1102, 1102, 1102, 1102, 1102
1072, 1072, 1072, 1072, 1072, 1072, 1072, 1072, 1072, 1072, 1072, 1072, 1072, 1072, 1102, 1103, 133, 134, 135, 136, 137, 138, 139, 140, 141, 142, 143, 144, 145, 146, 147, 148, 149, 150, 151, 152, 425, 426, 453, 454, 455, 456, 457, 458, 459, 460, 461, 462, 463, 464, 465, 453, 454, 455, 456, 457, 458, 459, 460, 461, 462, 463, 464, 465, 466, 467, 468, 469, 470, 471, 472, 1106, 1102, 1102, 1102, 1102, 1102, 1102, 1102, 1102
1072, 1072, 1072, 1072, 1072, 1072, 1072, 1072, 1072, 1072, 1072, 1072, 1072, 1072, 1102, 1103, 165, 166, 167, 168, 169, 170, 171, 172, 173, 174, 175, 176, 177, 178, 179, 180, 181, 182, 183, 184, 457, 458, 485, 486, 487, 488, 489, 490, 491, 492, 493, 494, 495, 496, 497, 485, 486, 487, 488, 489, 490, 491, 492, 493, 494, 495, 496, 497, 498, 499, 500, 501, 502, 503, 504, 1106, 1102, 1102, 1102, 1102, 1102, 1102, 1102, 1102
1072, 1072, 1072, 1072, 1072, 1072, 1072, 1072, 1072, 1072, 1072, 1072, 1072, 1072, 1102, 1103, 208, 208, 208, 208, 208, 208, 208, 208, 208, 208, 208, 208, 208, 208, 208, 208, 208, 208, 208, 208, 208, 208, 517, 518, 519, 520, 521, 522, 523, 524, 525, 526, 527, 528, 529, 517, 518, 519, 520, 521, 522, 523, 524, 525, 526, 527, 528, 529, 530, 531, 532, 533, 534, 535, 536, 1074, 1102, 1102, 1102, 1102, 1102, 1102, 1102, 1102
1102, 1102, 1072, 1072, 1072, 1072, 1072, 1072, 1072, 1072, 1072, 1072, 1072, 1072, 1102, 1057, 1065, 1065, 1065, 1065, 1065, 1065, 1065, 1065, 1065, 1065, 1065, 1065, 1065, 1065, 1065, 1065, 1065, 1065, 1065, 1065, 1065, 1065, 1065, 1065, 1065, 1065, 1065, 1065, 1065, 1065, 1065, 1065, 1065, 1065, 1065, 1065, 1065, 1065, 1065, 1065, 1065, 1065, 1065, 1065, 1065, 1065, 1065, 1065, 1065, 1065, 1065, 1065, 1065, 1065, 1063, 1068, 1102, 1102, 1102, 1102, 1102, 1102, 1102, 1102
1102, 1102, 1072, 1072, 1072, 1072, 1072, 1072, 1072, 1072, 1072, 1072, 1102, 1102, 1102, 1102, 1102, 1102, 1102, 1102, 1102, 1102, 1174, 1175, 1176, 1177, 1178, 1179, 1180, 1181, 1182, 1174, 1175, 1176, 1177, 1178, 1179, 1180, 1181, 1182, 1174, 1175, 1176, 1177, 1178, 1179, 1180, 1181, 1182, 1174, 1175, 1176, 1102, 1102, 1102, 1102, 1102, 1102, 1102, 1102, 1102, 1102, 1102, 1102, 1102, 1102, 1102, 1102, 1102, 1102, 1102, 1102, 1102, 1102, 1102, 1102, 1102, 1102, 1102, 1102
1102, 1102, 1102, 1102, 1102, 1102, 1102, 1102, 1102, 1102, 1102, 1102, 1102, 1102, 1102, 1102, 1102, 1102, 1102, 1102, 1102, 1102, 1177, 1178, 1179, 1180, 1181, 1182, 1174, 1175, 1176, 1177, 1178, 1179, 1180, 1181, 1182, 1174, 1175, 1176, 1177, 1178, 1179, 1180, 1181, 1182, 1174, 1175, 1176, 1177, 1178, 1179, 1102, 1102, 1102, 1102, 1102, 1102, 1102, 1102, 1102, 1102, 1102, 1102, 1102, 1102, 1102, 1102, 1102, 1102, 1102, 1102, 1102, 1102, 1102, 1102, 1102, 1102, 1102, 1102
1102, 1102, 1102, 1102, 1102, 1102, 1102, 1102, 1102, 1102, 1102, 1102, 1102, 1102, 1102, 1102, 1102, 1102, 1102, 1102, 1102, 1102, 1102, 1102, 1102, 1102, 1102, 1102, 1102, 1102, 1102, 1102, 1102, 1102, 1102, 1102, 1102, 1102, 1102, 1102, 1102, 1102, 1102, 1102, 1102, 1102, 1102, 1102, 1102, 1102, 1102, 1102, 1102, 1102, 1102, 1102, 1102, 1102, 1102, 1102, 1102, 1102, 1102, 1102, 1102, 1102, 1102, 1102, 1102, 1102, 1102, 1102, 1102, 1102, 1102, 1102, 1102, 1102, 1102, 1102
1102, 1102, 1102, 1102, 1102, 1102, 1102, 1102, 1102, 1102, 1102, 1102, 1102, 1102, 1102, 1102, 1102, 1102, 1102, 1102, 1102, 1102, 1102, 1102, 1102, 1102, 1102, 1102, 1102, 1102, 1102, 1102, 1102, 1102, 1102, 1102, 1102, 1102, 1102, 1102, 1102, 1102, 1102, 1102, 1102, 1102, 1102, 1102, 1102, 1102, 1102, 1102, 1102, 1102, 1102, 1102, 1102, 1102, 1102, 1102, 1102, 1102, 1102, 1102, 1102, 1102, 1102, 1102, 1102, 1102, 1102, 1102, 1102, 1102, 1102, 1102, 1102, 1102, 1102, 1102
1102, 1102, 1102, 1102, 1102, 1102, 1102, 1102, 1102, 1102, 1102, 1102, 1102, 1102, 1102, 1102, 1102, 1102, 1102, 1102, 1102, 1102, 1102, 1102, 1102, 1102, 1102, 1102, 1102, 1102, 1102, 1102, 1102, 1102, 1102, 1102, 1102, 1102, 1102, 1102, 1102, 1102, 1102, 1102, 1102, 1102, 1102, 1102, 1102, 1102, 1102, 1102, 1102, 1102, 1102, 1102, 1102, 1102, 1102, 1102, 1102, 1102, 1102, 1102, 1102, 1102, 1102, 1102, 1102, 1102, 1102, 1102, 1102, 1102, 1102, 1102, 1102, 1102, 1102, 1102
1102, 1102, 1102, 1102, 1102, 1102, 1102, 1102, 1102, 1102, 1102, 1102, 1102, 1102, 1102, 1102, 1102, 1102, 1102, 1102, 1102, 1102, 1102, 1102, 1102, 1102, 1102, 1102, 1102, 1102, 1102, 1102, 1102, 1102, 1102, 1102, 1102, 1102, 1102, 1102, 1102, 1102, 1102, 1102, 1102, 1102, 1102, 1102, 1102, 1102, 1102, 1102, 1102, 1102, 1102, 1102, 1102, 1102, 1102, 1102, 1102, 1102, 1102, 1102, 1102, 1102, 1102, 1102, 1102, 1102, 1102, 1102, 1102, 1102, 1102, 1102, 1102, 1102, 1102, 1102
1102, 1102, 1102, 1102, 1102, 1102, 1102, 1102, 1102, 1102, 1102, 1102, 1102, 1102, 1102, 1102, 1102, 1102, 1102, 1102, 1102, 1102, 1102, 1102, 1102, 1102, 1102, 1102, 1102, 1102, 1102, 1102, 1102, 1102, 1102, 1102, 1102, 1102, 1102, 1102, 1102, 1102, 1102, 1102, 1102, 1102, 1102, 1102, 1102, 1102, 1102, 1102, 1102, 1102, 1102, 1102, 1102, 1102, 1102, 1102, 1102, 1102, 1102, 1102, 1102, 1102, 1102, 1102, 1102, 1102, 1102, 1102, 1102, 1102, 1102, 1102, 1102, 1102, 1102, 1102
1102, 1102, 1102, 1102, 1102, 1102, 1102, 1102, 1102, 1102, 1102, 1102, 1102, 1102, 1102, 1102, 1102, 1102, 1102, 1102, 1102, 1102, 1102, 1102, 1102, 1102, 1102, 1102, 1102, 1102, 1102, 1102, 1102, 1102, 1102, 1102, 1102, 1102, 1102, 1102, 1102, 1102, 1102, 1102, 1102, 1102, 1102, 1102, 1102, 1102, 1102, 1102, 1102, 1102, 1102, 1102, 1102, 1102, 1102, 1102, 1102, 1102, 1102, 1102, 1102, 1102, 1102, 1102, 1102, 1102, 1102, 1102, 1102, 1102, 1102, 1102, 1102, 1102, 1102, 1102
1102, 1102, 1102, 1102, 1102, 1102, 1102, 1102, 1102, 1102, 1102, 1102, 1102, 1102, 1102, 1102, 1102, 1102, 1102, 1102, 1102, 1102, 1102, 1102, 1102, 1102, 1102, 1102, 1102, 1102, 1102, 1102, 1102, 1102, 1102, 1102, 1102, 1102, 1102, 1102, 1102, 1102, 1102, 1102, 1102, 1102, 1102, 1102, 1102, 1102, 1102, 1102, 1102, 1102, 1102, 1102, 1102, 1102, 1102, 1102, 1102, 1102, 1102, 1102, 1102, 1102, 1102, 1102, 1102, 1102, 1102, 1102, 1102, 1102, 1102, 1102, 1102, 1102, 1102, 1102
1102, 1102, 1102, 1102, 1102, 1102, 1102, 1102, 1102, 1102, 1102, 1102, 1102, 1102, 1102, 1102, 1102, 1102, 1102, 1102, 1102, 1102, 1102, 1102, 1102, 1102, 1102, 1102, 1102, 1102, 1102, 1102, 1102, 1102, 1102, 1102, 1102, 1102, 1102, 1102, 1102, 1102, 1102, 1102, 1102, 1102, 1102, 1102, 1102, 1102, 1102, 1102, 1102, 1102, 1102, 1102, 1102, 1102, 1102, 1102, 1102, 1102, 1102, 1102, 1102, 1102, 1102, 1102, 1102, 1102, 1102, 1102, 1102, 1102, 1102, 1102, 1102, 1102, 1102, 1102
1102, 1102, 1102, 1102, 1102, 1102, 1102, 1102, 1102, 1102, 1102, 1102, 1102, 1102, 1102, 1102, 1102, 1102, 1102, 1102, 1102, 1102, 1102, 1102, 1102, 1102, 1102, 1102, 1102, 1102, 1102, 1102, 1102, 1102, 1102, 1102, 1102, 1102, 1102, 1102, 1102, 1102, 1102, 1102, 1102, 1102, 1102, 1102, 1102, 1102, 1102, 1102, 1102, 1102, 1102, 1102, 1102, 1102, 1102, 1102, 1102, 1102, 1102, 1102, 1102, 1102, 1102, 1102, 1102, 1102, 1102, 1102, 1102, 1102, 1102, 1102, 1102, 1102, 1102, 1102
