0, 0, 0, 0, 0, 0, 0, 0, 0, 0, 0, 0, 0, 0, 0, 0, 0, 0, 0, 0, 0, 0, 0, 0, 0, 0, 0, 0, 0, 0, 0, 0, 0, 0, 0, 0, 0, 0, 0, 0, 0, 0, 0, 0, 0, 0, 0, 0, 0, 0, 0, 0, 0, 0, 0, 0, 0, 0, 0, 0, 0, 0, 0, 0, 0, 0, 0, 0, 0, 0, 0, 0, 0, 0, 0, 0, 0, 0, 0, 0
0, 0, 0, 0, 0, 0, 0, 0, 0, 0, 0, 0, 0, 0, 0, 0, 0, 0, 0, 0, 0, 0, 0, 0, 0, 0, 0, 0, 0, 0, 0, 0, 0, 0, 0, 0, 0, 0, 0, 0, 0, 0, 0, 0, 0, 0, 0, 0, 0, 0, 0, 0, 0, 0, 0, 0, 0, 0, 0, 0, 0, 0, 0, 0, 0, 0, 0, 0, 0, 0, 0, 0, 0, 0, 0, 0, 0, 0, 0, 0
0, 0, 0, 0, 0, 0, 0, 0, 0, 0, 0, 0, 0, 0, 0, 0, 0, 0, 0, 0, 0, 0, 0, 0, 0, 0, 0, 0, 0, 0, 0, 0, 0, 0, 0, 0, 0, 0, 0, 0, 0, 0, 0, 0, 0, 0, 0, 0, 0, 0, 0, 0, 0, 0, 0, 0, 0, 0, 0, 0, 0, 0, 0, 0, 0, 0, 0, 0, 0, 0, 0, 0, 0, 0, 0, 0, 0, 0, 0, 0
0, 0, 0, 0, 0, 0, 0, 0, 0, 0, 0, 0, 0, 0, 0, 0, 0, 0, 0, 0, 0, 0, 0, 0, 0, 0, 0, 0, 0, 0, 0, 0, 0, 0, 0, 0, 0, 0, 0, 0, 0, 0, 0, 0, 0, 0, 0, 0, 0, 0, 0, 0, 0, 0, 0, 0, 0, 0, 0, 0, 0, 0, 0, 0, 0, 0, 0, 0, 0, 0, 0, 0, 0, 0, 0, 0, 0, 0, 0, 0
0, 0, 0, 0, 0, 0, 0, 0, 0, 0, 0, 0, 0, 0, 0, 0, 0, 0, 0, 0, 0, 0, 0, 0, 0, 0, 0, 0, 0, 0, 0, 0, 0, 0, 0, 0, 0, 0, 0, 0, 0, 0, 0, 0, 0, 0, 0, 0, 0, 0, 0, 0, 0, 0, 0, 0, 0, 0, 0, 0, 0, 0, 0, 0, 0, 0, 0, 0, 0, 0, 0, 0, 0, 0, 0, 0, 0, 0, 0, 0
0, 0, 0, 0, 0, 0, 0, 0, 0, 0, 0, 0, 0, 0, 0, 0, 0, 0, 0, 0, 0, 0, 0, 0, 0, 0, 0, 0, 0, 0, 0, 0, 0, 0, 0, 0, 0, 0, 0, 0, 0, 0, 0, 0, 0, 0, 0, 0, 0, 0, 0, 0, 0, 0, 0, 0, 0, 0, 0, 0, 0, 0, 0, 0, 0, 0, 0, 0, 0, 0, 0, 0, 0, 0, 0, 0, 0, 0, 0, 0
0, 0, 0, 0, 0, 0, 0, 0, 0, 0, 0, 0, 0, 0, 0, 0, 0, 0, 0, 0, 0, 0, 0, 0, 0, 0, 0, 0, 0, 0, 0, 0, 0, 0, 0, 0, 0, 0, 0, 0, 0, 0, 0, 0, 0, 0, 0, 0, 0, 0, 0, 0, 0, 0, 0, 0, 0, 0, 0, 0, 0, 0, 0, 0, 0, 0, 0, 0, 0, 0, 0, 0, 0, 0, 0, 0, 0, 0, 0, 0
0, 0, 0, 0, 0, 0, 0, 0, 0, 0, 0, 0, 0, 0, 0, 0, 0, 0, 0, 0, 0, 0, 0, 0, 0, 0, 0, 0, 0, 0, 0, 0, 0, 0, 0, 0, 0, 0, 0, 0, 0, 0, 0, 0, 0, 0, 0, 0, 0, 0, 0, 0, 0, 0, 0, 0, 0, 0, 0, 0, 0, 0, 0, 0, 0, 0, 0, 0, 0, 0, 0, 0, 0, 0, 0, 0, 0, 0, 0, 0
0, 0, 0, 0, 0, 0, 0, 0, 0, 0, 0, 0, 0, 0, 0, 0, 0, 0, 0, 0, 0, 0, 0, 0, 0, 0, 0, 0, 0, 0, 0, 0, 0, 0, 0, 0, 0, 0, 0, 0, 0, 0, 0, 0, 0, 0, 0, 0, 0, 0, 0, 0, 0, 0, 0, 0, 0, 0, 0, 0, 0, 0, 0, 0, 0, 0, 0, 0, 0, 0, 0, 0, 0, 0, 0, 0, 0, 0, 0, 0
0, 0, 0, 0, 0, 0, 0, 0, 0, 0, 0, 0, 0, 0, 0, 0, 0, 0, 0, 0, 0, 0, 0, 0, 0, 0, 0, 0, 0, 0, 0, 0, 0, 0, 0, 0, 0, 0, 0, 0, 0, 0, 0, 0, 0, 0, 0, 0, 0, 0, 0, 0, 0, 0, 0, 0, 0, 0, 0, 0, 0, 0, 0, 0, 0, 0, 0, 0, 0, 0, 0, 0, 0, 0, 0, 0, 0, 0, 0, 0
0, 0, 0, 0, 0, 0, 0, 0, 0, 0, 0, 0, 0, 0, 0, 0, 0, 0, 0, 0, 0, 4800, 4801, 0, 0, 0, 0, 0, 0, 0, 0, 0, 0, 0, 0, 0, 0, 0, 0, 0, 0, 0, 0, 0, 0, 0, 0, 0, 0, 0, 0, 0, 0, 0, 0, 0, 0, 4800, 4801, 0, 0, 0, 0, 0, 0, 0, 0, 0, 0, 0, 0, 0, 0, 0, 0, 0, 0, 0, 0, 0
0, 0, 0, 0, 0, 0, 0, 0, 0, 0, 0, 0, 0, 0, 0, 0, 0, 0, 0, 0, 0, 4802, 4803, 0, 0, 0, 0, 0, 0, 0, 0, 0, 0, 0, 0, 0, 0, 0, 0, 0, 0, 0, 0, 0, 0, 0, 0, 0, 0, 0, 0, 0, 0, 0, 0, 0, 0, 4802, 4803, 0, 0, 0, 0, 0, 0, 0, 0, 0, 0, 0, 0, 0, 0, 0, 0, 0, 0, 0, 0, 0
0, 0, 0, 0, 0, 0, 0, 0, 0, 0, 0, 0, 0, 0, 0, 0, 0, 0, 0, 0, 0, 4800, 4801, 0, 0, 0, 0, 0, 0, 0, 0, 0, 0, 0, 0, 0, 0, 0, 0, 0, 0, 0, 0, 0, 0, 0, 0, 0, 0, 0, 0, 0, 0, 0, 0, 0, 0, 4800, 4801, 0, 0, 0, 0, 0, 0, 0, 0, 0, 0, 0, 0, 0, 0, 0, 0, 0, 0, 0, 0, 0
0, 0, 0, 0, 0, 0, 0, 0, 0, 0, 0, 0, 0, 0, 0, 0, 0, 0, 0, 0, 0, 4802, 4803, 0, 0, 0, 0, 0, 0, 0, 0, 4800, 4801, 4800, 4801, 0, 0, 0, 0, 0, 0, 0, 0, 4800, 4801, 4800, 4801, 0, 0, 0, 0, 0, 0, 0, 0, 0, 0, 4802, 4803, 0, 0, 0, 0, 0, 0, 0, 0, 0, 0, 0, 0, 0, 0, 0, 0, 0, 0, 0, 0, 0
0, 0, 0, 0, 0, 0, 0, 0, 0, 0, 0, 0, 0, 0, 0, 0, 0, 0, 0, 0, 0, 4800, 4801, 0, 0, 0, 0, 0, 0, 0, 4800, 4801, 4803, 4800, 4801, 0, 0, 0, 0, 0, 0, 0, 0, 4800, 4801, 4802, 4800, 4801, 0, 0, 0, 0, 0, 0, 0, 0, 0, 4800, 4801, 0, 0, 0, 0, 0, 0, 0, 0, 0, 0, 0, 0, 0, 0, 0, 0, 0, 0, 0, 0, 0
0, 0, 0, 0, 0, 0, 0, 0, 0, 0, 0, 0, 0, 0, 0, 0, 0, 0, 0, 0, 0, 4802, 4803, 0, 0, 0, 0, 0, 0, 4800, 4801, 4803, 0, 4802, 4803, 0, 0, 0, 0, 0, 0, 0, 0, 4802, 4803, 0, 4802, 4800, 4801, 0, 0, 0, 0, 0, 0, 0, 0, 4802, 4803, 0, 0, 0, 0, 0, 0, 0, 0, 0, 0, 0, 0, 0, 0, 0, 0, 0, 0, 0, 0, 0
0, 0, 0, 0, 0, 0, 0, 0, 0, 0, 0, 0, 0, 0, 0, 0, 0, 0, 0, 0, 0, 4800, 4801, 0, 0, 0, 0, 4800, 4801, 4802, 4803, 0, 0, 4800, 4801, 0, 0, 0, 0, 0, 0, 0, 0, 4800, 4801, 0, 0, 4802, 4803, 4800, 4801, 0, 0, 0, 0, 0, 0, 4800, 4801, 0, 0, 0, 0, 0, 0, 0, 0, 0, 0, 0, 0, 0, 0, 0, 0, 0, 0, 0, 0, 0
0, 0, 0, 0, 0, 0, 0, 0, 0, 0, 0, 0, 0, 0, 0, 0, 0, 0, 0, 0, 0, 4802, 4803, 0, 0, 0, 0, 4802, 4803, 0, 0, 0, 0, 0, 4800, 4801, 0, 0, 0, 0, 0, 0, 4800, 4801, 0, 0, 0, 0, 0, 4802, 4803, 0, 0, 0, 0, 0, 0, 4802, 4803, 0, 0, 0, 0, 0, 0, 0, 0, 0, 0, 0, 0, 0, 0, 0, 0, 0, 0, 0, 0, 0
0, 0, 0, 0, 0, 0, 0, 0, 0, 0, 0, 0, 0, 0, 0, 0, 0, 0, 0, 0, 0, 4800, 4801, 0, 0, 0, 0, 4800, 4801, 0, 0, 0, 0, 0, 4802, 4803, 0, 0, 0, 0, 0, 0, 4802, 4803, 0, 0, 0, 0, 0, 4800, 4801, 0, 0, 0, 0, 0, 0, 4800, 4801, 0, 0, 0, 0, 0, 0, 0, 0, 0, 0, 0, 0, 0, 0, 0, 0, 0, 0, 0, 0, 0
0, 0, 0, 0, 0, 0, 0, 0, 0, 0, 0, 0, 0, 0, 0, 0, 0, 0, 0, 0, 0, 4802, 4803, 0, 0, 0, 0, 4802, 4803, 0, 0, 0, 0, 0, 0, 4800, 4801, 0, 0, 0, 0, 4800, 4801, 0, 0, 0, 0, 0, 0, 4802, 4803, 0, 0, 0, 0, 0, 0, 4802, 4803, 0, 0, 0, 0, 0, 0, 0, 0, 0, 0, 0, 0, 0, 0, 0, 0, 0, 0, 0, 0, 0
0, 0, 0, 0, 0, 0, 0, 0, 0, 0, 0, 0, 0, 0, 0, 0, 0, 0, 0, 0, 0, 4800, 4801, 0, 0, 0, 0, 4800, 4801, 0, 0, 0, 0, 0, 0, 4802, 4803, 0, 0, 0, 0, 4802, 4803, 0, 0, 0, 0, 0, 0, 4800, 4801, 0, 0, 0, 0, 0, 0, 4800, 4801, 0, 0, 0, 0, 0, 0, 0, 0, 0, 0, 0, 0, 0, 0, 0, 0, 0, 0, 0, 0, 0
0, 0, 0, 0, 0, 0, 0, 0, 0, 0, 0, 0, 0, 0, 0, 0, 0, 0, 0, 0, 0, 4802, 4803, 0, 0, 0, 0, 4800, 4801, 0, 0, 0, 0, 0, 0, 0, 4800, 4801, 0, 0, 4800, 4801, 0, 0, 0, 0, 0, 0, 0, 4802, 4803, 0, 0, 0, 0, 0, 0, 4802, 4803, 0, 0, 0, 0, 0, 0, 0, 0, 0, 0, 0, 0, 0, 0, 0, 0, 0, 0, 0, 0, 0
0, 0, 0, 0, 0, 0, 0, 0, 0, 0, 0, 0, 0, 0, 0, 0, 0, 0, 0, 0, 0, 4800, 4801, 0, 0, 0, 0, 4802, 4803, 0, 0, 0, 0, 0, 0, 0, 4802, 4803, 0, 0, 4802, 4803, 0, 0, 0, 0, 0, 0, 0, 4800, 4801, 0, 0, 0, 0, 0, 0, 4800, 4801, 0, 0, 0, 0, 0, 0, 0, 0, 0, 0, 0, 0, 0, 0, 0, 0, 0, 0, 0, 0, 0
0, 0, 0, 0, 0, 0, 0, 0, 0, 0, 0, 0, 0, 0, 0, 0, 0, 0, 0, 0, 0, 4802, 4803, 0, 0, 0, 0, 4800, 4801, 0, 0, 0, 0, 0, 0, 0, 0, 4800, 4801, 4800, 4801, 0, 0, 0, 0, 0, 0, 0, 0, 4802, 4803, 0, 0, 0, 0, 0, 0, 4802, 4803, 0, 0, 0, 0, 0, 0, 0, 0, 0, 0, 0, 0, 0, 0, 0, 0, 0, 0, 0, 0, 0
0, 0, 0, 0, 0, 0, 0, 0, 0, 0, 0, 0, 0, 0, 0, 0, 0, 0, 0, 0, 0, 4800, 4801, 0, 0, 0, 0, 4802, 4803, 4800, 4801, 0, 0, 0, 0, 0, 0, 4802, 4803, 4802, 4803, 0, 0, 0, 0, 0, 0, 4800, 4801, 4800, 4800, 4801, 0, 0, 0, 0, 0, 4800, 4801, 0, 0, 0, 0, 0, 0, 0, 0, 0, 0, 0, 0, 0, 0, 0, 0, 0, 0, 0, 0, 0
0, 0, 0, 0, 0, 0, 0, 0, 0, 0, 0, 0, 0, 0, 0, 0, 0, 0, 0, 0, 0, 4802, 4803, 0, 0, 0, 4800, 4801, 4801, 4802, 4803, 0, 0, 0, 0, 0, 0, 0, 4800, 4801, 0, 0, 0, 0, 0, 0, 0, 4800, 4801, 4802, 4802, 4803, 0, 0, 0, 0, 0, 4802, 4803, 0, 0, 0, 0, 0, 0, 0, 0, 0, 0, 0, 0, 0, 0, 0, 0, 0, 0, 0, 0, 0
0, 0, 0, 0, 0, 0, 0, 0, 0, 0, 0, 0, 0, 0, 0, 0, 0, 0, 0, 0, 0, 4800, 4801, 0, 0, 0, 4802, 4803, 4803, 4800, 4800, 4801, 0, 0, 0, 0, 0, 0, 4802, 4803, 0, 0, 0, 0, 0, 0, 4800, 4802, 4803, 0, 0, 4800, 4801, 0, 0, 0, 0, 4800, 4801, 0, 0, 0, 0, 0, 0, 0, 0, 0, 0, 0, 0, 0, 0, 0, 0, 0, 0, 0, 0, 0
0, 0, 0, 0, 0, 0, 0, 0, 0, 0, 0, 0, 0, 0, 0, 0, 0, 0, 0, 0, 0, 4802, 4803, 0, 0, 4800, 4801, 0, 0, 0, 4802, 4803, 4801, 0, 0, 0, 0, 0, 4800, 4801, 0, 0, 0, 0, 0, 4800, 4802, 4803, 0, 0, 0, 4802, 4803, 0, 0, 0, 0, 4802, 4803, 0, 0, 0, 0, 0, 0, 0, 0, 0, 0, 0, 0, 0, 0, 0, 0, 0, 0, 0, 0, 0
0, 0, 0, 0, 0, 0, 0, 0, 0, 0, 0, 0, 0, 0, 0, 0, 0, 0, 0, 0, 0, 4800, 4801, 0, 0, 4802, 4803, 0, 0, 0, 0, 4802, 4803, 0, 0, 0, 0, 4800, 4801, 4800, 4801, 0, 0, 0, 0, 4802, 4803, 0, 0, 0, 0, 4800, 4801, 0, 0, 0, 0, 4800, 4801, 0, 0, 0, 0, 0, 0, 0, 0, 0, 0, 0, 0, 0, 0, 0, 0, 0, 0, 0, 0, 0
0, 0, 0, 0, 0, 0, 0, 0, 0, 0, 0, 0, 0, 0, 0, 0, 0, 0, 0, 0, 0, 4802, 4803, 0, 0, 4800, 4801, 0, 0, 0, 0, 4800, 4801, 0, 0, 0, 0, 4802, 4803, 4802, 4803, 0, 0, 0, 0, 4800, 4801, 0, 0, 0, 0, 4802, 4803, 0, 0, 0, 0, 4802, 4803, 0, 0, 0, 0, 0, 0, 0, 0, 0, 0, 0, 0, 0, 0, 0, 0, 0, 0, 0, 0, 0
0, 0, 0, 0, 0, 0, 0, 0, 0, 0, 0, 0, 0, 0, 0, 0, 0, 0, 0, 0, 0, 4800, 4801, 0, 0, 4802, 4803, 0, 0, 0, 0, 4802, 4803, 0, 0, 0, 0, 0, 4802, 4803, 0, 0, 0, 0, 0, 4802, 4803, 0, 0, 0, 0, 4800, 4801, 0, 0, 0, 0, 4800, 4801, 0, 0, 0, 0, 0, 0, 0, 0, 0, 0, 0, 0, 0, 0, 0, 0, 0, 0, 0, 0, 0
0, 0, 0, 0, 0, 0, 0, 0, 0, 0, 0, 0, 0, 0, 0, 0, 0, 0, 0, 0, 0, 4802, 4803, 0, 0, 4800, 4801, 0, 0, 0, 0, 4800, 4801, 0, 0, 0, 0, 0, 4800, 4801, 0, 0, 0, 0, 0, 4800, 4801, 0, 0, 0, 0, 4800, 4801, 0, 0, 0, 0, 4802, 4803, 0, 0, 0, 0, 0, 0, 0, 0, 0, 0, 0, 0, 0, 0, 0, 0, 0, 0, 0, 0, 0
0, 0, 0, 0, 0, 0, 0, 0, 0, 0, 0, 0, 0, 0, 0, 0, 0, 0, 0, 0, 0, 4800, 4801, 0, 0, 4802, 4803, 0, 0, 0, 0, 4802, 4803, 0, 0, 0, 0, 0, 4802, 4803, 0, 0, 0, 0, 0, 4802, 4803, 0, 0, 0, 0, 4802, 4803, 0, 0, 0, 0, 4800, 4801, 0, 0, 0, 0, 0, 0, 0, 0, 0, 0, 0, 0, 0, 0, 0, 0, 0, 0, 0, 0, 0
0, 0, 0, 0, 0, 0, 0, 0, 0, 0, 0, 0, 0, 0, 0, 0, 0, 0, 0, 0, 0, 4802, 4803, 0, 0, 4800, 4801, 0, 0, 0, 0, 4800, 4801, 0, 0, 0, 0, 4800, 4801, 4800, 4801, 0, 0, 0, 0, 4800, 4801, 0, 0, 0, 0, 4800, 4801, 0, 0, 0, 0, 4802, 4803, 0, 0, 0, 0, 0, 0, 0, 0, 0, 0, 0, 0, 0, 0, 0, 0, 0, 0, 0, 0, 0
0, 0, 0, 0, 0, 0, 0, 0, 0, 0, 0, 0, 0, 0, 0, 0, 0, 0, 0, 0, 0, 4800, 4801, 0, 0, 4802, 4803, 0, 0, 0, 0, 4802, 4803, 0, 0, 0, 0, 4802, 4803, 4802, 4803, 0, 0, 0, 0, 4802, 4803, 0, 0, 0, 0, 4802, 4803, 0, 0, 0, 0, 4800, 4801, 0, 0, 0, 0, 0, 0, 0, 0, 0, 0, 0, 0, 0, 0, 0, 0, 0, 0, 0, 0, 0
0, 0, 0, 0, 0, 0, 0, 0, 0, 0, 0, 0, 0, 0, 0, 0, 0, 0, 0, 0, 0, 4802, 4803, 0, 0, 4800, 4801, 0, 0, 0, 0, 4800, 4801, 0, 0, 0, 4800, 4801, 0, 0, 4800, 4801, 0, 0, 0, 4800, 4801, 0, 0, 0, 0, 4800, 4801, 0, 0, 0, 0, 4802, 4803, 0, 0, 0, 0, 0, 0, 0, 0, 0, 0, 0, 0, 0, 0, 0, 0, 0, 0, 0, 0, 0
0, 0, 0, 0, 0, 0, 0, 0, 0, 0, 0, 0, 0, 0, 0, 0, 0, 0, 0, 0, 0, 4800, 4801, 0, 0, 4802, 4803, 0, 0, 0, 4800, 4801, 4803, 0, 0, 0, 4800, 4801, 0, 0, 4800, 4801, 0, 0, 0, 4802, 4800, 4801, 0, 0, 0, 4802, 4803, 0, 0, 0, 0, 4800, 4801, 0, 0, 0, 0, 0, 0, 0, 0, 0, 0, 0, 0, 0, 0, 0, 0, 0, 0, 0, 0, 0
0, 0, 0, 0, 0, 0, 0, 0, 0, 0, 0, 0, 0, 0, 0, 0, 0, 0, 0, 0, 0, 4802, 4803, 0, 0, 4800, 4801, 0, 0, 4800, 4802, 4803, 0, 0, 0, 0, 4802, 4803, 0, 0, 4802, 4803, 0, 0, 0, 0, 4802, 4800, 4801, 0, 0, 4800, 4801, 0, 0, 0, 0, 4802, 4803, 0, 0, 0, 0, 0, 0, 0, 0, 0, 0, 0, 0, 0, 0, 0, 0, 0, 0, 0, 0, 0
0, 0, 0, 0, 0, 0, 0, 0, 0, 0, 0, 0, 0, 0, 0, 0, 0, 0, 0, 0, 0, 4800, 4801, 0, 0, 4802, 4800, 4801, 4800, 4802, 4803, 0, 0, 0, 0, 0, 4800, 4801, 0, 0, 4800, 4801, 0, 0, 0, 0, 0, 4802, 4800, 4801, 4800, 4801, 4803, 0, 0, 0, 0, 4800, 4801, 0, 0, 0, 0, 0, 0, 0, 0, 0, 0, 0, 0, 0, 0, 0, 0, 0, 0, 0, 0, 0
0, 0, 0, 0, 0, 0, 0, 0, 0, 0, 0, 0, 0, 0, 0, 0, 0, 0, 0, 0, 0, 4802, 4803, 0, 0, 0, 4802, 4803, 4802, 4803, 0, 0, 0, 0, 0, 4800, 4801, 0, 0, 0, 0, 4800, 4801, 0, 0, 0, 0, 0, 4802, 4803, 4802, 4803, 0, 0, 0, 0, 0, 4802, 4803, 0, 0, 0, 0, 0, 0, 0, 0, 0, 0, 0, 0, 0, 0, 0, 0, 0, 0, 0, 0, 0
0, 0, 0, 0, 0, 0, 0, 0, 0, 0, 0, 0, 0, 0, 0, 0, 0, 0, 0, 0, 0, 4800, 4801, 0, 0, 0, 0, 4800, 4801, 0, 0, 0, 0, 0, 0, 4800, 4801, 0, 0, 0, 0, 4800, 4801, 0, 0, 0, 0, 0, 0, 4800, 4801, 0, 0, 0, 0, 0, 0, 4800, 4801, 0, 0, 0, 0, 0, 0, 0, 0, 0, 0, 0, 0, 0, 0, 0, 0, 0, 0, 0, 0, 0
0, 0, 0, 0, 0, 0, 0, 0, 0, 0, 0, 0, 0, 0, 0, 0, 0, 0, 0, 0, 0, 4802, 4803, 0, 0, 0, 0, 4802, 4803, 0, 0, 0, 0, 0, 0, 4802, 4803, 0, 0, 0, 0, 4802, 4803, 0, 0, 0, 0, 0, 0, 4802, 4803, 0, 0, 0, 0, 0, 0, 4802, 4803, 0, 0, 0, 0, 0, 0, 0, 0, 0, 0, 0, 0, 0, 0, 0, 0, 0, 0, 0, 0, 0
0, 0, 0, 0, 0, 0, 0, 0, 0, 0, 0, 0, 0, 0, 0, 0, 0, 0, 0, 0, 0, 4800, 4801, 0, 0, 0, 0, 4800, 4801, 0, 0, 0, 0, 0, 4800, 4800, 4801, 0, 0, 0, 0, 4800, 4801, 4801, 0, 0, 0, 0, 0, 4800, 4801, 0, 0, 0, 0, 0, 0, 4800, 4801, 0, 0, 0, 0, 0, 0, 0, 0, 0, 0, 0, 0, 0, 0, 0, 0, 0, 0, 0, 0, 0
0, 0, 0, 0, 0, 0, 0, 0, 0, 0, 0, 0, 0, 0, 0, 0, 0, 0, 0, 0, 0, 4802, 4803, 0, 0, 0, 0, 4802, 4803, 0, 0, 0, 0, 0, 4800, 4801, 0, 0, 0, 0, 0, 0, 4800, 4801, 0, 0, 0, 0, 0, 4802, 4803, 0, 0, 0, 0, 0, 0, 4802, 4803, 0, 0, 0, 0, 0, 0, 0, 0, 0, 0, 0, 0, 0, 0, 0, 0, 0, 0, 0, 0, 0
0, 0, 0, 0, 0, 0, 0, 0, 0, 0, 0, 0, 0, 0, 0, 0, 0, 0, 0, 0, 0, 4800, 4801, 0, 0, 0, 0, 4800, 4801, 0, 0, 0, 0, 0, 4802, 4803, 0, 0, 0, 0, 0, 0, 4802, 4803, 0, 0, 0, 0, 0, 4800, 4801, 0, 0, 0, 0, 0, 0, 4800, 4801, 0, 0, 0, 0, 0, 0, 0, 0, 0, 0, 0, 0, 0, 0, 0, 0, 0, 0, 0, 0, 0
0, 0, 0, 0, 0, 0, 0, 0, 0, 0, 0, 0, 0, 0, 0, 0, 0, 0, 0, 0, 0, 4802, 4803, 0, 0, 0, 0, 4802, 4803, 0, 0, 0, 0, 0, 4800, 4801, 0, 0, 0, 0, 0, 0, 4800, 4801, 0, 0, 0, 0, 0, 4802, 4803, 0, 0, 0, 0, 0, 0, 4802, 4803, 0, 0, 0, 0, 0, 0, 0, 0, 0, 0, 0, 0, 0, 0, 0, 0, 0, 0, 0, 0, 0
0, 0, 0, 0, 0, 0, 0, 0, 0, 0, 0, 0, 0, 0, 0, 0, 0, 0, 0, 0, 0, 4800, 4801, 0, 0, 0, 0, 4800, 4801, 0, 0, 0, 0, 0, 4802, 4803, 0, 0, 0, 0, 0, 0, 4802, 4803, 0, 0, 0, 0, 0, 4800, 4801, 0, 0, 0, 0, 0, 0, 4800, 4801, 0, 0, 0, 0, 0, 0, 0, 0, 0, 0, 0, 0, 0, 0, 0, 0, 0, 0, 0, 0, 0
0, 0, 0, 0, 0, 0, 0, 0, 0, 0, 0, 0, 0, 0, 0, 0, 0, 0, 0, 0, 0, 4802, 4803, 0, 0, 0, 0, 4802, 4803, 0, 0, 0, 0, 0, 4800, 4801, 0, 0, 0, 0, 0, 0, 4800, 4801, 0, 0, 0, 0, 0, 4802, 4803, 0, 0, 0, 0, 0, 0, 4802, 4803, 0, 0, 0, 0, 0, 0, 0, 0, 0, 0, 0, 0, 0, 0, 0, 0, 0, 0, 0, 0, 0
0, 0, 0, 0, 0, 0, 0, 0, 0, 0, 0, 0, 0, 0, 0, 0, 0, 0, 0, 0, 0, 4800, 4801, 0, 0, 0, 0, 4800, 4801, 4800, 4801, 4802, 4803, 4800, 4800, 4803, 0, 0, 0, 0, 0, 0, 4802, 4800, 4800, 4801, 4802, 4803, 4800, 4800, 4801, 0, 0, 0, 0, 0, 0, 4800, 4801, 0, 0, 0, 0, 0, 0, 0, 0, 0, 0, 0, 0, 0, 0, 0, 0, 0, 0, 0, 0, 0
0, 0, 0, 0, 0, 0, 0, 0, 0, 0, 0, 0, 0, 0, 0, 0, 0, 0, 0, 0, 0, 4802, 4803, 0, 0, 0, 0, 4802, 4803, 4801, 4802, 4803, 4800, 4801, 4801, 0, 0, 0, 0, 0, 0, 0, 0, 4801, 4801, 4802, 4803, 4800, 4801, 4802, 4803, 0, 0, 0, 0, 0, 0, 4802, 4803, 0, 0, 0, 0, 0, 0, 0, 0, 0, 0, 0, 0, 0, 0, 0, 0, 0, 0, 0, 0, 0
0, 0, 0, 0, 0, 0, 0, 0, 0, 0, 0, 0, 0, 0, 0, 0, 0, 0, 0, 0, 0, 4800, 4801, 0, 0, 0, 0, 0, 0, 0, 0, 0, 0, 0, 0, 0, 0, 0, 0, 0, 0, 0, 0, 0, 0, 0, 0, 0, 0, 0, 0, 0, 0, 0, 0, 0, 0, 4800, 4801, 0, 0, 0, 0, 0, 0, 0, 0, 0, 0, 0, 0, 0, 0, 0, 0, 0, 0, 0, 0, 0
0, 0, 0, 0, 0, 0, 0, 0, 0, 0, 0, 0, 0, 0, 0, 0, 0, 0, 0, 0, 0, 4802, 4803, 0, 0, 0, 0, 0, 0, 0, 0, 0, 0, 0, 0, 0, 0, 0, 0, 0, 0, 0, 0, 0, 0, 0, 0, 0, 0, 0, 0, 0, 0, 0, 0, 0, 0, 4802, 4803, 0, 0, 0, 0, 0, 0, 0, 0, 0, 0, 0, 0, 0, 0, 0, 0, 0, 0, 0, 0, 0
0, 0, 0, 0, 0, 0, 0, 0, 0, 0, 0, 0, 0, 0, 0, 0, 0, 0, 0, 0, 0, 4800, 4801, 4800, 4801, 4802, 4803, 4800, 4801, 4802, 4803, 4800, 4801, 4802, 4803, 4800, 4801, 4800, 4801, 4802, 4803, 4800, 4801, 4802, 4803, 4800, 4801, 4802, 4803, 4800, 4801, 4802, 4803, 4800, 4801, 4802, 4803, 4800, 4801, 0, 0, 0, 0, 0, 0, 0, 0, 0, 0, 0, 0, 0, 0, 0, 0, 0, 0, 0, 0, 0
0, 0, 0, 0, 0, 0, 0, 0, 0, 0, 0, 0, 0, 0, 0, 0, 0, 0, 0, 0, 0, 4802, 4803, 4800, 4801, 4802, 4803, 4800, 4801, 4802, 4803, 4800, 4801, 4802, 4803, 4800, 4801, 4800, 4801, 4802, 4803, 4800, 4801, 4802, 4803, 4800, 4801, 4802, 4803, 4800, 4801, 4802, 4803, 4800, 4801, 4802, 4803, 4802, 4803, 0, 0, 0, 0, 0, 0, 0, 0, 0, 0, 0, 0, 0, 0, 0, 0, 0, 0, 0, 0, 0
0, 0, 0, 0, 0, 0, 0, 0, 0, 0, 0, 0, 0, 0, 0, 0, 0, 0, 0, 0, 0, 0, 0, 0, 0, 0, 0, 0, 0, 0, 0, 0, 0, 0, 0, 0, 0, 0, 0, 0, 0, 0, 0, 0, 0, 0, 0, 0, 0, 0, 0, 0, 0, 0, 0, 0, 0, 0, 0, 0, 0, 0, 0, 0, 0, 0, 0, 0, 0, 0, 0, 0, 0, 0, 0, 0, 0, 0, 0, 0
0, 0, 0, 0, 0, 0, 0, 0, 0, 0, 0, 0, 0, 0, 0, 0, 0, 0, 0, 0, 0, 0, 0, 0, 0, 0, 0, 0, 0, 0, 0, 0, 0, 0, 0, 0, 0, 0, 0, 0, 0, 0, 0, 0, 0, 0, 0, 0, 0, 0, 0, 0, 0, 0, 0, 0, 0, 0, 0, 0, 0, 0, 0, 0, 0, 0, 0, 0, 0, 0, 0, 0, 0, 0, 0, 0, 0, 0, 0, 0
0, 0, 0, 0, 0, 0, 0, 0, 0, 0, 0, 0, 0, 0, 0, 0, 0, 0, 0, 0, 0, 0, 0, 0, 0, 0, 0, 0, 0, 0, 0, 0, 0, 0, 0, 0, 0, 0, 0, 0, 0, 0, 0, 0, 0, 0, 0, 0, 0, 0, 0, 0, 0, 0, 0, 0, 0, 0, 0, 0, 0, 0, 0, 0, 0, 0, 0, 0, 0, 0, 0, 0, 0, 0, 0, 0, 0, 0, 0, 0
0, 0, 0, 0, 0, 0, 0, 0, 0, 0, 0, 0, 0, 0, 0, 0, 0, 0, 0, 0, 0, 0, 0, 0, 0, 0, 0, 0, 0, 0, 0, 0, 0, 0, 0, 0, 0, 0, 0, 0, 0, 0, 0, 0, 0, 0, 0, 0, 0, 0, 0, 0, 0, 0, 0, 0, 0, 0, 0, 0, 0, 0, 0, 0, 0, 0, 0, 0, 0, 0, 0, 0, 0, 0, 0, 0, 0, 0, 0, 0
0, 0, 0, 0, 0, 0, 0, 0, 0, 0, 0, 0, 0, 0, 0, 0, 0, 0, 0, 0, 0, 0, 0, 0, 0, 0, 0, 0, 0, 0, 0, 0, 0, 0, 0, 0, 0, 0, 0, 0, 0, 0, 0, 0, 0, 0, 0, 0, 0, 0, 0, 0, 0, 0, 0, 0, 0, 0, 0, 0, 0, 0, 0, 0, 0, 0, 0, 0, 0, 0, 0, 0, 0, 0, 0, 0, 0, 0, 0, 0
0, 0, 0, 0, 0, 0, 0, 0, 0, 0, 0, 0, 0, 0, 0, 0, 0, 0, 0, 0, 0, 0, 0, 0, 0, 0, 0, 0, 0, 0, 0, 0, 0, 0, 0, 0, 0, 0, 0, 0, 0, 0, 0, 0, 0, 0, 0, 0, 0, 0, 0, 0, 0, 0, 0, 0, 0, 0, 0, 0, 0, 0, 0, 0, 0, 0, 0, 0, 0, 0, 0, 0, 0, 0, 0, 0, 0, 0, 0, 0
