1102, 1102, 1102, 1102, 1102, 1102, 1102, 1102, 1102, 1102, 1102, 1102, 1102, 1102, 1102, 1102, 1102, 1102, 1102, 1102, 1102, 1102, 1102, 1102, 1102, 1102, 1102, 1136, 1136, 1102, 1102, 1102, 1102, 1102, 1102, 1102, 1102, 1102, 1102, 1102, 1102, 1102, 1102, 1102, 1102, 1102, 1102, 1102, 1102, 1102, 1102, 1102, 1102, 1102, 1102, 1102, 1102, 1102, 1102, 1102, 1102, 1102, 1102, 1102, 1102, 1102, 1102, 1102, 1102, 1102, 1102, 1102, 1102, 1102, 1102, 1102, 1102, 1102, 1102, 1102
1102, 1102, 1102, 1102, 1102, 1102, 1102, 1102, 1102, 1102, 1102, 1102, 1102, 1102, 1102, 1102, 1102, 1102, 1102, 1102, 1102, 1102, 1102, 1102, 1102, 1102, 1102, 1136, 1136, 1102, 1102, 1102, 1102, 1102, 1102, 1102, 1102, 1102, 1102, 1102, 1102, 1102, 1102, 1102, 1102, 1102, 1102, 1102, 1102, 1102, 1102, 1102, 1102, 1102, 1102, 1102, 1102, 1102, 1102, 1102, 1102, 1102, 1102, 1102, 1102, 1102, 1102, 1102, 1102, 1102, 1102, 1102, 1102, 1102, 1102, 1102, 1102, 1102, 1102, 1102
1102, 1089, 1097, 1090, 1097, 1097, 1090, 1090, 1097, 1097, 1097, 1097, 1097, 1097, 1097, 1053, 1053, 1097, 1097, 1097, 1097, 1097, 1097, 1097, 1097, 1097, 1097, 1094, 1094, 1091, 1091, 1097, 1097, 1097, 1097, 1097, 1097, 1097, 1097, 1097, 1097, 1097, 1097, 1097, 1097, 1097, 1094, 1095, 1097, 1097, 1097, 1097, 1097, 1097, 1097, 1097, 1097, 1097, 1097, 1097, 1097, 1097, 1097, 1097, 1097, 1090, 1090, 1097, 1097, 1097, 1097, 1100, 1102, 1102, 1102, 1102, 1102, 1102, 1102, 1102
1102, 1103, 64, 795, 795, 67, 408, 408, 70, 1053, 1053, 73, 74, 75, 1020, 1052, 1052, 79, 80, 81, 82, 83, 64, 65, 66, 67, 68, 304, 304, 66, 67, 68, 304, 304, 67, 68, 67, 68, 312, 312, 184, 184, 312, 312, 70, 71, 67, 68, 69, 64, 1053, 1053, 65, 66, 67, 68, 69, 70, 71, 72, 73, 74, 1053, 1053, 77, 408, 408, 80, 81, 82, 83, 1106, 1102, 1102, 1102, 1102, 1102, 1102, 1102, 1102
1102, 1103, 96, 97, 98, 99, 408, 408, 102, 1053, 1053, 105, 106, 107, 108, 109, 110, 111, 112, 113, 64, 65, 96, 97, 98, 99, 100, 96, 97, 98, 99, 100, 142, 143, 144, 145, 146, 147, 148, 149, 184, 184, 142, 143, 144, 145, 146, 147, 148, 149, 1053, 1053, 97, 98, 99, 100, 101, 102, 103, 104, 105, 106, 1053, 1053, 109, 408, 408, 112, 113, 114, 115, 1106, 1102, 1102, 1102, 1102, 1102, 1102, 1102, 1102
1102, 1103, 128, 129, 130, 131, 132, 133, 134, 1053, 1053, 137, 138, 177, 177, 141, 142, 143, 144, 145, 96, 97, 128, 129, 130, 131, 132, 128, 129, 130, 131, 132, 174, 175, 176, 177, 178, 179, 180, 181, 184, 184, 174, 175, 176, 177, 178, 179, 180, 181, 201, 201, 129, 130, 131, 132, 133, 134, 135, 136, 137, 138, 139, 140, 141, 142, 143, 144, 145, 146, 147, 1106, 1102, 1102, 1102, 1102, 1102, 1102, 1102, 1102
1102, 1103, 160, 161, 162, 163, 164, 165, 166, 1053, 1053, 169, 170, 177, 177, 173, 174, 175, 176, 177, 128, 129, 160, 161, 162, 163, 164, 160, 161, 162, 163, 164, 206, 207, 208, 209, 210, 211, 212, 213, 184, 184, 206, 207, 208, 209, 210, 211, 212, 213, 75, 76, 161, 162, 163, 164, 165, 166, 167, 168, 169, 170, 171, 172, 173, 174, 175, 176, 177, 178, 179, 1106, 1102, 1102, 1102, 1102, 1102, 1102, 1102, 1102
1102, 1103, 192, 193, 194, 195, 196, 197, 198, 1053, 1053, 201, 202, 177, 177, 205, 206, 64, 65, 66, 160, 161, 192, 193, 194, 195, 196, 192, 193, 194, 195, 196, 238, 239, 240, 241, 242, 243, 244, 245, 184, 184, 238, 239, 240, 241, 242, 243, 244, 245, 107, 108, 102, 103, 104, 105, 106, 107, 108, 131, 132, 133, 134, 135, 136, 137, 138, 139, 140, 210, 211, 1106, 1102, 1102, 1102, 1102, 1102, 1102, 1102, 1102
1102, 1103, 224, 225, 99, 0, 1, 2, 3, 1053, 1053, 6, 7, 8, 9, 10, 11, 12, 13, 14, 15, 16, 17, 18, 19, 227, 228, 224, 225, 226, 227, 228, 270, 271, 272, 273, 274, 275, 276, 277, 184, 184, 270, 271, 272, 273, 274, 275, 276, 277, 149, 140, 166, 167, 168, 169, 170, 171, 172, 195, 196, 197, 198, 199, 200, 201, 202, 203, 204, 242, 243, 1106, 1102, 1102, 1102, 1102, 1102, 1102, 1102, 1102
1102, 1103, 256, 257, 163, 32, 33, 34, 35, 1053, 1053, 38, 39, 40, 41, 42, 43, 44, 45, 46, 47, 48, 49, 50, 51, 259, 260, 256, 257, 258, 259, 260, 302, 303, 304, 305, 306, 307, 308, 309, 184, 184, 302, 303, 304, 305, 306, 307, 308, 309, 181, 172, 230, 231, 232, 233, 234, 235, 236, 259, 260, 261, 262, 263, 264, 265, 266, 267, 268, 274, 275, 1106, 1102, 1102, 1102, 1102, 1102, 1102, 1102, 1102
1102, 1103, 288, 289, 227, 64, 65, 66, 67, 1053, 1053, 70, 71, 72, 73, 74, 75, 76, 77, 78, 79, 80, 81, 82, 83, 291, 292, 288, 0, 1, 2, 3, 334, 335, 336, 337, 338, 339, 340, 341, 1053, 1053, 334, 335, 336, 337, 338, 339, 340, 341, 213, 204, 294, 295, 296, 297, 298, 299, 300, 323, 324, 325, 326, 327, 328, 329, 330, 331, 332, 306, 307, 1106, 1102, 1102, 1102, 1102, 1102, 1102, 1102, 1102
1102, 1103, 320, 321, 291, 96, 97, 98, 99, 1053, 1053, 102, 103, 104, 105, 106, 107, 108, 109, 110, 111, 112, 113, 114, 115, 323, 324, 320, 32, 33, 34, 35, 366, 367, 368, 369, 370, 371, 372, 373, 1053, 1053, 366, 367, 368, 369, 370, 371, 372, 373, 245, 236, 358, 359, 360, 361, 362, 363, 1053, 1053, 388, 389, 390, 391, 392, 393, 394, 395, 396, 338, 339, 1106, 1102, 1102, 1102, 1102, 1102, 1102, 1102, 1102
1102, 1103, 352, 353, 355, 128, 129, 130, 131, 1053, 1053, 134, 135, 136, 137, 138, 139, 140, 141, 142, 143, 144, 145, 0, 1, 2, 3, 4, 64, 65, 66, 67, 302, 303, 304, 305, 306, 307, 308, 309, 1053, 1053, 270, 271, 272, 273, 274, 275, 276, 277, 277, 268, 102, 103, 104, 105, 106, 107, 1053, 1053, 132, 133, 134, 135, 136, 137, 138, 139, 140, 370, 371, 1106, 1102, 1102, 1102, 1102, 1102, 1102, 1102, 1102
1102, 1103, 384, 385, 99, 160, 161, 162, 163, 1053, 1053, 166, 167, 168, 169, 170, 171, 172, 173, 174, 175, 176, 177, 32, 33, 34, 35, 36, 96, 97, 98, 99, 142, 143, 144, 145, 146, 147, 148, 149, 1053, 1053, 302, 303, 304, 305, 306, 307, 308, 309, 309, 300, 166, 167, 168, 169, 1053, 1053, 172, 195, 196, 197, 198, 199, 200, 201, 202, 203, 204, 402, 403, 1106, 1102, 1102, 1102, 1102, 1102, 1102, 1102, 1102
1102, 1103, 416, 417, 163, 192, 193, 194, 195, 1053, 1053, 198, 199, 200, 201, 202, 203, 204, 205, 206, 207, 208, 209, 64, 65, 66, 67, 68, 128, 129, 130, 131, 174, 175, 176, 177, 178, 179, 180, 181, 1053, 1053, 334, 335, 336, 337, 338, 339, 340, 341, 341, 332, 230, 231, 232, 233, 1053, 1053, 236, 259, 260, 261, 262, 263, 264, 265, 266, 267, 268, 434, 435, 1106, 1102, 1102, 1102, 1102, 1102, 1102, 1102, 1102
1102, 1103, 448, 449, 227, 224, 225, 226, 227, 1053, 1053, 230, 231, 232, 233, 234, 235, 236, 237, 238, 239, 240, 241, 96, 97, 98, 99, 100, 160, 161, 162, 163, 206, 207, 208, 209, 210, 211, 212, 213, 1053, 1053, 366, 367, 368, 369, 370, 371, 372, 373, 373, 364, 14, 15, 1053, 1053, 18, 19, 300, 323, 324, 325, 326, 327, 328, 329, 330, 331, 332, 466, 467, 1106, 1102, 1102, 1102, 1102, 1102, 1102, 1102, 1102
1102, 1103, 480, 481, 291, 256, 257, 258, 259, 1053, 1053, 262, 263, 264, 213, 213, 267, 268, 269, 270, 271, 272, 273, 128, 129, 130, 131, 132, 192, 193, 194, 195, 238, 239, 240, 241, 242, 243, 244, 245, 1053, 1053, 101, 102, 103, 101, 102, 103, 101, 102, 103, 147, 46, 47, 1053, 1053, 50, 51, 364, 387, 388, 389, 390, 391, 392, 393, 394, 395, 396, 498, 499, 1138, 1102, 1102, 1102, 1102, 1102, 1102, 1102, 1102
1102, 1103, 64, 65, 355, 288, 289, 0, 1, 1053, 1053, 4, 5, 6, 213, 213, 9, 10, 11, 12, 142, 143, 144, 145, 146, 142, 143, 144, 145, 146, 147, 148, 149, 271, 272, 273, 274, 275, 276, 277, 1053, 1053, 104, 105, 106, 104, 105, 106, 104, 105, 106, 179, 1053, 1053, 80, 81, 82, 83, 108, 131, 132, 133, 134, 135, 136, 137, 138, 139, 140, 530, 531, 1074, 1105, 1102, 1102, 1102, 1102, 1102, 1102, 1102
1102, 1103, 96, 97, 99, 320, 179, 179, 179, 1053, 1053, 1053, 1053, 1053, 1053, 1053, 1053, 1053, 1053, 1053, 174, 175, 176, 177, 178, 174, 175, 176, 177, 178, 179, 180, 181, 303, 304, 305, 306, 307, 308, 309, 1053, 1053, 107, 108, 131, 107, 108, 131, 107, 108, 131, 244, 1053, 1053, 2, 3, 4, 5, 6, 7, 8, 9, 10, 11, 12, 13, 14, 15, 16, 17, 18, 1074, 1105, 1102, 1102, 1102, 1102, 1102, 1102, 1102
1102, 1103, 128, 129, 163, 352, 179, 179, 179, 1053, 1053, 1053, 1053, 1053, 1053, 1053, 1053, 1053, 1053, 1053, 206, 207, 208, 209, 210, 206, 207, 208, 209, 210, 211, 212, 213, 335, 336, 337, 338, 339, 340, 341, 1053, 1053, 1053, 1053, 1053, 1053, 1053, 1053, 1053, 1053, 1053, 1053, 32, 33, 34, 35, 36, 37, 38, 39, 40, 41, 42, 43, 44, 45, 46, 47, 48, 49, 50, 1074, 1105, 1102, 1102, 1102, 1102, 1102, 1102, 1102
1102, 1103, 160, 161, 227, 384, 179, 179, 179, 98, 99, 100, 101, 102, 103, 104, 105, 106, 107, 0, 1053, 1053, 563, 563, 242, 238, 239, 240, 241, 242, 243, 244, 245, 367, 368, 369, 370, 371, 372, 373, 1053, 1053, 1053, 1053, 1053, 1053, 1053, 1053, 1053, 1053, 1053, 1053, 64, 65, 66, 67, 68, 69, 70, 71, 72, 73, 74, 75, 76, 77, 78, 79, 80, 81, 82, 1074, 1105, 1102, 1102, 1102, 1102, 1102, 1102, 1102
1102, 1103, 192, 193, 291, 416, 179, 179, 179, 2, 3, 4, 5, 6, 7, 8, 9, 10, 11, 32, 1053, 1053, 563, 563, 274, 270, 271, 272, 273, 274, 275, 276, 277, 304, 358, 359, 135, 136, 312, 312, 1053, 1053, 138, 139, 140, 138, 139, 140, 138, 139, 140, 104, 96, 97, 98, 99, 100, 101, 102, 103, 104, 105, 106, 107, 108, 109, 110, 111, 112, 113, 114, 1074, 1105, 1102, 1102, 1102, 1102, 1102, 1102, 1102
1102, 1103, 224, 225, 355, 448, 179, 179, 179, 34, 35, 36, 37, 38, 39, 40, 41, 42, 43, 64, 302, 303, 1053, 1053, 1053, 1053, 1053, 1053, 305, 306, 307, 308, 309, 304, 390, 391, 138, 139, 140, 201, 201, 201, 201, 201, 201, 201, 67, 68, 69, 70, 71, 72, 73, 74, 75, 76, 132, 133, 134, 135, 136, 137, 138, 139, 140, 141, 142, 143, 144, 145, 146, 1074, 1105, 1102, 1102, 1102, 1102, 1102, 1102, 1102
1102, 1103, 256, 257, 99, 480, 481, 64, 65, 66, 67, 68, 69, 70, 71, 72, 73, 74, 75, 96, 334, 335, 1053, 1053, 1053, 1053, 1053, 1053, 337, 338, 339, 340, 341, 304, 422, 423, 201, 201, 201, 201, 201, 201, 201, 201, 201, 201, 99, 100, 101, 102, 103, 104, 105, 106, 107, 108, 164, 165, 166, 167, 168, 169, 170, 171, 172, 173, 174, 175, 176, 177, 178, 1074, 1105, 1102, 1102, 1102, 1102, 1102, 1102, 1102
1102, 1103, 288, 289, 163, 512, 513, 96, 97, 98, 99, 100, 101, 102, 103, 104, 105, 106, 107, 128, 366, 367, 563, 563, 370, 1053, 1053, 368, 369, 370, 371, 372, 373, 304, 454, 67, 68, 69, 70, 71, 72, 73, 74, 75, 76, 201, 131, 132, 563, 563, 135, 136, 137, 138, 139, 140, 196, 197, 198, 199, 200, 201, 202, 203, 204, 205, 206, 207, 208, 209, 210, 1074, 1105, 1102, 1102, 1102, 1102, 1102, 1102, 1102
1102, 1103, 320, 321, 227, 228, 229, 128, 129, 130, 131, 132, 133, 134, 135, 136, 137, 138, 139, 160, 161, 162, 563, 563, 165, 1053, 1053, 168, 480, 481, 482, 410, 410, 304, 486, 99, 100, 101, 102, 103, 104, 105, 106, 107, 108, 168, 163, 1053, 1053, 563, 167, 168, 169, 170, 171, 172, 228, 229, 230, 231, 232, 233, 234, 235, 236, 237, 238, 239, 240, 241, 242, 1074, 1105, 1102, 1102, 1102, 1102, 1102, 1102, 1102
1102, 1103, 352, 353, 291, 292, 293, 160, 161, 162, 163, 164, 0, 1, 2, 0, 1, 2, 3, 4, 5, 6, 7, 8, 9, 10, 11, 12, 512, 513, 514, 410, 410, 517, 518, 131, 132, 133, 134, 135, 136, 137, 138, 139, 140, 168, 195, 1053, 1053, 563, 199, 200, 201, 202, 203, 204, 260, 261, 262, 263, 264, 265, 266, 267, 268, 269, 270, 271, 272, 273, 274, 1074, 1105, 1102, 1102, 1102, 1102, 1102, 1102, 1102
1102, 1103, 384, 385, 355, 356, 357, 192, 193, 194, 195, 196, 32, 33, 34, 67, 68, 69, 35, 142, 143, 144, 145, 146, 147, 148, 149, 44, 45, 46, 47, 410, 410, 50, 51, 163, 164, 165, 166, 167, 168, 169, 170, 171, 1053, 1053, 1053, 1053, 1053, 1053, 251, 251, 233, 234, 235, 236, 292, 293, 294, 295, 296, 297, 298, 299, 300, 301, 302, 303, 304, 305, 306, 1074, 1105, 1102, 1102, 1102, 1102, 1102, 1102, 1102
1102, 1103, 416, 417, 355, 356, 357, 224, 225, 226, 227, 228, 64, 65, 66, 70, 71, 72, 67, 174, 175, 176, 177, 178, 179, 180, 181, 76, 77, 78, 79, 410, 410, 410, 410, 195, 196, 197, 198, 199, 200, 201, 202, 203, 1053, 1053, 1053, 1053, 1053, 1053, 251, 251, 265, 266, 267, 268, 5, 6, 7, 8, 9, 10, 11, 12, 13, 14, 15, 16, 17, 18, 19, 1074, 1105, 1102, 1102, 1102, 1102, 1102, 1102, 1102
1102, 1103, 448, 449, 450, 451, 452, 256, 257, 258, 259, 260, 96, 97, 98, 73, 74, 75, 99, 206, 207, 208, 209, 210, 211, 212, 213, 108, 109, 110, 111, 410, 410, 410, 410, 227, 228, 229, 230, 231, 232, 233, 142, 143, 144, 145, 146, 147, 148, 149, 1053, 1053, 297, 298, 299, 300, 37, 38, 39, 40, 41, 42, 43, 44, 45, 46, 47, 48, 49, 50, 51, 1074, 1105, 1102, 1102, 1102, 1102, 1102, 1102, 1102
1102, 1103, 480, 481, 482, 483, 484, 288, 289, 290, 291, 292, 128, 129, 130, 76, 99, 100, 131, 238, 239, 240, 241, 242, 243, 244, 245, 140, 141, 142, 143, 410, 410, 410, 410, 259, 260, 261, 262, 263, 264, 265, 174, 175, 176, 177, 178, 179, 180, 181, 1053, 1053, 329, 330, 331, 332, 69, 70, 71, 72, 73, 74, 75, 76, 77, 78, 79, 80, 81, 82, 83, 1074, 1105, 1102, 1102, 1102, 1102, 1102, 1102, 1102
1102, 1103, 512, 513, 514, 515, 516, 320, 321, 322, 323, 324, 160, 161, 162, 101, 102, 103, 163, 270, 271, 272, 273, 274, 275, 276, 277, 172, 173, 174, 175, 1053, 1053, 410, 410, 291, 292, 293, 294, 295, 296, 297, 206, 207, 208, 209, 210, 211, 212, 213, 244, 245, 1053, 1053, 1053, 1053, 1053, 1053, 1053, 1053, 1053, 1053, 1053, 1053, 109, 110, 111, 112, 113, 114, 115, 1074, 1105, 1102, 1102, 1102, 1102, 1102, 1102, 1102
1102, 1103, 64, 65, 66, 67, 68, 352, 353, 354, 355, 356, 192, 193, 194, 104, 105, 106, 195, 302, 1053, 1053, 1053, 1053, 1053, 1053, 1053, 1053, 1053, 1053, 1053, 1053, 1053, 410, 410, 323, 324, 325, 326, 327, 328, 329, 238, 239, 240, 241, 242, 243, 244, 245, 276, 277, 1053, 1053, 1053, 1053, 1053, 1053, 1053, 1053, 1053, 1053, 1053, 1053, 141, 142, 143, 144, 145, 146, 147, 1074, 1105, 1102, 1102, 1102, 1102, 1102, 1102, 1102
1102, 1103, 64, 65, 66, 67, 68, 384, 385, 386, 387, 388, 224, 225, 226, 107, 108, 131, 227, 334, 1053, 1053, 1053, 1053, 1053, 1053, 1053, 1053, 1053, 1053, 1053, 1053, 1053, 410, 410, 355, 356, 357, 358, 359, 360, 361, 270, 271, 272, 273, 274, 275, 276, 277, 308, 309, 161, 162, 163, 164, 165, 166, 167, 168, 169, 170, 1053, 1053, 173, 174, 175, 176, 177, 178, 179, 1074, 1105, 1102, 1102, 1102, 1102, 1102, 1102, 1102
1102, 1103, 96, 97, 98, 99, 100, 416, 417, 418, 419, 420, 256, 257, 258, 132, 133, 134, 1053, 1053, 367, 368, 369, 370, 371, 372, 373, 268, 269, 270, 271, 1053, 1053, 410, 410, 464, 168, 168, 291, 292, 293, 294, 302, 303, 304, 305, 306, 307, 308, 309, 340, 341, 193, 194, 195, 196, 197, 198, 199, 200, 201, 202, 1053, 1053, 205, 206, 207, 208, 209, 210, 211, 1074, 1105, 1102, 1102, 1102, 1102, 1102, 1102, 1102
1102, 1103, 128, 129, 130, 131, 132, 448, 449, 450, 451, 452, 288, 289, 290, 135, 136, 137, 1053, 1053, 293, 294, 295, 296, 297, 298, 299, 300, 301, 302, 303, 1053, 1053, 410, 410, 496, 497, 498, 323, 324, 325, 326, 334, 335, 336, 337, 338, 339, 340, 341, 372, 373, 225, 226, 227, 228, 229, 230, 231, 232, 233, 234, 1053, 1053, 237, 238, 239, 240, 241, 242, 243, 1074, 1105, 1102, 1102, 1102, 1102, 1102, 1102, 1102
1102, 1103, 160, 161, 162, 163, 164, 480, 481, 482, 483, 484, 320, 321, 322, 138, 1053, 1053, 323, 324, 325, 326, 327, 328, 329, 330, 331, 332, 333, 334, 335, 1053, 1053, 410, 410, 528, 529, 530, 355, 356, 357, 358, 366, 367, 368, 369, 370, 371, 372, 373, 325, 256, 257, 258, 259, 260, 261, 262, 263, 264, 265, 266, 1053, 1053, 67, 68, 69, 272, 273, 274, 275, 1074, 1105, 1102, 1102, 1102, 1102, 1102, 1102, 1102
1102, 1103, 192, 193, 194, 195, 196, 512, 513, 514, 515, 516, 352, 353, 354, 352, 1053, 1053, 355, 356, 357, 358, 359, 360, 361, 362, 363, 364, 365, 366, 367, 1053, 1053, 410, 410, 296, 297, 298, 299, 288, 289, 290, 291, 292, 293, 352, 353, 354, 355, 356, 357, 288, 289, 290, 291, 292, 293, 294, 295, 296, 297, 298, 1053, 1053, 70, 71, 72, 304, 305, 306, 307, 1074, 1105, 1102, 1102, 1102, 1102, 1102, 1102, 1102
1102, 1103, 224, 225, 226, 227, 228, 229, 230, 355, 356, 357, 384, 385, 1053, 1053, 385, 386, 387, 388, 389, 390, 391, 392, 393, 394, 395, 396, 397, 398, 399, 1053, 1053, 410, 410, 360, 361, 362, 363, 320, 321, 322, 323, 324, 325, 384, 385, 386, 387, 388, 389, 320, 321, 322, 323, 324, 325, 326, 327, 328, 329, 330, 1053, 1053, 73, 74, 75, 336, 337, 338, 339, 1074, 1105, 1102, 1102, 1102, 1102, 1102, 1102, 1102
1102, 1103, 256, 257, 258, 259, 260, 261, 262, 99, 100, 101, 416, 417, 1053, 1053, 417, 418, 419, 420, 421, 422, 423, 424, 425, 426, 427, 428, 429, 430, 431, 1053, 1053, 410, 410, 104, 105, 106, 107, 352, 353, 354, 355, 356, 357, 416, 417, 418, 419, 420, 421, 352, 353, 354, 355, 356, 357, 358, 359, 360, 361, 362, 1053, 1053, 76, 99, 100, 368, 369, 370, 371, 1074, 1105, 1102, 1102, 1102, 1102, 1102, 1102, 1102
1102, 1103, 288, 289, 290, 291, 292, 293, 294, 163, 164, 165, 1053, 1053, 450, 448, 449, 450, 451, 452, 453, 454, 455, 456, 457, 458, 459, 460, 461, 462, 463, 184, 184, 410, 410, 168, 169, 170, 171, 384, 385, 386, 387, 388, 389, 448, 449, 450, 451, 452, 453, 384, 385, 386, 387, 388, 389, 390, 391, 392, 393, 394, 1053, 1053, 101, 102, 103, 400, 401, 402, 403, 1074, 1102, 1102, 1102, 1102, 1102, 1102, 1102, 1102
1102, 1103, 320, 321, 322, 323, 324, 325, 326, 227, 228, 229, 1053, 1053, 482, 480, 481, 482, 483, 484, 485, 486, 487, 488, 489, 490, 491, 492, 493, 494, 495, 184, 184, 410, 410, 232, 233, 234, 235, 416, 417, 418, 419, 420, 421, 480, 481, 482, 483, 484, 485, 416, 417, 418, 419, 420, 421, 422, 423, 424, 425, 426, 1053, 1053, 104, 105, 106, 432, 433, 434, 435, 1138, 1102, 1102, 1102, 1102, 1102, 1102, 1102, 1102
1102, 1103, 352, 353, 354, 355, 356, 357, 358, 291, 292, 293, 512, 513, 514, 512, 513, 514, 515, 516, 517, 518, 519, 520, 521, 522, 523, 524, 525, 526, 527, 184, 184, 410, 410, 296, 297, 298, 299, 448, 449, 450, 451, 452, 453, 512, 513, 514, 515, 516, 517, 448, 449, 450, 451, 452, 453, 454, 455, 456, 457, 458, 1053, 1053, 107, 108, 131, 464, 465, 466, 467, 1106, 1102, 1102, 1102, 1102, 1102, 1102, 1102, 1102
1102, 1103, 384, 385, 386, 387, 388, 389, 390, 355, 356, 357, 358, 359, 360, 361, 362, 363, 364, 387, 388, 389, 390, 391, 392, 393, 394, 395, 396, 136, 355, 184, 184, 410, 410, 360, 361, 362, 363, 480, 481, 482, 483, 484, 485, 486, 487, 488, 489, 490, 491, 480, 481, 482, 483, 484, 485, 486, 487, 488, 489, 490, 1053, 1053, 132, 133, 134, 496, 497, 498, 499, 1106, 1102, 1102, 1102, 1102, 1102, 1102, 1102, 1102
1102, 1103, 416, 417, 418, 419, 420, 312, 312, 423, 424, 425, 426, 427, 163, 164, 165, 166, 167, 168, 169, 170, 171, 172, 195, 196, 197, 198, 199, 200, 201, 184, 184, 410, 410, 398, 399, 400, 401, 512, 513, 514, 515, 516, 517, 518, 519, 520, 521, 522, 523, 512, 513, 514, 515, 516, 517, 518, 304, 304, 521, 522, 1053, 1053, 302, 302, 137, 528, 302, 302, 302, 1106, 1102, 1102, 1102, 1102, 1102, 1102, 1102, 1102
1102, 1103, 448, 449, 450, 312, 312, 312, 312, 455, 456, 457, 458, 459, 227, 228, 229, 230, 231, 232, 233, 234, 235, 236, 259, 260, 261, 262, 263, 264, 265, 184, 184, 410, 410, 430, 431, 432, 433, 434, 435, 436, 208, 291, 292, 293, 294, 295, 296, 297, 298, 299, 300, 323, 324, 325, 326, 327, 304, 304, 304, 304, 1053, 1053, 302, 302, 302, 302, 302, 302, 302, 1106, 1102, 1102, 1102, 1102, 1102, 1102, 1102, 1102
1102, 1103, 480, 481, 482, 312, 312, 1053, 1053, 487, 488, 489, 490, 491, 291, 312, 312, 294, 295, 296, 297, 298, 299, 300, 323, 324, 325, 326, 327, 328, 329, 184, 184, 410, 410, 462, 463, 464, 465, 466, 467, 468, 208, 355, 356, 357, 358, 359, 360, 361, 362, 363, 364, 387, 388, 389, 390, 391, 304, 304, 304, 304, 1053, 1053, 208, 208, 302, 302, 302, 208, 208, 1106, 1102, 1102, 1102, 1102, 1102, 1102, 1102, 1102
1102, 1103, 512, 513, 514, 515, 516, 1053, 1053, 519, 520, 521, 522, 523, 355, 312, 312, 358, 359, 360, 361, 362, 363, 364, 387, 388, 389, 390, 391, 392, 393, 184, 184, 410, 410, 208, 208, 208, 208, 208, 208, 208, 208, 208, 208, 208, 208, 208, 208, 208, 208, 208, 208, 208, 208, 208, 1052, 1052, 208, 208, 208, 208, 1053, 1053, 208, 208, 208, 208, 208, 208, 208, 1106, 1102, 1102, 1102, 1102, 1102, 1102, 1102, 1102
1102, 1057, 1065, 1065, 1065, 1065, 1065, 1065, 1065, 1065, 1065, 1065, 1065, 1065, 1065, 1065, 1065, 1065, 1065, 1065, 1065, 1065, 1065, 1065, 1065, 1065, 1065, 1065, 1065, 1065, 1065, 1065, 1065, 1065, 1065, 1065, 1065, 1065, 1065, 1065, 1065, 1065, 1065, 1065, 1065, 1065, 1065, 1065, 1065, 1065, 1065, 1065, 1065, 1065, 1065, 1065, 1053, 1053, 1065, 1065, 1065, 1065, 1065, 1065, 1065, 1065, 1065, 1065, 1065, 1065, 1063, 1068, 1102, 1102, 1102, 1102, 1102, 1102, 1102, 1102
1102, 1102, 1102, 1102, 1102, 1102, 1102, 1102, 1102, 1102, 1102, 1102, 1102, 1102, 1102, 1102, 1102, 1102, 1102, 1102, 1102, 1102, 1174, 1175, 1176, 1177, 1178, 1179, 1180, 1181, 1182, 1174, 1175, 1176, 1177, 1178, 1179, 1180, 1181, 1182, 1174, 1175, 1176, 1177, 1178, 1179, 1180, 1181, 1182, 1174, 1175, 1176, 1102, 1102, 1102, 1102, 1102, 1102, 1102, 1102, 1102, 1102, 1102, 1102, 1102, 1102, 1102, 1102, 1102, 1102, 1102, 1102, 1102, 1102, 1102, 1102, 1102, 1102, 1102, 1102
1102, 1102, 1102, 1102, 1102, 1102, 1102, 1102, 1102, 1102, 1102, 1102, 1102, 1102, 1102, 1102, 1102, 1102, 1102, 1102, 1102, 1102, 1177, 1178, 1179, 1180, 1181, 1182, 1174, 1175, 1176, 1177, 1178, 1179, 1180, 1181, 1182, 1174, 1175, 1176, 1177, 1178, 1179, 1180, 1181, 1182, 1174, 1175, 1176, 1177, 1178, 1179, 1102, 1102, 1102, 1102, 1102, 1102, 1102, 1102, 1102, 1102, 1102, 1102, 1102, 1102, 1102, 1102, 1102, 1102, 1102, 1102, 1102, 1102, 1102, 1102, 1102, 1102, 1102, 1102
1102, 1102, 1102, 1102, 1102, 1102, 1102, 1102, 1102, 1102, 1102, 1102, 1102, 1102, 1102, 1102, 1102, 1102, 1102, 1102, 1102, 1102, 1102, 1102, 1102, 1102, 1102, 1102, 1102, 1102, 1102, 1102, 1102, 1102, 1102, 1102, 1102, 1102, 1102, 1102, 1102, 1102, 1102, 1102, 1102, 1102, 1102, 1102, 1102, 1102, 1102, 1102, 1102, 1102, 1102, 1102, 1102, 1102, 1102, 1102, 1102, 1102, 1102, 1102, 1102, 1102, 1102, 1102, 1102, 1102, 1102, 1102, 1102, 1102, 1102, 1102, 1102, 1102, 1102, 1102
1102, 1102, 1102, 1102, 1102, 1102, 1102, 1102, 1102, 1102, 1102, 1102, 1102, 1102, 1102, 1102, 1102, 1102, 1102, 1102, 1102, 1102, 1102, 1102, 1102, 1102, 1102, 1102, 1102, 1102, 1102, 1102, 1102, 1102, 1102, 1102, 1102, 1102, 1102, 1102, 1102, 1102, 1102, 1102, 1102, 1102, 1102, 1102, 1102, 1102, 1102, 1102, 1102, 1102, 1102, 1102, 1102, 1102, 1102, 1102, 1102, 1102, 1102, 1102, 1102, 1102, 1102, 1102, 1102, 1102, 1102, 1102, 1102, 1102, 1102, 1102, 1102, 1102, 1102, 1102
1102, 1102, 1102, 1102, 1102, 1102, 1102, 1102, 1102, 1102, 1102, 1102, 1102, 1102, 1102, 1102, 1102, 1102, 1102, 1102, 1102, 1102, 1102, 1102, 1102, 1102, 1102, 1102, 1102, 1102, 1102, 1102, 1102, 1102, 1102, 1102, 1102, 1102, 1102, 1102, 1102, 1102, 1102, 1102, 1102, 1102, 1102, 1102, 1102, 1102, 1102, 1102, 1102, 1102, 1102, 1102, 1102, 1102, 1102, 1102, 1102, 1102, 1102, 1102, 1102, 1102, 1102, 1102, 1102, 1102, 1102, 1102, 1102, 1102, 1102, 1102, 1102, 1102, 1102, 1102
1102, 1102, 1102, 1102, 1102, 1102, 1102, 1102, 1102, 1102, 1102, 1102, 1102, 1102, 1102, 1102, 1102, 1102, 1102, 1102, 1102, 1102, 1102, 1102, 1102, 1102, 1102, 1102, 1102, 1102, 1102, 1102, 1102, 1102, 1102, 1102, 1102, 1102, 1102, 1102, 1102, 1102, 1102, 1102, 1102, 1102, 1102, 1102, 1102, 1102, 1102, 1102, 1102, 1102, 1102, 1102, 1102, 1102, 1102, 1102, 1102, 1102, 1102, 1102, 1102, 1102, 1102, 1102, 1102, 1102, 1102, 1102, 1102, 1102, 1102, 1102, 1102, 1102, 1102, 1102
1102, 1102, 1102, 1102, 1102, 1102, 1102, 1102, 1102, 1102, 1102, 1102, 1102, 1102, 1102, 1102, 1102, 1102, 1102, 1102, 1102, 1102, 1102, 1102, 1102, 1102, 1102, 1102, 1102, 1102, 1102, 1102, 1102, 1102, 1102, 1102, 1102, 1102, 1102, 1102, 1102, 1102, 1102, 1102, 1102, 1102, 1102, 1102, 1102, 1102, 1102, 1102, 1102, 1102, 1102, 1102, 1102, 1102, 1102, 1102, 1102, 1102, 1102, 1102, 1102, 1102, 1102, 1102, 1102, 1102, 1102, 1102, 1102, 1102, 1102, 1102, 1102, 1102, 1102, 1102
1102, 1102, 1102, 1102, 1102, 1102, 1102, 1102, 1102, 1102, 1102, 1102, 1102, 1102, 1102, 1102, 1102, 1102, 1102, 1102, 1102, 1102, 1102, 1102, 1102, 1102, 1102, 1102, 1102, 1102, 1102, 1102, 1102, 1102, 1102, 1102, 1102, 1102, 1102, 1102, 1102, 1102, 1102, 1102, 1102, 1102, 1102, 1102, 1102, 1102, 1102, 1102, 1102, 1102, 1102, 1102, 1102, 1102, 1102, 1102, 1102, 1102, 1102, 1102, 1102, 1102, 1102, 1102, 1102, 1102, 1102, 1102, 1102, 1102, 1102, 1102, 1102, 1102, 1102, 1102
1102, 1102, 1102, 1102, 1102, 1102, 1102, 1102, 1102, 1102, 1102, 1102, 1102, 1102, 1102, 1102, 1102, 1102, 1102, 1102, 1102, 1102, 1102, 1102, 1102, 1102, 1102, 1102, 1102, 1102, 1102, 1102, 1102, 1102, 1102, 1102, 1102, 1102, 1102, 1102, 1102, 1102, 1102, 1102, 1102, 1102, 1102, 1102, 1102, 1102, 1102, 1102, 1102, 1102, 1102, 1102, 1102, 1102, 1102, 1102, 1102, 1102, 1102, 1102, 1102, 1102, 1102, 1102, 1102, 1102, 1102, 1102, 1102, 1102, 1102, 1102, 1102, 1102, 1102, 1102
1102, 1102, 1102, 1102, 1102, 1102, 1102, 1102, 1102, 1102, 1102, 1102, 1102, 1102, 1102, 1102, 1102, 1102, 1102, 1102, 1102, 1102, 1102, 1102, 1102, 1102, 1102, 1102, 1102, 1102, 1102, 1102, 1102, 1102, 1102, 1102, 1102, 1102, 1102, 1102, 1102, 1102, 1102, 1102, 1102, 1102, 1102, 1102, 1102, 1102, 1102, 1102, 1102, 1102, 1102, 1102, 1102, 1102, 1102, 1102, 1102, 1102, 1102, 1102, 1102, 1102, 1102, 1102, 1102, 1102, 1102, 1102, 1102, 1102, 1102, 1102, 1102, 1102, 1102, 1102
1102, 1102, 1102, 1102, 1102, 1102, 1102, 1102, 1102, 1102, 1102, 1102, 1102, 1102, 1102, 1102, 1102, 1102, 1102, 1102, 1102, 1102, 1102, 1102, 1102, 1102, 1102, 1102, 1102, 1102, 1102, 1102, 1102, 1102, 1102, 1102, 1102, 1102, 1102, 1102, 1102, 1102, 1102, 1102, 1102, 1102, 1102, 1102, 1102, 1102, 1102, 1102, 1102, 1102, 1102, 1102, 1102, 1102, 1102, 1102, 1102, 1102, 1102, 1102, 1102, 1102, 1102, 1102, 1102, 1102, 1102, 1102, 1102, 1102, 1102, 1102, 1102, 1102, 1102, 1102
