7759, 7759, 7759, 7759, 7759, 7759, 7759, 7759, 7759, 7759, 7759, 7759, 7759, 7759, 7759, 7759, 7759, 7759, 7759, 7759, 7759, 7759, 7759, 7759, 7759, 7759, 7759, 7759, 7759, 7759, 7759, 7759, 7759, 7759, 7759, 7759, 7759, 7759, 7759, 7759, 7759, 7759, 7759, 7759, 7759, 7759, 7759, 7759, 7759, 7759, 7759, 7759, 7759, 7759, 7759, 7759, 7759, 7759, 7759, 7759, 7759, 7759, 7759, 7759, 7759, 7759, 7759, 7759, 7759, 7759, 7759, 7759, 7759, 7759, 7759, 7759, 7759, 7759, 7759, 7759
7759, 7759, 7759, 7759, 7759, 7759, 7759, 7759, 7759, 7759, 7759, 7759, 7759, 7759, 7759, 7759, 7759, 7759, 7759, 7759, 7759, 7759, 7759, 7759, 7759, 7759, 7759, 7759, 7759, 7759, 7759, 7759, 7759, 7759, 7759, 7759, 7759, 7759, 7759, 7759, 7759, 7759, 7759, 7759, 7759, 7759, 7759, 7759, 7759, 7759, 7759, 7759, 7759, 7759, 7759, 7759, 7759, 7759, 7759, 7759, 7759, 7759, 7759, 7759, 7759, 7759, 7759, 7759, 7759, 7759, 7759, 7759, 7759, 7759, 7759, 7759, 7759, 7759, 7759, 7759
7759, 7759, 7759, 7759, 7759, 7759, 7759, 7759, 7759, 7759, 7759, 7759, 7759, 7759, 7759, 7759, 7759, 7759, 7759, 7759, 7759, 7759, 7759, 7759, 7759, 7759, 7759, 7759, 7759, 7759, 7759, 7759, 7759, 7759, 7759, 7759, 7759, 7759, 7759, 7759, 7759, 7759, 7759, 7759, 7759, 7759, 7759, 7759, 7759, 7759, 7759, 7759, 7759, 7759, 7759, 7759, 7759, 7759, 7759, 7759, 7759, 7759, 7759, 7759, 7759, 7759, 7759, 7759, 7759, 7759, 7759, 7759, 7759, 7759, 7759, 7759, 7759, 7759, 7759, 7759
7759, 7759, 7759, 7759, 7759, 7759, 7759, 7759, 7759, 7759, 7759, 7759, 7759, 7759, 7759, 7759, 7759, 7759, 7759, 7759, 7759, 7759, 7759, 7759, 7759, 7759, 7759, 7759, 7759, 7759, 7759, 7759, 7759, 7759, 7759, 7759, 7759, 7759, 7759, 7759, 7759, 7759, 7759, 7759, 7759, 7759, 7759, 7759, 7759, 7759, 7759, 7759, 7759, 7759, 7759, 7759, 7759, 7759, 7759, 7759, 7759, 7759, 7759, 7759, 7759, 7759, 7759, 7759, 7759, 7759, 7759, 7759, 7759, 7759, 7759, 7759, 7759, 7759, 7759, 7759
7759, 7759, 7759, 7759, 7759, 7759, 7759, 7759, 7759, 7759, 7759, 7759, 7759, 7759, 7759, 7759, 7759, 7759, 7759, 7759, 7759, 7759, 7759, 7759, 7759, 7759, 7759, 7759, 7759, 7759, 7759, 7759, 7759, 7759, 7759, 7759, 7759, 7759, 7759, 7759, 7759, 7759, 7759, 7759, 7759, 7759, 7759, 7759, 7759, 7759, 7759, 7759, 7759, 7759, 7759, 7759, 7759, 7759, 7759, 7759, 7759, 7759, 7759, 7759, 7759, 7759, 7759, 7759, 7759, 7759, 7759, 7759, 7759, 7759, 7759, 7759, 7759, 7759, 7759, 7759
7759, 7759, 7759, 7759, 7759, 7759, 7759, 7759, 7759, 7759, 7759, 7759, 7759, 7759, 7759, 7759, 7759, 7759, 7759, 7759, 7759, 7759, 7759, 7759, 7759, 7759, 7759, 7759, 7759, 7759, 7759, 7759, 7759, 7759, 7759, 7759, 7759, 7759, 7759, 7759, 7759, 7759, 7759, 7759, 7759, 7759, 7759, 7759, 7759, 7759, 7759, 7759, 7759, 7759, 7759, 7759, 7759, 7759, 7759, 7759, 7759, 7759, 7759, 7759, 7759, 7759, 7759, 7759, 7759, 7759, 7759, 7759, 7759, 7759, 7759, 7759, 7759, 7759, 7759, 7759
7759, 7759, 7759, 7759, 7759, 7759, 7759, 7759, 7759, 7759, 7759, 7759, 7759, 7759, 7759, 7759, 7759, 7759, 7759, 7759, 7759, 7759, 7759, 7759, 7759, 7759, 7759, 7759, 7759, 7759, 7759, 7759, 7759, 7759, 7759, 7759, 7759, 7759, 7759, 7759, 7759, 7759, 7759, 7759, 7759, 7759, 7759, 7759, 7759, 7759, 7759, 7759, 7759, 7759, 7759, 7759, 7759, 7759, 7759, 7759, 7759, 7759, 7759, 7759, 7759, 7759, 7759, 7759, 7759, 7759, 7759, 7759, 7759, 7759, 7759, 7759, 7759, 7759, 7759, 7759
7759, 7759, 7759, 7759, 7759, 7759, 7759, 7759, 7759, 7759, 7759, 7759, 7759, 7759, 7759, 7759, 7759, 7759, 7759, 7759, 7759, 7759, 7759, 7759, 7759, 7759, 7759, 7759, 7759, 7759, 7759, 7759, 7759, 7759, 7759, 7759, 7759, 7759, 7759, 7759, 7759, 7759, 7759, 7759, 7759, 7759, 7759, 7759, 7759, 7759, 7759, 7759, 7759, 7759, 7759, 7759, 7759, 7759, 7759, 7759, 7759, 7759, 7759, 7759, 7759, 7759, 7759, 7759, 7759, 7759, 7759, 7759, 7759, 7759, 7759, 7759, 7759, 7759, 7759, 7759
7759, 7759, 7759, 7759, 7759, 7759, 7759, 7759, 7759, 7759, 7759, 7759, 7759, 7759, 7759, 7759, 7759, 7759, 7759, 7759, 7759, 7759, 7759, 7759, 7759, 7759, 7759, 7759, 7759, 7759, 7759, 7759, 7759, 7759, 7759, 7759, 7759, 7759, 7759, 7759, 7759, 7759, 7759, 7759, 7759, 7759, 7759, 7759, 7759, 7759, 7759, 7759, 7759, 7759, 7759, 7759, 7759, 7759, 7759, 7759, 7759, 7759, 7759, 7759, 7759, 7759, 7759, 7759, 7759, 7759, 7759, 7759, 7759, 7759, 7759, 7759, 7759, 7759, 7759, 7759
7759, 5684, 5685, 5364, 5365, 5366, 5367, 5368, 5369, 5370, 5371, 5372, 5373, 5374, 5375, 5376, 5377, 5378, 5379, 5380, 5381, 5382, 5383, 5384, 5385, 5386, 5387, 5388, 5389, 5390, 5391, 5392, 5393, 5394, 5395, 5396, 5397, 5398, 5399, 5400, 5401, 5402, 5403, 5404, 5405, 5406, 5407, 5408, 5409, 5410, 5411, 5412, 5413, 5414, 5415, 5416, 5417, 5418, 5419, 5420, 5421, 5422, 5423, 5424, 5425, 5426, 5427, 5428, 5429, 5430, 5686, 5687, 7759, 7759, 7759, 7759, 7759, 7759, 7759, 7759
7759, 5764, 5765, 5444, 5445, 5446, 5447, 5448, 5449, 5450, 5451, 5452, 5453, 5454, 5455, 5456, 5457, 5458, 5459, 5460, 5461, 5462, 5463, 5464, 5465, 7766, 7767, 5468, 5469, 5470, 5471, 5472, 5473, 5474, 5475, 5476, 5477, 5478, 5479, 5480, 5481, 5482, 5483, 5484, 5485, 5486, 5487, 7766, 7767, 5490, 5491, 5492, 5493, 5494, 5495, 5496, 5497, 5498, 5499, 5500, 5501, 5502, 5503, 5504, 5505, 5506, 5507, 5508, 5509, 5510, 5766, 5767, 7759, 7759, 7759, 7759, 7759, 7759, 7759, 7759
7759, 5360, 5361, 162, 163, 164, 165, 166, 167, 168, 169, 170, 171, 172, 173, 174, 175, 176, 177, 178, 179, 180, 181, 182, 183, 7846, 7847, 186, 187, 188, 189, 190, 191, 192, 193, 194, 195, 196, 197, 198, 199, 200, 201, 202, 203, 204, 205, 7846, 7847, 208, 209, 210, 211, 212, 213, 214, 215, 216, 217, 218, 219, 220, 221, 222, 223, 224, 225, 226, 227, 228, 5442, 5443, 7759, 7759, 7759, 7759, 7759, 7759, 7759, 7759
7759, 5440, 5441, 242, 243, 244, 245, 246, 247, 248, 249, 250, 251, 252, 253, 254, 255, 256, 257, 258, 259, 260, 261, 262, 263, 7766, 7767, 266, 267, 268, 269, 270, 271, 272, 273, 274, 275, 276, 277, 278, 279, 280, 281, 282, 283, 284, 285, 7846, 7847, 288, 289, 290, 291, 292, 293, 294, 295, 296, 297, 298, 299, 300, 301, 302, 303, 304, 305, 306, 307, 308, 5522, 5523, 7759, 7759, 7759, 7759, 7759, 7759, 7759, 7759
7759, 5520, 5521, 322, 323, 324, 325, 326, 327, 328, 329, 330, 331, 332, 333, 334, 335, 336, 337, 338, 339, 340, 341, 342, 343, 7846, 7847, 346, 347, 348, 349, 350, 351, 352, 353, 354, 355, 356, 357, 358, 359, 360, 361, 362, 363, 364, 365, 7766, 7767, 368, 369, 5132, 5133, 5134, 5135, 5135, 5135, 5134, 5135, 5134, 5135, 5134, 5135, 5134, 5134, 5135, 5136, 5137, 387, 388, 5602, 5603, 7759, 7759, 7759, 7759, 7759, 7759, 7759, 7759
7759, 5600, 5601, 402, 403, 404, 405, 406, 407, 408, 409, 410, 411, 412, 413, 414, 415, 416, 417, 418, 419, 420, 421, 422, 423, 7766, 7767, 426, 427, 428, 429, 430, 431, 432, 433, 434, 435, 436, 437, 438, 439, 440, 441, 442, 443, 444, 445, 7846, 7847, 448, 449, 5214, 5215, 5214, 5215, 5215, 5134, 5135, 5215, 5214, 5134, 5135, 5134, 5135, 5214, 5215, 5216, 5217, 467, 468, 5682, 5683, 7759, 7759, 7759, 7759, 7759, 7759, 7759, 7759
7759, 5680, 5681, 482, 483, 484, 485, 486, 487, 488, 489, 490, 491, 492, 493, 494, 495, 496, 497, 498, 499, 500, 501, 502, 503, 7846, 7847, 506, 507, 508, 509, 510, 511, 512, 513, 514, 515, 516, 517, 518, 519, 520, 521, 522, 523, 524, 525, 7766, 7767, 528, 529, 5294, 5295, 5134, 5135, 5134, 5214, 5215, 5135, 5134, 5214, 5215, 5214, 5215, 5135, 5214, 5214, 5215, 547, 548, 5762, 5763, 7759, 7759, 7759, 7759, 7759, 7759, 7759, 7759
7759, 5760, 5761, 562, 563, 564, 565, 566, 567, 568, 569, 570, 571, 572, 573, 574, 575, 576, 577, 578, 579, 580, 581, 582, 583, 7766, 7767, 7766, 7767, 7766, 7767, 7766, 7767, 7766, 7767, 7766, 7767, 7766, 7767, 655, 656, 600, 601, 602, 603, 604, 605, 7846, 7847, 608, 609, 5134, 5134, 5135, 5134, 5135, 5134, 5135, 5215, 5214, 5134, 5135, 5215, 5214, 5134, 5135, 5134, 5135, 627, 628, 5842, 5843, 7759, 7759, 7759, 7759, 7759, 7759, 7759, 7759
7759, 5840, 5841, 642, 643, 644, 645, 646, 647, 648, 649, 650, 7322, 7323, 653, 654, 655, 656, 657, 658, 659, 660, 661, 662, 663, 7846, 7847, 7846, 7847, 7846, 7847, 7846, 7847, 7846, 7847, 7846, 7847, 7846, 7847, 735, 736, 680, 681, 682, 683, 684, 685, 7766, 7767, 688, 689, 5214, 5215, 5134, 5135, 5215, 5214, 5215, 5135, 5135, 5214, 5215, 5134, 5135, 5134, 5135, 5134, 5135, 707, 708, 5922, 5923, 7759, 7759, 7759, 7759, 7759, 7759, 7759, 7759
7759, 5920, 5921, 722, 723, 724, 725, 726, 727, 728, 729, 730, 7402, 7403, 733, 734, 735, 736, 737, 738, 739, 740, 741, 742, 743, 744, 745, 746, 747, 7780, 7781, 750, 751, 752, 753, 754, 755, 756, 757, 758, 759, 760, 761, 762, 763, 764, 765, 7846, 7847, 768, 769, 5294, 5295, 5214, 5215, 5134, 5135, 5134, 5135, 5215, 5134, 5135, 5214, 5215, 5214, 5215, 5134, 5135, 787, 788, 6002, 6003, 7759, 7759, 7759, 7759, 7759, 7759, 7759, 7759
7759, 6000, 6001, 802, 803, 804, 805, 806, 807, 808, 7322, 7323, 7322, 7323, 7322, 7323, 815, 816, 817, 818, 819, 820, 821, 822, 823, 824, 825, 826, 827, 7860, 7861, 830, 831, 832, 833, 834, 835, 836, 837, 838, 839, 840, 841, 842, 843, 844, 845, 7766, 7767, 848, 849, 5212, 5213, 5135, 5134, 5214, 5215, 5214, 5215, 5135, 5214, 5215, 5134, 5135, 5134, 5134, 5216, 5217, 867, 868, 6082, 6083, 7759, 7759, 7759, 7759, 7759, 7759, 7759, 7759
7759, 6080, 6081, 882, 883, 884, 885, 886, 887, 888, 7402, 7403, 7402, 7403, 7402, 7403, 895, 896, 897, 898, 899, 900, 901, 902, 903, 904, 905, 906, 907, 655, 656, 910, 911, 912, 913, 914, 915, 916, 917, 918, 919, 920, 921, 922, 923, 924, 925, 7846, 7847, 928, 929, 5292, 5293, 5215, 5214, 5215, 5214, 5215, 5214, 5215, 5214, 5215, 5214, 5215, 5214, 5214, 5296, 5297, 947, 948, 6162, 6163, 7759, 7759, 7759, 7759, 7759, 7759, 7759, 7759
7759, 6160, 6161, 962, 963, 964, 965, 966, 967, 968, 969, 970, 7322, 7323, 973, 974, 975, 976, 977, 978, 979, 980, 981, 982, 983, 984, 985, 986, 987, 735, 736, 990, 991, 992, 993, 994, 995, 996, 997, 998, 999, 1000, 1001, 1002, 1003, 1004, 1005, 7766, 7767, 1008, 1009, 1010, 1011, 1012, 1013, 1014, 1015, 1016, 1017, 1018, 1019, 1020, 1021, 1022, 1023, 1024, 1025, 1026, 1027, 1028, 6242, 6243, 7759, 7759, 7759, 7759, 7759, 7759, 7759, 7759
7759, 6240, 6241, 1042, 1043, 1044, 1045, 1046, 1047, 1048, 1049, 1050, 7402, 7403, 1053, 1054, 1055, 1056, 1057, 1058, 1059, 1060, 1061, 1062, 1063, 1064, 1065, 1066, 1067, 1068, 1069, 1070, 1071, 1072, 1073, 1074, 1075, 1076, 1077, 1078, 1079, 1080, 1081, 1082, 1083, 1084, 1085, 7846, 7847, 1088, 1089, 1090, 1091, 1092, 1093, 1094, 1095, 1096, 1097, 1098, 1099, 1100, 1101, 1102, 1103, 1104, 1105, 1106, 1107, 1108, 6322, 6323, 7759, 7759, 7759, 7759, 7759, 7759, 7759, 7759
7759, 6320, 6321, 1122, 1123, 1124, 1125, 1126, 1127, 1128, 1129, 1130, 1131, 1132, 1133, 1134, 1135, 1136, 1137, 1138, 1139, 1140, 1141, 1142, 1143, 1144, 1145, 1146, 1147, 1148, 1149, 1150, 1151, 1152, 1153, 339, 340, 1156, 1157, 1158, 1159, 1160, 1161, 1162, 1163, 1164, 1165, 7766, 7767, 1168, 1169, 1170, 1171, 1172, 1173, 1174, 1175, 1176, 1177, 1178, 1179, 1180, 1181, 1182, 1183, 1184, 1185, 1186, 1187, 1188, 6402, 6403, 7759, 7759, 7759, 7759, 7759, 7759, 7759, 7759
7759, 6400, 6401, 1202, 1203, 1204, 1205, 1206, 1207, 1208, 1209, 1210, 1211, 1212, 1213, 1214, 1215, 1216, 1217, 1218, 1219, 1220, 1221, 1222, 1223, 1224, 1225, 1226, 1227, 1228, 1229, 1230, 1231, 1232, 1233, 419, 420, 1236, 1237, 1238, 1239, 1240, 1241, 1242, 1243, 1244, 1245, 7846, 7847, 1248, 1249, 1250, 1251, 1252, 1253, 1254, 1255, 1256, 1257, 1258, 1259, 1260, 1261, 1262, 1263, 1264, 1265, 1266, 1267, 1268, 6482, 6483, 7759, 7759, 7759, 7759, 7759, 7759, 7759, 7759
7759, 5360, 5361, 1282, 1283, 1284, 1285, 1286, 1287, 1288, 1289, 1290, 1291, 1292, 1293, 1294, 1295, 1296, 1297, 1298, 1299, 1300, 1301, 1302, 1303, 1304, 1305, 1306, 1058, 1059, 1060, 1061, 1060, 7780, 7781, 7780, 7781, 1059, 1060, 1061, 1058, 1059, 1060, 1061, 1059, 1060, 1061, 7766, 7767, 1058, 1059, 1060, 1061, 1058, 1059, 1060, 1061, 1058, 1059, 1060, 1061, 1058, 1059, 1058, 1059, 1060, 1058, 1059, 1060, 1061, 5362, 5363, 7759, 7759, 7759, 7759, 7759, 7759, 7759, 7759
7759, 5440, 5441, 1362, 1363, 1364, 1365, 1366, 1367, 1368, 1369, 1370, 1371, 1372, 1373, 1374, 1375, 1376, 1377, 1378, 1379, 1380, 1381, 1382, 1383, 1384, 1385, 1386, 1138, 1139, 1140, 1141, 1140, 7860, 7861, 7860, 7861, 1139, 1140, 1141, 1138, 1139, 1140, 1141, 1139, 1140, 1141, 7846, 7847, 1138, 1139, 1140, 1141, 1138, 1139, 1140, 1141, 1138, 1139, 1140, 1141, 1138, 1139, 1138, 1139, 1140, 1138, 1139, 1140, 1141, 5442, 5443, 7759, 7759, 7759, 7759, 7759, 7759, 7759, 7759
7759, 5520, 5521, 1442, 1443, 1444, 1445, 1446, 1447, 1448, 1449, 1450, 1451, 1452, 1453, 1454, 1455, 1456, 1457, 1458, 1459, 1460, 7782, 7783, 7784, 7768, 7769, 7770, 7771, 7768, 7769, 7770, 7771, 7768, 7769, 7770, 7771, 7768, 7769, 7770, 7771, 7768, 7769, 7768, 7769, 7770, 7771, 7766, 7767, 1218, 1219, 1220, 1221, 1218, 1219, 1220, 1221, 1218, 1219, 1220, 1221, 1218, 1219, 1218, 1219, 1220, 1218, 1219, 1220, 1221, 5522, 5523, 7759, 7759, 7759, 7759, 7759, 7759, 7759, 7759
7759, 5600, 5601, 1522, 1523, 1524, 1525, 1526, 1527, 1528, 1529, 1530, 1531, 1532, 1533, 1534, 1535, 1536, 1537, 1538, 1539, 1540, 7862, 7863, 7864, 7848, 7849, 7850, 7851, 7848, 7849, 7850, 7851, 7848, 7849, 7850, 7851, 7848, 7849, 7850, 7851, 7848, 7849, 7848, 7849, 7850, 7851, 7846, 7847, 1298, 1299, 1300, 1301, 1298, 1299, 1300, 1301, 1298, 1299, 1300, 1301, 1298, 1299, 1298, 1299, 1300, 1298, 1299, 1300, 1301, 5602, 5603, 7759, 7759, 7759, 7759, 7759, 7759, 7759, 7759
7759, 5680, 5681, 1602, 1603, 1604, 1605, 1606, 1607, 1608, 1609, 1610, 1611, 1612, 1613, 1614, 1615, 1616, 1617, 1618, 1619, 1620, 7942, 7943, 7944, 7928, 7929, 7930, 7931, 7928, 7929, 7930, 7931, 7928, 7929, 7930, 7931, 7928, 7929, 7930, 7931, 7928, 7929, 7928, 7929, 7930, 7931, 7770, 7771, 2198, 2199, 2200, 2198, 2199, 2200, 2201, 2198, 2199, 2198, 2199, 2198, 2199, 2198, 2199, 2200, 2198, 2198, 2199, 2200, 2201, 5682, 5683, 7759, 7759, 7759, 7759, 7759, 7759, 7759, 7759
7759, 5760, 5761, 1682, 1683, 1684, 1685, 1686, 1687, 1688, 1689, 1690, 1691, 1692, 1693, 1694, 1695, 1696, 1697, 1698, 1699, 1700, 8022, 8023, 8024, 8008, 8009, 8010, 8011, 8008, 8009, 8010, 8011, 8008, 8009, 8010, 8011, 8008, 8009, 8010, 8011, 8008, 8009, 8008, 8009, 8010, 8011, 7850, 7851, 2278, 2279, 2280, 2278, 2279, 2280, 2281, 2278, 2279, 2278, 2279, 2278, 2279, 2278, 2279, 2280, 2278, 2278, 2279, 2280, 2281, 5762, 5763, 7759, 7759, 7759, 7759, 7759, 7759, 7759, 7759
7759, 5840, 5841, 7768, 7769, 7770, 7771, 7768, 7769, 7770, 7771, 726, 727, 728, 729, 726, 727, 728, 729, 7768, 7769, 7770, 7771, 7768, 7769, 7770, 7771, 2657, 2658, 2659, 2660, 2657, 2658, 2657, 2658, 2659, 2660, 7928, 7929, 7930, 7931, 7928, 7929, 7930, 7931, 7928, 7929, 7930, 7931, 2358, 2359, 2360, 2358, 2359, 2360, 2361, 2358, 2359, 2358, 2359, 2358, 2359, 2358, 2359, 2360, 2358, 2358, 2359, 2360, 2361, 5842, 5843, 7759, 7759, 7759, 7759, 7759, 7759, 7759, 7759
7759, 5920, 5921, 7848, 7849, 7850, 7851, 7848, 7849, 7850, 7851, 806, 807, 808, 809, 806, 807, 808, 809, 7848, 7849, 7850, 7851, 7848, 7849, 7850, 7851, 2737, 2738, 2739, 2740, 2737, 2738, 2737, 2738, 2739, 2740, 8008, 8009, 8010, 8011, 8008, 8009, 8010, 8011, 8008, 8009, 8010, 8011, 2438, 2439, 2440, 2438, 2439, 2440, 2441, 2438, 2439, 2438, 2439, 2438, 2439, 2438, 2439, 2440, 2438, 2438, 2439, 2440, 2441, 5922, 5923, 7759, 7759, 7759, 7759, 7759, 7759, 7759, 7759
7759, 6000, 6001, 7928, 7929, 7930, 7931, 7928, 7929, 7930, 7931, 886, 887, 888, 889, 886, 887, 888, 889, 7928, 7929, 7930, 7931, 7928, 7929, 7930, 7931, 2817, 2818, 2819, 2820, 2817, 2818, 2817, 2818, 2819, 2820, 7768, 7769, 7770, 7771, 7768, 7769, 7770, 7771, 7768, 7769, 7770, 7771, 7768, 7769, 7770, 7768, 7769, 7770, 7771, 726, 727, 728, 729, 726, 727, 728, 729, 7768, 7769, 7768, 7769, 7770, 7771, 6002, 6003, 7759, 7759, 7759, 7759, 7759, 7759, 7759, 7759
7759, 6080, 6081, 8008, 8009, 8010, 8011, 8008, 8009, 8010, 8011, 966, 967, 968, 969, 966, 967, 968, 969, 8008, 8009, 8010, 8011, 8008, 8009, 8010, 8011, 2897, 2898, 2899, 2900, 2897, 2898, 2897, 2898, 2899, 2900, 7848, 7849, 7850, 7851, 7848, 7849, 7850, 7851, 7848, 7849, 7850, 7851, 7848, 7849, 7850, 7848, 7849, 7850, 7851, 806, 807, 808, 809, 806, 807, 808, 809, 7848, 7849, 7848, 7849, 7850, 7851, 6082, 6083, 7759, 7759, 7759, 7759, 7759, 7759, 7759, 7759
7759, 6160, 6161, 2082, 2083, 2084, 2085, 2086, 2087, 2088, 2089, 2090, 2091, 2092, 2093, 2094, 2095, 2096, 2097, 2098, 2099, 2100, 2101, 2102, 2103, 2104, 2105, 2106, 2107, 2108, 2109, 2110, 2111, 2112, 2113, 2114, 2115, 7928, 7929, 7930, 7931, 7928, 7929, 7930, 7931, 7928, 7929, 7930, 7931, 7928, 7929, 7930, 7928, 7929, 7930, 7931, 886, 887, 888, 889, 886, 887, 888, 889, 7928, 7929, 7928, 7929, 7930, 7931, 6162, 6163, 7759, 7759, 7759, 7759, 7759, 7759, 7759, 7759
7759, 6240, 6241, 2162, 2163, 2164, 2165, 2166, 2167, 2168, 2169, 2170, 2171, 2172, 2173, 2174, 2175, 2176, 2177, 2178, 2179, 2180, 2181, 2182, 2183, 2184, 2185, 2186, 2187, 2188, 2189, 2190, 2191, 2192, 2193, 2194, 2195, 8008, 8009, 8010, 8011, 8008, 8009, 8010, 8011, 8008, 8009, 8010, 8011, 8008, 8009, 8010, 8008, 8009, 8010, 8011, 966, 967, 968, 969, 966, 967, 968, 969, 8008, 8009, 8008, 8009, 8010, 8011, 6242, 6243, 7759, 7759, 7759, 7759, 7759, 7759, 7759, 7759
7759, 6320, 6321, 2242, 2243, 2244, 2245, 2246, 2247, 2248, 2249, 2250, 2251, 2252, 2253, 2254, 2255, 2256, 2257, 2258, 2259, 2260, 2261, 2262, 2263, 2264, 2265, 2266, 2267, 2268, 2269, 2270, 2271, 2272, 2273, 2274, 2275, 7768, 7769, 7770, 7771, 2280, 2281, 2282, 2283, 2284, 2285, 7322, 7323, 2288, 2289, 2290, 2291, 2292, 2293, 2294, 2295, 2296, 2297, 2298, 2299, 2300, 2301, 2302, 2303, 2304, 2305, 2306, 2307, 2308, 6322, 6323, 7759, 7759, 7759, 7759, 7759, 7759, 7759, 7759
7759, 6400, 6401, 2322, 2323, 2324, 2325, 2326, 2327, 2328, 2329, 2330, 2331, 2332, 2333, 2334, 2335, 2336, 2337, 2338, 2339, 2340, 2341, 2342, 2343, 2344, 2345, 2346, 2347, 2348, 2349, 2350, 2351, 2352, 2353, 2354, 2355, 726, 727, 728, 729, 2360, 2361, 2362, 2363, 513, 514, 7402, 7403, 2368, 2369, 2370, 2371, 2372, 2373, 2374, 2375, 2376, 2377, 2378, 2379, 2380, 2381, 2382, 2383, 2384, 2385, 2386, 2387, 2388, 6402, 6403, 7759, 7759, 7759, 7759, 7759, 7759, 7759, 7759
7759, 6480, 6481, 7760, 7761, 7760, 7761, 7760, 7761, 7760, 7761, 7760, 7761, 2412, 2413, 2414, 2415, 2416, 2417, 2418, 2419, 2420, 2421, 2422, 2423, 2424, 2425, 2426, 2427, 2428, 2429, 2430, 2431, 2432, 2433, 2434, 2435, 806, 807, 808, 809, 2440, 2441, 2442, 2443, 593, 594, 7322, 7323, 2448, 2449, 2450, 2451, 2452, 2453, 2454, 2455, 2456, 2457, 2458, 2459, 2460, 2461, 2462, 2463, 2464, 2465, 2466, 2467, 2468, 6482, 6483, 7759, 7759, 7759, 7759, 7759, 7759, 7759, 7759
7759, 6560, 6561, 7840, 7841, 7840, 7841, 7840, 7841, 7840, 7841, 7840, 7841, 2492, 2493, 2494, 2495, 2496, 2497, 2498, 2499, 2500, 2501, 2502, 2503, 2504, 2505, 2506, 2507, 2508, 2509, 2510, 2511, 2512, 2513, 2514, 2515, 886, 887, 888, 889, 2520, 2521, 2522, 2523, 513, 514, 7402, 7403, 2528, 2529, 2530, 2531, 2532, 2533, 2534, 2535, 2536, 2537, 2538, 2539, 2540, 2541, 2542, 2543, 2544, 2545, 2546, 2547, 2548, 6562, 6563, 7759, 7759, 7759, 7759, 7759, 7759, 7759, 7759
7759, 6640, 6641, 5134, 5135, 5134, 5135, 5134, 5135, 5134, 5135, 5134, 5135, 5134, 5135, 5214, 5215, 5214, 5215, 5214, 5215, 5214, 5215, 5134, 5135, 5136, 5137, 2586, 2587, 2588, 2589, 2590, 2591, 2592, 2593, 2594, 2595, 966, 967, 968, 969, 2600, 2601, 2602, 2603, 593, 594, 7322, 7323, 2608, 2609, 2610, 2611, 2612, 2613, 2614, 2615, 2616, 2617, 2618, 2619, 2620, 2621, 2622, 2623, 2624, 2625, 2626, 2627, 5040, 6642, 6643, 7759, 7759, 7759, 7759, 7759, 7759, 7759, 7759
7759, 6720, 6721, 5214, 5134, 5135, 5214, 5215, 5294, 5295, 5134, 5135, 5214, 5215, 5134, 5135, 5214, 5215, 5294, 5295, 5134, 5135, 5214, 5215, 5215, 5216, 5217, 2666, 2667, 2668, 2669, 2670, 2671, 2672, 2673, 2674, 2675, 726, 727, 728, 729, 2680, 2681, 2682, 2683, 513, 514, 7402, 7403, 2688, 2689, 2690, 2691, 2692, 2693, 4124, 4125, 2696, 2697, 2698, 2699, 2700, 2701, 2702, 2703, 2704, 2705, 2706, 2707, 5040, 6722, 6723, 7759, 7759, 7759, 7759, 7759, 7759, 7759, 7759
7759, 6800, 6801, 5134, 5135, 5134, 5135, 5294, 5295, 5134, 5135, 5214, 5215, 5134, 5134, 5135, 5215, 5294, 5134, 5135, 5135, 5214, 5215, 5294, 5295, 5296, 5297, 2746, 2747, 2748, 2749, 2750, 2751, 2752, 2753, 2754, 2755, 806, 807, 808, 809, 2760, 2761, 2762, 2763, 593, 594, 7322, 7323, 2768, 2769, 2770, 2771, 2772, 2773, 4204, 4205, 2776, 2777, 2778, 2779, 2780, 2781, 2782, 2783, 2784, 2785, 2786, 2787, 5040, 6802, 6803, 7759, 7759, 7759, 7759, 7759, 7759, 7759, 7759
7759, 6880, 6881, 5214, 5215, 5134, 5135, 2806, 2807, 2808, 2809, 5208, 5209, 5210, 5214, 5215, 5214, 5215, 5214, 5215, 5209, 5210, 5211, 2822, 2823, 2824, 2825, 2826, 2827, 2828, 2829, 2830, 2831, 2832, 2833, 2834, 2835, 886, 887, 888, 889, 2840, 2841, 2842, 2843, 513, 514, 7402, 7403, 2848, 2849, 2850, 2851, 2852, 2853, 2854, 2855, 2856, 2857, 2858, 2859, 2860, 2861, 2862, 2863, 2864, 2865, 2866, 2867, 2868, 6882, 6883, 7759, 7759, 7759, 7759, 7759, 7759, 7759, 7759
7759, 6960, 6961, 5294, 5295, 5214, 5215, 2886, 2887, 2888, 2889, 2890, 2891, 2892, 2893, 5204, 5205, 5206, 5207, 2898, 2899, 2900, 2901, 2902, 2903, 2904, 2905, 2906, 2907, 2908, 2909, 2910, 2911, 2912, 2913, 2914, 2915, 966, 967, 968, 969, 2920, 2921, 2922, 2923, 593, 594, 2926, 2927, 2928, 2929, 2930, 2931, 2932, 2933, 7322, 7323, 2936, 2937, 2938, 2939, 2940, 2941, 2942, 2943, 2944, 2945, 2946, 2947, 2948, 6962, 6963, 7759, 7759, 7759, 7759, 7759, 7759, 7759, 7759
7759, 7040, 7041, 5214, 5215, 7760, 7761, 2966, 2967, 2968, 2969, 2970, 2971, 2972, 2973, 2974, 2975, 2976, 2977, 2978, 2979, 2980, 2981, 2982, 2983, 2984, 2985, 2986, 2987, 2988, 2989, 2990, 2991, 2992, 2993, 2994, 2995, 7768, 7769, 7770, 7771, 3000, 3001, 3002, 3003, 3004, 3005, 3006, 3007, 3008, 3009, 3010, 3011, 3012, 3013, 7402, 7403, 3016, 3017, 3018, 3019, 3020, 3021, 3022, 3023, 3024, 3025, 3026, 3027, 3028, 7042, 7043, 7759, 7759, 7759, 7759, 7759, 7759, 7759, 7759
7759, 7120, 7121, 5294, 5295, 7840, 7841, 3046, 3047, 3048, 3049, 3050, 3051, 3052, 3053, 3054, 3055, 3056, 3057, 3058, 3059, 3060, 3061, 3062, 3063, 3064, 3065, 3066, 3067, 3068, 3069, 3070, 3071, 3072, 3073, 3074, 3075, 7848, 7849, 7850, 7851, 3080, 3081, 3082, 3083, 3084, 3085, 3086, 3087, 3088, 3089, 3090, 3091, 3092, 3093, 3094, 3095, 3096, 3097, 3098, 3099, 3100, 3101, 3102, 3103, 3104, 3105, 3106, 3107, 3108, 7122, 7123, 7759, 7759, 7759, 7759, 7759, 7759, 7759, 7759
7759, 7200, 7201, 5214, 5215, 7760, 7761, 3126, 3127, 3128, 3129, 3130, 3131, 3132, 3133, 3134, 3135, 3136, 3137, 3138, 3139, 3140, 3141, 3142, 3143, 3144, 3145, 3146, 3147, 3148, 3149, 3150, 3151, 3152, 3153, 3154, 3155, 7928, 7929, 7930, 7931, 3160, 3161, 3162, 3163, 3164, 3165, 3166, 3167, 3168, 3169, 3170, 3171, 3172, 3173, 3174, 3175, 3176, 3177, 3178, 3179, 3180, 3181, 3182, 3183, 3184, 3185, 3186, 3187, 3188, 7202, 7203, 7759, 7759, 7759, 7759, 7759, 7759, 7759, 7759
7759, 7280, 7281, 5294, 5295, 7840, 7841, 3206, 3207, 3208, 3209, 3210, 3211, 3212, 3213, 3214, 3215, 3216, 3217, 3218, 3219, 3220, 3221, 3222, 3223, 3224, 3225, 3226, 3227, 3228, 3229, 3230, 3231, 3232, 3233, 3234, 3235, 8008, 8009, 8010, 8011, 3240, 3241, 3242, 3243, 3244, 3245, 3246, 3247, 3248, 3249, 3250, 3251, 3252, 3253, 3254, 3255, 3256, 3257, 3258, 3259, 3260, 3261, 3262, 3263, 3264, 3265, 3266, 3267, 3268, 7282, 7283, 7759, 7759, 7759, 7759, 7759, 7759, 7759, 7759
7759, 7360, 7361, 5214, 5215, 5134, 5135, 3286, 3287, 3288, 3289, 3290, 3291, 3292, 3293, 5128, 5129, 5130, 5131, 3298, 3299, 3300, 3301, 3302, 3303, 3304, 3305, 3306, 3307, 3308, 3309, 3310, 3311, 3312, 3313, 3314, 3315, 7768, 7769, 7770, 7771, 3320, 3321, 3322, 3323, 3324, 3325, 3326, 3327, 3328, 3329, 3330, 3331, 3332, 3333, 3334, 3335, 3336, 3337, 3338, 3339, 3340, 3341, 3342, 3343, 3344, 3345, 3346, 3347, 3348, 7362, 7363, 7759, 7759, 7759, 7759, 7759, 7759, 7759, 7759
7759, 7440, 7441, 5294, 5295, 5214, 5215, 3366, 3367, 3368, 3369, 5128, 5129, 5134, 5135, 5213, 5214, 5215, 5134, 5135, 5125, 5126, 5127, 3382, 3383, 3384, 3385, 3386, 3387, 3388, 3389, 3390, 3391, 3392, 3393, 3394, 3395, 7848, 7849, 7850, 7851, 3400, 3401, 3402, 3403, 3404, 3405, 3406, 3407, 3408, 3409, 3410, 3411, 3412, 3413, 3414, 3415, 3416, 3417, 3418, 3419, 3420, 3421, 3422, 3423, 3424, 3425, 3426, 3427, 3428, 7442, 7443, 7759, 7759, 7759, 7759, 7759, 7759, 7759, 7759
7759, 7520, 7521, 5134, 5135, 5214, 5215, 5294, 5295, 5134, 5135, 5214, 5215, 5214, 5215, 5135, 5214, 5215, 5214, 5215, 5134, 5135, 5214, 5134, 5135, 5136, 5137, 3466, 3467, 3468, 3469, 3470, 3471, 3472, 3473, 3474, 3475, 7928, 7929, 7930, 7931, 3480, 3481, 3482, 3483, 3484, 3485, 3486, 3487, 3488, 3489, 3490, 3491, 3492, 3493, 3494, 3495, 3496, 3497, 3498, 3499, 3500, 3501, 3502, 3503, 3504, 3505, 3506, 3507, 3508, 7522, 7523, 7759, 7759, 7759, 7759, 7759, 7759, 7759, 7759
7759, 7600, 7601, 5294, 5295, 5134, 5135, 5214, 5215, 5294, 5295, 5134, 5135, 5135, 5294, 5295, 5134, 5135, 5214, 5215, 5294, 5295, 5134, 5214, 5215, 5216, 5217, 3546, 3547, 3548, 3549, 3550, 3551, 3552, 3553, 3554, 3555, 8008, 8009, 8010, 8011, 3560, 3561, 3562, 3563, 3564, 3565, 3566, 3567, 3568, 3569, 3570, 3571, 3572, 3573, 3574, 3575, 7322, 7323, 3578, 3579, 3580, 3581, 3582, 3583, 3584, 3585, 3586, 3587, 3588, 6162, 6163, 7759, 7759, 7759, 7759, 7759, 7759, 7759, 7759
7759, 5844, 5845, 5214, 5215, 5294, 5295, 5134, 5135, 5214, 5215, 5294, 5295, 5295, 5214, 5215, 5294, 5295, 5134, 5135, 5214, 5215, 5294, 5294, 5295, 5296, 5297, 3626, 3627, 3628, 3629, 3630, 3631, 3632, 3633, 3634, 3635, 7768, 7769, 7770, 7771, 3640, 3641, 3642, 3643, 3644, 3645, 3646, 3647, 3648, 3649, 3650, 3651, 3652, 3653, 3654, 3655, 7402, 7403, 5040, 5040, 5040, 3661, 3662, 3663, 3664, 3665, 3666, 3667, 3668, 5846, 5847, 7759, 7759, 7759, 7759, 7759, 7759, 7759, 7759
7759, 5924, 5925, 5524, 5525, 5526, 5527, 5528, 5529, 5530, 5531, 5532, 5533, 5534, 5535, 5536, 5537, 5538, 5539, 5540, 5541, 5542, 5543, 5544, 5545, 5546, 5547, 5548, 5549, 5550, 5551, 5552, 5553, 5554, 5555, 5556, 5557, 5558, 5559, 5560, 5561, 5562, 5563, 5564, 5565, 5566, 5567, 5568, 5569, 5570, 5571, 5572, 5573, 5574, 5575, 5576, 5577, 5578, 5579, 5580, 5581, 5582, 5583, 5584, 5585, 5586, 5587, 5588, 5537, 5538, 5926, 5927, 7759, 7759, 7759, 7759, 7759, 7759, 7759, 7759
7759, 5604, 5605, 5604, 5605, 5606, 5607, 5608, 5609, 5610, 5611, 5612, 5613, 5614, 5615, 5616, 5617, 5618, 5619, 5620, 5621, 5622, 5623, 5624, 5625, 5626, 5627, 5628, 5629, 5630, 5631, 5632, 5633, 5634, 5635, 5636, 5637, 5638, 5639, 5640, 5641, 5642, 5643, 5644, 5645, 5646, 5647, 5648, 5649, 5650, 5651, 5652, 5653, 5654, 5655, 5656, 5657, 5658, 5659, 5660, 5661, 5662, 5663, 5664, 5665, 5666, 5667, 5668, 5617, 5618, 5617, 5618, 7759, 7759, 7759, 7759, 7759, 7759, 7759, 7759
7759, 7759, 7759, 7759, 7759, 7759, 7759, 7759, 7759, 7759, 7759, 7759, 7759, 7759, 7759, 7759, 7759, 7759, 7759, 7759, 7759, 7759, 7759, 7759, 7759, 7759, 7759, 7759, 7759, 7759, 7759, 7759, 7759, 7759, 7759, 7759, 7759, 7759, 7759, 7759, 7759, 7759, 7759, 7759, 7759, 7759, 7759, 7759, 7759, 7759, 7759, 7759, 7759, 7759, 7759, 7759, 7759, 7759, 7759, 7759, 7759, 7759, 7759, 7759, 7759, 7759, 7759, 7759, 7759, 7759, 7759, 7759, 7759, 7759, 7759, 7759, 7759, 7759, 7759, 7759
7759, 7759, 7759, 7759, 7759, 7759, 7759, 7759, 7759, 7759, 7759, 7759, 7759, 7759, 7759, 7759, 7759, 7759, 7759, 7759, 7759, 7759, 7759, 7759, 7759, 7759, 7759, 7759, 7759, 7759, 7759, 7759, 7759, 7759, 7759, 7759, 7759, 7759, 7759, 7759, 7759, 7759, 7759, 7759, 7759, 7759, 7759, 7759, 7759, 7759, 7759, 7759, 7759, 7759, 7759, 7759, 7759, 7759, 7759, 7759, 7759, 7759, 7759, 7759, 7759, 7759, 7759, 7759, 7759, 7759, 7759, 7759, 7759, 7759, 7759, 7759, 7759, 7759, 7759, 7759
7759, 7759, 7759, 7759, 7759, 7759, 7759, 7759, 7759, 7759, 7759, 7759, 7759, 7759, 7759, 7759, 7759, 7759, 7759, 7759, 7759, 7759, 7759, 7759, 7759, 7759, 7759, 7759, 7759, 7759, 7759, 7759, 7759, 7759, 7759, 7759, 7759, 7759, 7759, 7759, 7759, 7759, 7759, 7759, 7759, 7759, 7759, 7759, 7759, 7759, 7759, 7759, 7759, 7759, 7759, 7759, 7759, 7759, 7759, 7759, 7759, 7759, 7759, 7759, 7759, 7759, 7759, 7759, 7759, 7759, 7759, 7759, 7759, 7759, 7759, 7759, 7759, 7759, 7759, 7759
