1121, 1121, 1121, 1121, 1121, 1121, 1121, 1121, 1121, 1121, 1121, 1121, 1121, 1121, 1121, 1121, 1121, 1121, 1121, 1121, 1121, 1121, 1121, 1121, 1121, 1121, 1121, 1121, 1121, 1121, 1121, 1121, 1121, 1121, 1121, 1121, 1121, 1121, 1121, 1121, 1121, 1121, 1121, 1121, 1121, 1121, 1121, 1121, 1121, 1121, 1121, 1121, 1121, 1121, 1121, 1121, 1121, 1121, 1121, 1121, 1121, 1121, 1121, 1121, 1121, 1121, 1121, 1121, 1121, 1121, 1121, 1121, 1121, 1121, 1121, 1121, 1121, 1121, 1121, 1121
1121, 1121, 1121, 1121, 1121, 1121, 1121, 1121, 1121, 1121, 1121, 1121, 1121, 1121, 1121, 1121, 1121, 1121, 1121, 1121, 1121, 1121, 1121, 1121, 1121, 1121, 1121, 1121, 1121, 1121, 1121, 1121, 1121, 1121, 1121, 1121, 1121, 1121, 1121, 1121, 1121, 1121, 1121, 1121, 1121, 1121, 1121, 1121, 1121, 1121, 1121, 1121, 1121, 1121, 1121, 1121, 1121, 1121, 1121, 1121, 1121, 1121, 1121, 1121, 1121, 1121, 1121, 1121, 1121, 1121, 1121, 1121, 1121, 1121, 1121, 1121, 1121, 1121, 1121, 1121
1121, 1121, 1121, 1121, 1121, 1121, 1121, 1121, 1121, 1121, 1121, 1121, 1121, 1121, 1121, 1121, 1121, 1121, 1121, 1121, 1121, 1121, 1121, 1121, 1121, 1121, 1121, 1121, 1121, 1121, 1121, 1121, 1121, 1121, 1121, 1121, 1121, 1121, 1121, 1121, 1121, 1121, 1121, 1121, 1121, 1121, 1121, 1121, 1121, 1121, 1121, 1121, 1121, 1121, 1121, 1121, 1121, 1121, 1121, 1121, 1121, 1121, 1121, 1121, 1121, 1121, 1121, 1121, 1121, 1121, 1121, 1121, 1121, 1121, 1121, 1121, 1121, 1121, 1121, 1121
1121, 1121, 1121, 1121, 1121, 1121, 1121, 1121, 1121, 1121, 1121, 1121, 1121, 1121, 1121, 1121, 1121, 1121, 1121, 1121, 1121, 1121, 1121, 1121, 1121, 1121, 1121, 1121, 1121, 1121, 1121, 1121, 1121, 1121, 1121, 1121, 1121, 1121, 1121, 1121, 1121, 1121, 1121, 1121, 1121, 1121, 1121, 1121, 1121, 1121, 1121, 1121, 1121, 1121, 1121, 1121, 1121, 1121, 1121, 1121, 1121, 1121, 1121, 1121, 1121, 1121, 1121, 1121, 1121, 1121, 1121, 1121, 1121, 1121, 1121, 1121, 1121, 1121, 1121, 1121
1168, 1168, 1168, 1168, 1168, 1168, 1168, 1168, 1168, 1168, 1168, 1168, 1168, 1168, 1168, 1168, 1168, 1168, 1168, 1168, 1168, 1168, 1168, 1168, 1168, 1168, 1168, 1168, 1168, 1168, 1168, 1168, 1168, 1168, 1168, 1168, 1168, 1168, 1168, 1168, 1168, 1168, 1165, 1165, 1165, 1165, 1165, 1165, 1165, 1165, 1165, 1165, 1165, 1165, 1165, 1165, 1165, 1165, 1165, 1165, 1165, 1165, 1165, 1165, 1165, 1165, 1165, 1165, 1165, 1165, 1165, 1165, 1165, 1165, 1165, 1165, 1165, 1165, 1165, 1165
1168, 1168, 1168, 1168, 1168, 1168, 1168, 1168, 1168, 1168, 1168, 1168, 1168, 1168, 1168, 1168, 1168, 1168, 1168, 1168, 1168, 1168, 1168, 1168, 1168, 1168, 1168, 1168, 1168, 1168, 1168, 1168, 1168, 1168, 1168, 1168, 1168, 1168, 1168, 1168, 1168, 1168, 1165, 1165, 1165, 1165, 1165, 1165, 1165, 1165, 1165, 1165, 1165, 1165, 1165, 1165, 1165, 1165, 1165, 1165, 1165, 1165, 1165, 1165, 1165, 1165, 1165, 1165, 1165, 1165, 1165, 1165, 1165, 1165, 1165, 1165, 1165, 1165, 1165, 1165
1168, 1168, 1168, 1168, 1168, 1168, 1168, 1168, 1168, 1168, 1168, 1168, 1168, 1168, 1168, 1168, 1168, 1168, 1168, 1168, 1168, 1168, 1168, 1168, 1168, 1168, 1168, 1168, 1168, 1168, 1168, 1168, 1168, 1168, 1168, 1168, 1168, 1168, 1168, 1168, 1168, 1168, 1165, 1165, 1165, 1165, 1165, 1165, 1165, 1165, 1165, 1165, 1165, 1165, 1165, 1165, 1165, 1165, 1165, 1165, 1165, 1165, 1165, 1165, 1165, 1165, 1165, 1165, 1165, 1165, 1165, 1165, 1165, 1165, 1165, 1165, 1165, 1165, 1165, 1165
1168, 1168, 1168, 1168, 1168, 1168, 1168, 1168, 1168, 1168, 1168, 1168, 1168, 1168, 1168, 1168, 1168, 1168, 1168, 1168, 1168, 1168, 1168, 1168, 1168, 1168, 1168, 1168, 1168, 1168, 1168, 1168, 1168, 1168, 1168, 1168, 1168, 1168, 1168, 1168, 1168, 1168, 1165, 1165, 1165, 1165, 1165, 1165, 1165, 1165, 1165, 1165, 1165, 1165, 1165, 1165, 1165, 1165, 1165, 1165, 1165, 1165, 1165, 1165, 1165, 1139, 1165, 1165, 1165, 1165, 1165, 1165, 1165, 1165, 1165, 1165, 1165, 1165, 1165, 1165
1168, 1168, 1168, 1168, 1168, 1168, 1168, 1168, 1168, 1168, 1168, 1168, 1168, 1168, 1168, 1168, 1168, 1168, 1168, 1168, 1168, 1168, 1168, 1168, 1168, 1168, 1168, 1168, 1168, 1168, 1168, 1168, 1168, 1168, 1168, 1168, 1168, 1168, 1168, 1168, 1168, 1168, 1165, 1165, 1165, 1165, 1165, 1165, 1165, 1165, 1165, 1165, 1165, 1165, 1165, 1165, 1165, 1165, 1165, 1165, 1165, 1165, 1165, 1165, 1165, 1139, 1165, 1165, 1165, 1165, 1165, 1165, 1165, 1165, 1165, 1165, 1165, 1165, 1165, 1165
1168, 1168, 1168, 1168, 1168, 1168, 1168, 1168, 1168, 1168, 1168, 1168, 1168, 1168, 1168, 1168, 1168, 1168, 1168, 1168, 1089, 1093, 1093, 1093, 1093, 1093, 1093, 1093, 1093, 1093, 1093, 1093, 1093, 1093, 1093, 1093, 1093, 1093, 1093, 1093, 1093, 1093, 1094, 1095, 1096, 1093, 1094, 1095, 1096, 1093, 1094, 1095, 1096, 1093, 1094, 1095, 1096, 1093, 1094, 1095, 1096, 1093, 1094, 1095, 1096, 1100, 1165, 1165, 1165, 1165, 1165, 1165, 1165, 1165, 1165, 1165, 1165, 1165, 1165, 1165
1168, 1168, 1168, 1168, 1168, 1168, 1168, 1168, 1168, 1168, 1168, 1168, 1168, 1168, 1168, 1168, 1168, 1168, 1168, 1168, 1103, 110, 110, 102, 115, 116, 117, 118, 119, 108, 109, 110, 111, 0, 0, 64, 65, 66, 67, 11, 12, 13, 147, 148, 149, 150, 117, 118, 140, 15, 147, 148, 149, 150, 1052, 1052, 147, 148, 149, 150, 147, 148, 149, 150, 245, 1138, 1165, 1165, 1165, 1165, 1165, 1165, 1165, 1165, 1165, 1165, 1165, 1165, 1165, 1165
1168, 1168, 1168, 1168, 1168, 1168, 1168, 1168, 1168, 1168, 1168, 1168, 1168, 1168, 1168, 1168, 1168, 1168, 1168, 1168, 1135, 142, 142, 134, 147, 148, 149, 150, 151, 140, 141, 1053, 1053, 0, 0, 96, 97, 98, 99, 1053, 1053, 50, 179, 180, 181, 182, 149, 1053, 1053, 244, 179, 180, 181, 182, 168, 169, 179, 180, 181, 182, 179, 180, 181, 182, 277, 1074, 1165, 1165, 1165, 1165, 1165, 1165, 1165, 1165, 1165, 1165, 1165, 1165, 1165, 1165
1168, 1168, 1168, 1168, 1168, 1168, 1168, 1168, 1168, 1168, 1168, 1168, 1168, 1168, 1168, 1168, 1168, 1168, 1168, 1168, 1071, 174, 174, 166, 179, 180, 181, 182, 183, 172, 173, 1053, 1053, 0, 134, 128, 129, 130, 131, 1053, 1053, 87, 211, 212, 213, 214, 181, 1053, 1053, 276, 211, 212, 213, 214, 200, 201, 211, 212, 213, 214, 211, 212, 213, 214, 121, 1106, 1165, 1165, 1165, 1165, 1165, 1165, 1165, 1165, 1165, 1165, 1165, 1165, 1165, 1165
1168, 1168, 1168, 1168, 1168, 1168, 1168, 1168, 1168, 1168, 1168, 1168, 1168, 1168, 1168, 1168, 1168, 1168, 1168, 1168, 1103, 206, 206, 198, 211, 212, 213, 214, 215, 204, 205, 206, 207, 144, 166, 160, 161, 162, 163, 139, 140, 141, 243, 244, 245, 246, 213, 214, 215, 143, 243, 244, 245, 246, 232, 233, 243, 244, 245, 246, 243, 244, 245, 246, 175, 1138, 1165, 1165, 1165, 1165, 1165, 1165, 1165, 1165, 1165, 1165, 1165, 1165, 1165, 1165
1168, 1168, 1168, 1168, 1168, 1168, 1168, 1168, 1168, 1168, 1168, 1168, 1168, 1168, 1168, 1168, 1168, 1168, 1168, 1168, 1135, 238, 238, 230, 243, 244, 245, 246, 247, 236, 237, 238, 239, 176, 198, 192, 193, 194, 195, 176, 168, 169, 170, 171, 172, 173, 174, 175, 176, 177, 181, 182, 183, 264, 264, 265, 266, 267, 268, 269, 270, 271, 272, 273, 212, 1074, 1165, 1165, 1165, 1165, 1165, 1165, 1165, 1165, 1165, 1165, 1165, 1165, 1165, 1165
1168, 1168, 1168, 1168, 1168, 1168, 1168, 1168, 1168, 1168, 1168, 1168, 1168, 1168, 1168, 1168, 1168, 1168, 1168, 1168, 1071, 270, 270, 262, 263, 264, 265, 266, 267, 268, 269, 270, 271, 208, 230, 224, 225, 226, 227, 213, 200, 201, 202, 203, 204, 205, 206, 207, 208, 209, 235, 236, 237, 296, 296, 297, 298, 299, 300, 301, 302, 303, 304, 305, 249, 1106, 1165, 1165, 1165, 1165, 1165, 1165, 1165, 1165, 1165, 1165, 1165, 1165, 1165, 1165
1168, 1168, 1168, 1168, 1168, 1168, 1168, 1168, 1168, 1168, 1168, 1168, 1168, 1168, 1168, 1168, 1168, 1168, 1168, 1168, 1103, 110, 110, 294, 295, 296, 297, 298, 299, 300, 301, 302, 303, 240, 262, 256, 257, 258, 259, 267, 232, 233, 234, 235, 236, 237, 238, 239, 240, 241, 272, 273, 274, 328, 328, 329, 330, 331, 332, 333, 334, 335, 336, 337, 303, 1138, 1165, 1165, 1165, 1165, 1165, 1165, 1165, 1165, 1165, 1165, 1165, 1165, 1165, 1165
1168, 1168, 1168, 1168, 1168, 1168, 1168, 1168, 1168, 1168, 1168, 1168, 1168, 1168, 1168, 1168, 1168, 1168, 1168, 1168, 1135, 142, 142, 326, 327, 328, 329, 330, 331, 332, 333, 334, 335, 272, 294, 288, 289, 290, 291, 304, 264, 265, 266, 267, 268, 269, 270, 271, 272, 273, 309, 310, 311, 360, 360, 361, 362, 363, 364, 365, 366, 367, 368, 369, 340, 1074, 1165, 1165, 1165, 1165, 1165, 1165, 1165, 1165, 1165, 1165, 1165, 1165, 1165, 1165
1168, 1168, 1168, 1168, 1168, 1168, 1168, 1168, 1168, 1168, 1168, 1168, 1168, 1168, 1168, 1168, 1168, 1168, 1168, 1168, 1071, 174, 174, 358, 359, 360, 361, 362, 363, 364, 365, 366, 367, 304, 326, 320, 321, 322, 323, 341, 296, 297, 298, 299, 300, 301, 302, 303, 304, 305, 363, 364, 365, 392, 392, 393, 394, 395, 396, 397, 398, 399, 400, 401, 1053, 1106, 1165, 1165, 1165, 1165, 1165, 1165, 1165, 1165, 1165, 1165, 1165, 1165, 1165, 1165
1168, 1168, 1168, 1168, 1168, 1168, 1168, 1168, 1168, 1168, 1168, 1168, 1168, 1168, 1168, 1168, 1168, 1168, 1168, 1168, 1103, 206, 206, 390, 391, 392, 393, 394, 395, 396, 397, 398, 399, 336, 358, 352, 353, 354, 355, 395, 328, 329, 330, 331, 332, 333, 334, 335, 336, 337, 400, 401, 402, 424, 424, 425, 426, 427, 428, 429, 430, 431, 432, 1053, 1053, 1074, 1165, 1165, 1165, 1165, 1165, 1165, 1165, 1165, 1165, 1165, 1165, 1165, 1165, 1165
1168, 1168, 1168, 1168, 1168, 1168, 1168, 1168, 1168, 1168, 1168, 1168, 1168, 1168, 1168, 1168, 1168, 1168, 1168, 1168, 1135, 238, 238, 422, 423, 424, 425, 426, 427, 428, 429, 430, 431, 368, 390, 384, 385, 386, 387, 432, 360, 361, 362, 363, 364, 365, 366, 367, 368, 369, 437, 438, 439, 456, 456, 457, 458, 459, 460, 461, 462, 463, 464, 1053, 1053, 1106, 1165, 1165, 1165, 1165, 1165, 1165, 1165, 1165, 1165, 1165, 1165, 1165, 1165, 1165
1168, 1168, 1168, 1168, 1168, 1168, 1168, 1168, 1168, 1168, 1168, 1168, 1168, 1168, 1168, 1168, 1168, 1168, 1168, 1168, 1071, 270, 270, 454, 455, 456, 457, 458, 459, 460, 461, 462, 463, 145, 422, 416, 417, 418, 419, 469, 392, 393, 394, 395, 396, 397, 398, 399, 400, 401, 11, 12, 13, 14, 15, 16, 17, 18, 19, 20, 21, 22, 23, 24, 25, 1138, 1165, 1165, 1165, 1165, 1165, 1165, 1165, 1165, 1165, 1165, 1165, 1165, 1165, 1165
1168, 1168, 1168, 1168, 1168, 1168, 1168, 1168, 1168, 1168, 1168, 1168, 1168, 1168, 1168, 1168, 1168, 1168, 1168, 1168, 1103, 1053, 1053, 486, 487, 488, 489, 490, 491, 492, 493, 494, 495, 177, 454, 448, 449, 450, 451, 43, 424, 425, 426, 427, 428, 429, 430, 431, 432, 433, 48, 49, 50, 51, 52, 53, 54, 55, 56, 57, 75, 76, 1053, 1053, 1053, 1074, 1165, 1165, 1165, 1165, 1165, 1165, 1165, 1165, 1165, 1165, 1165, 1165, 1165, 1165
1168, 1168, 1168, 1168, 1168, 1168, 1168, 1168, 1168, 1168, 1168, 1168, 1168, 1168, 1168, 1168, 1168, 1168, 1168, 1168, 1135, 1053, 1053, 38, 39, 40, 41, 203, 204, 205, 206, 207, 208, 209, 486, 480, 481, 482, 483, 80, 456, 457, 458, 459, 460, 461, 462, 463, 464, 465, 85, 86, 87, 88, 89, 107, 108, 109, 110, 111, 112, 113, 1053, 1053, 1053, 1106, 1165, 1165, 1165, 1165, 1165, 1165, 1165, 1165, 1165, 1165, 1165, 1165, 1165, 1165
1168, 1168, 1168, 1168, 1168, 1168, 1168, 1168, 1168, 1168, 1168, 1168, 1168, 1168, 1168, 1168, 1168, 1168, 1168, 1168, 1071, 174, 174, 117, 118, 119, 115, 116, 117, 118, 119, 116, 117, 118, 119, 115, 116, 117, 118, 119, 118, 119, 120, 121, 139, 117, 118, 119, 120, 121, 139, 140, 141, 142, 143, 144, 145, 146, 147, 148, 149, 150, 1053, 1053, 153, 1138, 1165, 1165, 1165, 1165, 1165, 1165, 1165, 1165, 1165, 1165, 1165, 1165, 1165, 1165
1168, 1168, 1168, 1168, 1168, 1168, 1168, 1168, 1168, 1168, 1168, 1168, 1168, 1168, 1168, 1168, 1168, 1168, 1168, 1168, 1103, 206, 206, 149, 150, 151, 147, 148, 149, 150, 151, 148, 149, 150, 151, 147, 148, 149, 150, 151, 172, 173, 174, 175, 176, 171, 172, 173, 174, 175, 176, 177, 178, 179, 180, 181, 182, 183, 184, 185, 203, 204, 1053, 1053, 331, 1074, 1165, 1165, 1165, 1165, 1165, 1165, 1165, 1165, 1165, 1165, 1165, 1165, 1165, 1165
1168, 1168, 1168, 1168, 1168, 1168, 1168, 1168, 1168, 1168, 1168, 1168, 1168, 1168, 1168, 1168, 1168, 1168, 1168, 1168, 1135, 238, 238, 181, 182, 183, 179, 180, 181, 182, 183, 180, 181, 182, 183, 179, 180, 181, 182, 183, 118, 119, 211, 212, 213, 208, 209, 210, 211, 212, 213, 214, 215, 216, 217, 235, 236, 237, 238, 239, 240, 241, 242, 331, 331, 1106, 1165, 1165, 1165, 1165, 1165, 1165, 1165, 1165, 1165, 1165, 1165, 1165, 1165, 1165
1168, 1168, 1168, 1168, 1168, 1168, 1168, 1168, 1168, 1168, 1168, 1168, 1168, 1168, 1168, 1168, 1168, 1168, 1168, 1168, 1071, 270, 270, 213, 214, 215, 211, 212, 213, 214, 215, 212, 213, 214, 215, 211, 212, 213, 214, 215, 150, 151, 248, 249, 267, 245, 168, 169, 170, 171, 172, 173, 174, 175, 176, 177, 174, 175, 176, 177, 119, 278, 279, 232, 233, 1138, 1165, 1165, 1165, 1165, 1165, 1165, 1165, 1165, 1165, 1165, 1165, 1165, 1165, 1165
1168, 1168, 1168, 1168, 1168, 1168, 1168, 1168, 1168, 1168, 1168, 1168, 1168, 1168, 1168, 1168, 1168, 1168, 1168, 1168, 1103, 110, 110, 245, 246, 247, 243, 168, 169, 170, 171, 172, 173, 168, 169, 170, 171, 172, 173, 174, 175, 176, 177, 303, 304, 299, 200, 201, 202, 203, 204, 205, 206, 207, 208, 209, 206, 207, 208, 209, 115, 116, 117, 118, 119, 1074, 1165, 1165, 1165, 1165, 1165, 1165, 1165, 1165, 1165, 1165, 1165, 1165, 1165, 1165
1168, 1168, 1168, 1168, 1168, 1168, 1168, 1168, 1168, 1168, 1168, 1168, 1168, 1168, 1168, 1168, 1168, 1168, 1168, 1168, 1135, 142, 142, 354, 355, 356, 357, 200, 201, 202, 203, 204, 205, 200, 201, 202, 203, 204, 205, 206, 207, 208, 209, 340, 341, 336, 232, 233, 234, 235, 236, 237, 238, 239, 240, 241, 238, 239, 240, 241, 147, 148, 149, 331, 331, 1106, 1165, 1165, 1165, 1165, 1165, 1165, 1165, 1165, 1165, 1165, 1165, 1165, 1165, 1165
1168, 1168, 1168, 1168, 1168, 1168, 1168, 1168, 1168, 1168, 1168, 1168, 1168, 1168, 1168, 1168, 1168, 1168, 1168, 1168, 1071, 110, 174, 396, 397, 398, 399, 232, 233, 234, 235, 236, 237, 232, 233, 234, 235, 236, 237, 238, 239, 240, 241, 15, 16, 176, 264, 265, 266, 267, 268, 269, 270, 271, 272, 273, 270, 271, 272, 273, 179, 180, 181, 331, 331, 1138, 1165, 1165, 1165, 1165, 1165, 1165, 1165, 1165, 1165, 1165, 1165, 1165, 1165, 1165
1168, 1168, 1168, 1168, 1168, 1168, 1168, 1168, 1168, 1168, 1168, 1168, 1168, 1168, 1168, 1168, 1168, 1168, 1168, 1168, 1103, 142, 206, 454, 455, 456, 457, 264, 265, 266, 267, 268, 269, 264, 265, 266, 267, 268, 269, 270, 271, 272, 273, 52, 53, 213, 296, 297, 298, 299, 300, 301, 302, 303, 304, 305, 302, 303, 304, 305, 211, 212, 213, 331, 331, 1074, 1165, 1165, 1165, 1165, 1165, 1165, 1165, 1165, 1165, 1165, 1165, 1165, 1165, 1165
1168, 1168, 1168, 1168, 1168, 1168, 1168, 1168, 1168, 1168, 1168, 1168, 1168, 1168, 1168, 1168, 1168, 1168, 1168, 1168, 1135, 174, 238, 0, 1, 2, 3, 296, 297, 298, 299, 300, 301, 296, 297, 298, 299, 300, 301, 302, 303, 304, 305, 89, 107, 267, 328, 329, 330, 331, 332, 333, 334, 335, 336, 337, 334, 335, 336, 337, 243, 244, 245, 331, 331, 1106, 1165, 1165, 1165, 1165, 1165, 1165, 1165, 1165, 1165, 1165, 1165, 1165, 1165, 1165
1168, 1168, 1168, 1168, 1168, 1168, 1168, 1168, 1168, 1168, 1168, 1168, 1168, 1168, 1168, 1168, 1168, 1168, 1168, 1168, 1071, 206, 270, 42, 43, 44, 45, 328, 329, 330, 331, 332, 333, 328, 329, 330, 331, 332, 333, 334, 335, 336, 337, 143, 144, 304, 360, 361, 362, 363, 364, 365, 366, 367, 368, 369, 366, 367, 368, 369, 115, 116, 117, 118, 119, 1138, 1165, 1165, 1165, 1165, 1165, 1165, 1165, 1165, 1165, 1165, 1165, 1165, 1165, 1165
1168, 1168, 1168, 1168, 1168, 1168, 1168, 1168, 1168, 1168, 1168, 1168, 1168, 1168, 1168, 1168, 1168, 1168, 1168, 1168, 1103, 238, 110, 100, 101, 102, 103, 360, 361, 362, 363, 364, 365, 360, 361, 362, 363, 364, 365, 366, 367, 368, 369, 180, 181, 341, 392, 393, 394, 395, 396, 397, 398, 399, 400, 401, 398, 399, 400, 401, 147, 148, 149, 150, 151, 1074, 1165, 1165, 1165, 1165, 1165, 1165, 1165, 1165, 1165, 1165, 1165, 1165, 1165, 1165
1168, 1168, 1168, 1168, 1168, 1168, 1168, 1168, 1168, 1168, 1168, 1168, 1168, 1168, 1168, 1168, 1168, 1168, 1168, 1168, 1135, 270, 141, 142, 143, 160, 161, 392, 393, 394, 395, 396, 397, 392, 393, 394, 395, 396, 397, 398, 399, 400, 401, 217, 235, 395, 424, 168, 169, 170, 171, 172, 173, 174, 175, 176, 177, 431, 432, 433, 179, 180, 181, 331, 331, 1106, 1165, 1165, 1165, 1165, 1165, 1165, 1165, 1165, 1165, 1165, 1165, 1165, 1165, 1165
1168, 1168, 1168, 1168, 1168, 1168, 1168, 1168, 1168, 1168, 1168, 1168, 1168, 1168, 1168, 1168, 1168, 1168, 1168, 1168, 1071, 110, 199, 200, 201, 202, 203, 424, 425, 426, 427, 428, 429, 424, 425, 426, 427, 428, 429, 430, 431, 432, 433, 271, 168, 169, 170, 200, 201, 202, 203, 204, 205, 206, 207, 208, 209, 463, 464, 465, 211, 212, 213, 331, 331, 1138, 1165, 1165, 1165, 1165, 1165, 1165, 1165, 1165, 1165, 1165, 1165, 1165, 1165, 1165
1168, 1168, 1168, 1168, 1168, 1168, 1168, 1168, 1168, 1168, 1168, 1168, 1168, 1168, 1168, 1168, 1168, 1168, 1168, 1168, 1103, 142, 257, 258, 259, 260, 261, 456, 457, 458, 459, 460, 461, 456, 457, 458, 459, 460, 461, 462, 463, 464, 465, 308, 200, 201, 202, 232, 233, 234, 235, 236, 237, 238, 239, 240, 241, 18, 19, 20, 243, 244, 245, 331, 331, 1074, 1165, 1165, 1165, 1165, 1165, 1165, 1165, 1165, 1165, 1165, 1165, 1165, 1165, 1165
1168, 1168, 1168, 1168, 1168, 1168, 1168, 1168, 1168, 1168, 1168, 1168, 1168, 1168, 1168, 1168, 1168, 1168, 1168, 1168, 1135, 174, 299, 300, 301, 302, 956, 957, 360, 204, 205, 206, 207, 224, 225, 226, 227, 228, 229, 341, 342, 343, 344, 345, 232, 233, 234, 264, 265, 266, 267, 268, 269, 270, 271, 272, 273, 55, 56, 57, 75, 76, 77, 331, 331, 1106, 1165, 1165, 1165, 1165, 1165, 1165, 1165, 1165, 1165, 1165, 1165, 1165, 1165, 1165
1168, 1168, 1168, 1168, 1168, 1168, 1168, 1168, 1168, 1168, 1168, 1168, 1168, 1168, 1168, 1168, 1168, 1168, 1168, 1168, 1071, 206, 357, 358, 359, 360, 988, 989, 142, 262, 263, 264, 265, 266, 267, 268, 269, 270, 271, 395, 396, 397, 398, 399, 264, 265, 266, 296, 297, 298, 299, 300, 301, 302, 303, 304, 305, 109, 110, 111, 112, 113, 114, 115, 116, 1138, 1165, 1165, 1165, 1165, 1165, 1165, 1165, 1165, 1165, 1165, 1165, 1165, 1165, 1165
1168, 1168, 1168, 1168, 1168, 1168, 1168, 1168, 1168, 1168, 1168, 1168, 1168, 1168, 1168, 1168, 1168, 1168, 1168, 1168, 1103, 238, 399, 416, 417, 418, 419, 177, 174, 320, 321, 322, 323, 324, 325, 326, 327, 328, 329, 432, 433, 434, 435, 436, 296, 297, 298, 328, 329, 330, 331, 332, 333, 334, 335, 336, 337, 146, 147, 148, 149, 150, 151, 152, 153, 1074, 1165, 1165, 1165, 1165, 1165, 1165, 1165, 1165, 1165, 1165, 1165, 1165, 1165, 1165
1168, 1168, 1168, 1168, 1168, 1168, 1168, 1168, 1168, 1168, 1168, 1168, 1168, 1168, 1168, 1168, 1168, 1168, 1168, 1168, 1135, 270, 457, 458, 459, 168, 169, 170, 171, 172, 173, 174, 175, 176, 177, 173, 174, 175, 176, 177, 470, 471, 472, 473, 328, 329, 330, 360, 361, 362, 363, 364, 365, 366, 367, 368, 369, 183, 184, 185, 203, 204, 205, 331, 331, 1106, 1165, 1165, 1165, 1165, 1165, 1165, 1165, 1165, 1165, 1165, 1165, 1165, 1165, 1165
1168, 1168, 1168, 1168, 1168, 1168, 1168, 1168, 1168, 1168, 1168, 1168, 1168, 1168, 1168, 1168, 1168, 1168, 1168, 1168, 1071, 110, 3, 4, 5, 200, 201, 202, 203, 204, 205, 206, 207, 208, 209, 205, 206, 207, 208, 209, 44, 45, 46, 47, 360, 361, 362, 392, 393, 394, 395, 396, 397, 398, 399, 400, 401, 237, 238, 239, 240, 241, 242, 331, 331, 1138, 1165, 1165, 1165, 1165, 1165, 1165, 1165, 1165, 1165, 1165, 1165, 1165, 1165, 1165
1168, 1168, 1168, 1168, 1168, 1168, 1168, 1168, 1168, 1168, 1168, 1168, 1168, 1168, 1168, 1168, 1168, 1168, 1168, 1168, 1103, 142, 45, 46, 47, 232, 233, 234, 235, 236, 237, 238, 239, 240, 241, 237, 238, 239, 240, 241, 12, 13, 14, 15, 392, 393, 394, 424, 425, 426, 427, 428, 429, 430, 431, 432, 433, 274, 275, 276, 277, 278, 279, 331, 331, 1074, 1165, 1165, 1165, 1165, 1165, 1165, 1165, 1165, 1165, 1165, 1165, 1165, 1165, 1165
1168, 1168, 1168, 1168, 1168, 1168, 1168, 1168, 1168, 1168, 1168, 1168, 1168, 1168, 1168, 1168, 1168, 1168, 1168, 1168, 1135, 174, 103, 104, 105, 264, 265, 266, 267, 268, 269, 270, 271, 272, 273, 269, 270, 271, 272, 273, 49, 50, 51, 52, 424, 425, 426, 456, 457, 458, 459, 460, 461, 462, 463, 464, 465, 311, 312, 313, 331, 332, 333, 331, 331, 1106, 1165, 1165, 1165, 1165, 1165, 1165, 1165, 1165, 1165, 1165, 1165, 1165, 1165, 1165
1168, 1168, 1168, 1168, 1168, 1168, 1168, 1168, 1168, 1168, 1168, 1168, 1168, 1168, 1168, 1168, 1168, 1168, 1168, 1168, 1071, 206, 161, 162, 163, 296, 297, 298, 299, 300, 301, 302, 303, 304, 305, 301, 302, 303, 304, 305, 86, 87, 88, 89, 456, 457, 458, 459, 460, 461, 462, 463, 464, 465, 345, 363, 364, 365, 366, 367, 368, 369, 370, 371, 372, 1138, 1165, 1165, 1165, 1165, 1165, 1165, 1165, 1165, 1165, 1165, 1165, 1165, 1165, 1165
1168, 1168, 1168, 1168, 1168, 1168, 1168, 1168, 1168, 1168, 1168, 1168, 1168, 1168, 1168, 1168, 1168, 1168, 1168, 1168, 1103, 238, 203, 204, 205, 328, 329, 330, 331, 332, 333, 334, 335, 336, 337, 333, 334, 335, 336, 337, 140, 141, 142, 143, 144, 139, 140, 141, 142, 143, 144, 145, 146, 147, 148, 149, 150, 151, 152, 153, 171, 172, 173, 174, 175, 1074, 1165, 1165, 1165, 1165, 1165, 1165, 1165, 1165, 1165, 1165, 1165, 1165, 1165, 1165
1168, 1168, 1168, 1168, 1168, 1168, 1168, 1168, 1168, 1168, 1168, 1168, 1168, 1168, 1168, 1168, 1168, 1168, 1168, 1168, 1135, 270, 261, 262, 263, 360, 361, 362, 363, 364, 365, 366, 367, 368, 369, 365, 366, 367, 368, 369, 177, 178, 179, 180, 181, 176, 177, 178, 179, 180, 181, 182, 183, 184, 185, 203, 204, 205, 206, 207, 208, 209, 210, 211, 212, 1106, 1165, 1165, 1165, 1165, 1165, 1165, 1165, 1165, 1165, 1165, 1165, 1165, 1165, 1165
1168, 1168, 1168, 1168, 1168, 1168, 1168, 1168, 1168, 1168, 1168, 1168, 1168, 1168, 1168, 1168, 1168, 1168, 1168, 1168, 1071, 110, 303, 320, 0, 392, 393, 394, 395, 396, 397, 398, 399, 400, 401, 397, 398, 399, 400, 401, 214, 215, 216, 217, 235, 213, 214, 215, 216, 217, 235, 236, 237, 238, 239, 240, 241, 242, 243, 244, 245, 246, 247, 248, 249, 1138, 1165, 1165, 1165, 1165, 1165, 1165, 1165, 1165, 1165, 1165, 1165, 1165, 1165, 1165
1168, 1168, 1168, 1168, 1168, 1168, 1168, 1168, 1168, 1168, 1168, 1168, 1168, 1168, 1168, 1168, 1168, 1168, 1168, 1168, 1071, 142, 116, 117, 118, 424, 425, 426, 427, 428, 429, 430, 431, 432, 433, 429, 430, 431, 432, 433, 268, 269, 270, 271, 272, 267, 268, 269, 270, 271, 272, 273, 274, 275, 276, 277, 278, 279, 280, 281, 299, 300, 301, 302, 303, 1074, 1165, 1165, 1165, 1165, 1165, 1165, 1165, 1165, 1165, 1165, 1165, 1165, 1165, 1165
1168, 1168, 1168, 1168, 1168, 1168, 1168, 1168, 1168, 1168, 1168, 1168, 1168, 1168, 1168, 1168, 1168, 1168, 1168, 1168, 1103, 174, 148, 149, 150, 456, 457, 458, 459, 460, 461, 462, 463, 464, 465, 461, 462, 463, 464, 465, 119, 306, 307, 308, 309, 304, 305, 306, 307, 308, 309, 310, 311, 312, 313, 331, 332, 333, 334, 335, 336, 337, 338, 339, 340, 1106, 1165, 1165, 1165, 1165, 1165, 1165, 1165, 1165, 1165, 1165, 1165, 1165, 1165, 1165
1168, 1168, 1168, 1168, 1168, 1168, 1168, 1168, 1168, 1168, 1168, 1168, 1168, 1168, 1168, 1168, 1168, 1168, 1168, 1168, 1135, 206, 180, 181, 182, 183, 180, 181, 182, 183, 179, 180, 181, 182, 183, 181, 182, 183, 149, 150, 151, 343, 344, 147, 148, 149, 150, 343, 344, 345, 363, 364, 365, 366, 367, 368, 369, 370, 371, 372, 373, 374, 375, 376, 377, 1138, 1165, 1165, 1165, 1165, 1165, 1165, 1165, 1165, 1165, 1165, 1165, 1165, 1165, 1165
1168, 1168, 1168, 1168, 1168, 1168, 1168, 1168, 1168, 1168, 1168, 1168, 1168, 1168, 1168, 1168, 1168, 1168, 1168, 1168, 1071, 238, 212, 213, 214, 215, 212, 213, 214, 215, 211, 212, 213, 214, 215, 213, 214, 215, 181, 182, 183, 397, 398, 179, 180, 181, 182, 397, 398, 399, 400, 401, 402, 403, 404, 405, 406, 407, 408, 409, 427, 428, 429, 430, 431, 1074, 1165, 1165, 1165, 1165, 1165, 1165, 1165, 1165, 1165, 1165, 1165, 1165, 1165, 1165
1168, 1168, 1168, 1168, 1168, 1168, 1168, 1168, 1168, 1168, 1168, 1168, 1168, 1168, 1168, 1168, 1168, 1168, 1168, 1168, 1103, 270, 244, 245, 246, 247, 244, 245, 246, 247, 243, 244, 245, 246, 247, 245, 246, 247, 213, 214, 215, 434, 435, 211, 212, 213, 214, 434, 435, 436, 437, 438, 439, 440, 441, 459, 460, 461, 462, 463, 464, 465, 466, 467, 468, 1106, 1165, 1165, 1165, 1165, 1165, 1165, 1165, 1165, 1165, 1165, 1165, 1165, 1165, 1165
1168, 1168, 1168, 1168, 1168, 1168, 1168, 1168, 1168, 1168, 1168, 1168, 1168, 1168, 1168, 1168, 1168, 1168, 1168, 1168, 1135, 110, 296, 297, 300, 301, 302, 303, 320, 321, 322, 323, 324, 325, 326, 327, 243, 244, 245, 246, 247, 471, 472, 243, 244, 245, 246, 471, 472, 473, 11, 12, 13, 14, 15, 16, 17, 18, 19, 20, 21, 22, 23, 24, 25, 1138, 1165, 1165, 1165, 1165, 1165, 1165, 1165, 1165, 1165, 1165, 1165, 1165, 1165, 1165
1168, 1168, 1168, 1168, 1168, 1168, 1168, 1168, 1168, 1168, 1168, 1168, 1168, 1168, 1168, 1168, 1168, 1168, 1168, 1168, 1071, 266, 1053, 1053, 1053, 1053, 360, 361, 362, 363, 364, 365, 366, 367, 384, 385, 386, 387, 388, 43, 44, 45, 46, 147, 148, 149, 150, 45, 46, 47, 48, 49, 50, 51, 52, 53, 54, 55, 56, 57, 75, 76, 77, 78, 79, 1074, 1165, 1165, 1165, 1165, 1165, 1165, 1165, 1165, 1165, 1165, 1165, 1165, 1165, 1165
1168, 1168, 1168, 1168, 1168, 1168, 1168, 1168, 1168, 1168, 1168, 1168, 1168, 1168, 1168, 1168, 1168, 1168, 1168, 1168, 1103, 266, 1053, 1053, 1053, 1053, 956, 957, 420, 956, 957, 956, 957, 956, 957, 427, 428, 429, 430, 80, 81, 82, 83, 179, 180, 181, 182, 82, 83, 84, 85, 86, 87, 88, 89, 107, 108, 109, 110, 111, 112, 113, 114, 115, 116, 1106, 1165, 1165, 1165, 1165, 1165, 1165, 1165, 1165, 1165, 1165, 1165, 1165, 1165, 1165
1168, 1168, 1168, 1168, 1168, 1168, 1168, 1168, 1168, 1168, 1168, 1168, 1168, 1168, 1168, 1168, 1168, 1168, 1168, 1168, 1135, 266, 1053, 1053, 1053, 1053, 988, 989, 462, 988, 989, 988, 989, 988, 989, 485, 486, 487, 488, 117, 118, 119, 120, 211, 212, 213, 214, 116, 117, 118, 119, 140, 141, 142, 143, 144, 145, 146, 147, 148, 149, 150, 151, 152, 153, 1138, 1165, 1165, 1165, 1165, 1165, 1165, 1165, 1165, 1165, 1165, 1165, 1165, 1165, 1165
1168, 1168, 1168, 1168, 1168, 1168, 1168, 1168, 1168, 1168, 1168, 1168, 1168, 1168, 1168, 1168, 1168, 1168, 1168, 1168, 1071, 266, 1053, 1053, 4, 5, 6, 7, 8, 9, 10, 11, 12, 13, 14, 15, 32, 33, 34, 171, 172, 173, 174, 243, 244, 245, 246, 116, 117, 118, 119, 177, 178, 179, 180, 181, 182, 183, 184, 185, 203, 204, 205, 206, 207, 1074, 1165, 1165, 1165, 1165, 1165, 1165, 1165, 1165, 1165, 1165, 1165, 1165, 1165, 1165
1168, 1168, 1168, 1168, 1168, 1168, 1168, 1168, 1168, 1168, 1168, 1168, 1168, 1168, 1168, 1168, 1168, 1168, 1168, 1168, 1057, 1061, 1061, 1061, 1061, 1061, 1061, 1061, 1061, 1061, 1061, 1061, 1061, 1061, 1061, 1061, 1061, 1061, 1061, 1061, 1061, 1061, 1061, 1061, 1061, 1061, 1061, 1061, 1061, 1061, 1061, 1061, 1061, 1061, 1061, 1061, 1061, 1061, 1061, 1061, 1061, 1061, 1061, 1061, 1061, 1068, 1165, 1165, 1165, 1165, 1165, 1165, 1165, 1165, 1165, 1165, 1165, 1165, 1165, 1165
