7759, 7759, 7759, 7759, 7759, 7759, 7759, 7759, 7759, 7759, 7759, 7759, 7759, 7759, 7759, 7759, 7759, 7759, 7759, 7759, 7759, 7759, 7759, 7759, 7759, 7759, 7759, 7759, 7759, 7759, 7759, 7759, 7759, 7759, 7759, 7759, 7759, 7759, 7759, 7759, 7759, 7759, 7759, 7759, 7759, 7759, 7759, 7759, 7759, 7759, 7759, 7759, 7759, 7759, 7759, 7759, 7759, 7759, 7759, 7759, 7759, 7759, 7759, 7759, 7759, 7759, 7759, 7759, 7759, 7759, 7759, 7759, 7759, 7759, 7759, 7759, 7759, 7759, 7759, 7759
7759, 7759, 7759, 7759, 7759, 7759, 7759, 7759, 7759, 7759, 7759, 7759, 7759, 7759, 7759, 7759, 7759, 7759, 7759, 7759, 7759, 7759, 7759, 7759, 7759, 7759, 7759, 7759, 7759, 7759, 7759, 7759, 7759, 7759, 7759, 7759, 7759, 7759, 7759, 7759, 7759, 7759, 7759, 7759, 7759, 7759, 7759, 7759, 7759, 7759, 7759, 7759, 7759, 7759, 7759, 7759, 7759, 7759, 7759, 7759, 7759, 7759, 7759, 7759, 7759, 7759, 7759, 7759, 7759, 7759, 7759, 7759, 7759, 7759, 7759, 7759, 7759, 7759, 7759, 7759
7759, 7759, 7759, 7759, 7759, 7759, 7759, 7759, 7759, 7759, 7759, 7759, 7759, 7759, 7759, 7759, 7759, 7759, 7759, 7759, 7759, 7759, 7759, 7759, 7759, 7759, 7759, 7759, 7759, 7759, 7759, 7759, 7759, 7759, 7759, 7759, 7759, 7759, 7759, 7759, 7759, 7759, 7759, 7759, 7759, 7759, 7759, 7759, 7759, 7759, 7759, 7759, 7759, 7759, 7759, 7759, 7759, 7759, 7759, 7759, 7759, 7759, 7759, 7759, 7759, 7759, 7759, 7759, 7759, 7759, 7759, 7759, 7759, 7759, 7759, 7759, 7759, 7759, 7759, 7759
7759, 7759, 7759, 7759, 7759, 7759, 7759, 7759, 7759, 7759, 7759, 7759, 7759, 7759, 7759, 7759, 7759, 7759, 7759, 7759, 7759, 7759, 7759, 7759, 7759, 7759, 7759, 7759, 7759, 7759, 7759, 7759, 7759, 7759, 7759, 7759, 7759, 7759, 7759, 7759, 7759, 7759, 7759, 7759, 7759, 7759, 7759, 7759, 7759, 7759, 7759, 7759, 7759, 7759, 7759, 7759, 7759, 7759, 7759, 7759, 7759, 7759, 7759, 7759, 7759, 7759, 7759, 7759, 7759, 7759, 7759, 7759, 7759, 7759, 7759, 7759, 7759, 7759, 7759, 7759
7759, 7759, 7759, 7759, 7759, 7759, 7759, 7759, 7759, 7759, 7759, 7759, 7759, 7759, 7759, 7759, 7759, 7759, 7759, 7759, 7759, 7759, 7759, 7759, 7759, 7759, 7759, 7759, 7759, 7759, 7759, 7759, 7759, 7759, 7759, 7759, 7759, 7759, 7759, 7759, 7759, 7759, 7759, 7759, 7759, 7759, 7759, 7759, 7759, 7759, 7759, 7759, 7759, 7759, 7759, 7759, 7759, 7759, 7759, 7759, 7759, 7759, 7759, 7759, 7759, 7759, 7759, 7759, 7759, 7759, 7759, 7759, 7759, 7759, 7759, 7759, 7759, 7759, 7759, 7759
7759, 7759, 7759, 7759, 7759, 7759, 7759, 7759, 7759, 7759, 7759, 7759, 7759, 7759, 7759, 7759, 7759, 7759, 7759, 7759, 7759, 7759, 7759, 7759, 7759, 7759, 7759, 7759, 7759, 7759, 7759, 7759, 7759, 7759, 7759, 7759, 7759, 7759, 7759, 7759, 7759, 7759, 7759, 7759, 7759, 7759, 7759, 7759, 7759, 7759, 7759, 7759, 7759, 7759, 7759, 7759, 7759, 7759, 7759, 7759, 7759, 7759, 7759, 7759, 7759, 7759, 7759, 7759, 7759, 7759, 7759, 7759, 7759, 7759, 7759, 7759, 7759, 7759, 7759, 7759
7759, 7759, 7759, 7759, 7759, 7759, 7759, 7759, 7759, 7759, 7759, 7759, 7759, 7759, 7759, 7759, 7759, 7759, 7759, 7759, 7759, 7759, 7759, 7759, 7759, 7759, 7759, 7759, 7759, 7759, 7759, 7759, 7759, 7759, 7759, 7759, 7759, 7759, 7759, 7759, 7759, 7759, 7759, 7759, 7759, 7759, 7759, 7759, 7759, 7759, 7759, 7759, 7759, 7759, 7759, 7759, 7759, 7759, 7759, 7759, 7759, 7759, 7759, 7759, 7759, 7759, 7759, 7759, 7759, 7759, 7759, 7759, 7759, 7759, 7759, 7759, 7759, 7759, 7759, 7759
7759, 7759, 7759, 7759, 7759, 7759, 7759, 7759, 7759, 7759, 7759, 7759, 7759, 7759, 7759, 7759, 7759, 7759, 7759, 7759, 7759, 7759, 7759, 7759, 7759, 7759, 7759, 7759, 7759, 7759, 7759, 7759, 7759, 7759, 7759, 7759, 7759, 7759, 7759, 7759, 7759, 7759, 7759, 7759, 7759, 7759, 7759, 7759, 7759, 7759, 7759, 7759, 7759, 7759, 7759, 7759, 7759, 7759, 7759, 7759, 7759, 7759, 7759, 7759, 7759, 7759, 7759, 7759, 7759, 7759, 7759, 7759, 7759, 7759, 7759, 7759, 7759, 7759, 7759, 7759
7759, 7759, 7759, 7759, 7759, 7759, 7759, 7759, 7759, 7759, 7759, 7759, 7759, 7759, 7759, 7759, 7759, 7759, 7759, 5764, 5765, 5366, 5367, 5368, 5369, 5370, 5371, 5372, 5373, 5374, 5375, 5376, 5377, 5378, 5379, 5380, 5381, 5364, 5365, 5366, 5367, 5368, 5369, 5370, 5371, 5372, 5373, 5374, 5375, 5376, 5377, 5378, 5379, 5380, 5381, 5382, 5383, 5384, 5385, 5686, 5687, 7759, 7759, 7759, 7759, 7759, 7759, 7759, 7759, 7759, 7759, 7759, 7759, 7759, 7759, 7759, 7759, 7759, 7759, 7759
7759, 7759, 7759, 7759, 7759, 7759, 7759, 7759, 7759, 7759, 7759, 7759, 7759, 7759, 7759, 7759, 7759, 7759, 7759, 5764, 5765, 5446, 5447, 5448, 5449, 5450, 5451, 5452, 5453, 5454, 5455, 5456, 5457, 5458, 5459, 5460, 5461, 5444, 5445, 5446, 5447, 5448, 5449, 5450, 5451, 5452, 5453, 5454, 5455, 5456, 5457, 5458, 5459, 5460, 5461, 5462, 5463, 5464, 5465, 5766, 5767, 7759, 7759, 7759, 7759, 7759, 7759, 7759, 7759, 7759, 7759, 7759, 7759, 7759, 7759, 7759, 7759, 7759, 7759, 7759
7759, 7759, 7759, 7759, 7759, 7759, 7759, 7759, 7759, 7759, 7759, 7759, 7759, 7759, 7759, 7759, 7759, 7759, 7759, 5844, 5845, 244, 245, 246, 247, 248, 249, 250, 251, 252, 253, 254, 255, 256, 257, 258, 259, 5040, 5040, 262, 263, 264, 265, 266, 267, 268, 269, 270, 271, 272, 273, 274, 275, 276, 277, 278, 279, 280, 281, 5442, 5443, 7759, 7759, 7759, 7759, 7759, 7759, 7759, 7759, 7759, 7759, 7759, 7759, 7759, 7759, 7759, 7759, 7759, 7759, 7759
7759, 7759, 7759, 7759, 7759, 7759, 7759, 7759, 7759, 7759, 7759, 7759, 7759, 7759, 7759, 7759, 7759, 7759, 7759, 5520, 5521, 324, 325, 326, 327, 328, 329, 330, 331, 332, 333, 334, 335, 336, 337, 338, 339, 340, 341, 342, 343, 344, 345, 346, 347, 348, 349, 350, 351, 352, 353, 354, 355, 356, 357, 358, 359, 360, 361, 5522, 5523, 7759, 7759, 7759, 7759, 7759, 7759, 7759, 7759, 7759, 7759, 7759, 7759, 7759, 7759, 7759, 7759, 7759, 7759, 7759
7759, 7759, 7759, 7759, 7759, 7759, 7759, 7759, 7759, 7759, 7759, 7759, 7759, 7759, 7759, 7759, 7759, 7759, 7759, 5600, 5601, 404, 405, 406, 407, 408, 409, 410, 411, 412, 413, 414, 415, 416, 417, 418, 419, 420, 421, 422, 423, 424, 425, 426, 427, 428, 429, 430, 431, 432, 433, 434, 435, 436, 437, 438, 439, 440, 441, 5602, 5603, 7759, 7759, 7759, 7759, 7759, 7759, 7759, 7759, 7759, 7759, 7759, 7759, 7759, 7759, 7759, 7759, 7759, 7759, 7759
7759, 7759, 7759, 7759, 7759, 7759, 7759, 7759, 7759, 7759, 7759, 7759, 7759, 7759, 7759, 7759, 7759, 7759, 7759, 5680, 5681, 484, 485, 486, 487, 488, 489, 490, 491, 492, 493, 494, 495, 496, 497, 498, 499, 500, 501, 502, 503, 504, 505, 506, 507, 508, 509, 510, 511, 512, 513, 514, 515, 516, 517, 518, 519, 520, 521, 5682, 5683, 7759, 7759, 7759, 7759, 7759, 7759, 7759, 7759, 7759, 7759, 7759, 7759, 7759, 7759, 7759, 7759, 7759, 7759, 7759
7759, 7759, 7759, 7759, 7759, 7759, 7759, 7759, 7759, 7759, 7759, 7759, 7759, 7759, 7759, 7759, 7759, 7759, 7759, 5760, 5761, 564, 565, 566, 567, 568, 569, 570, 571, 572, 573, 574, 575, 576, 577, 578, 579, 580, 581, 582, 583, 584, 585, 586, 587, 588, 589, 590, 591, 592, 593, 594, 595, 596, 597, 598, 599, 600, 601, 5762, 5763, 7759, 7759, 7759, 7759, 7759, 7759, 7759, 7759, 7759, 7759, 7759, 7759, 7759, 7759, 7759, 7759, 7759, 7759, 7759
7759, 7759, 7759, 7759, 7759, 7759, 7759, 7759, 7759, 7759, 7759, 7759, 7759, 7759, 7759, 7759, 7759, 7759, 7759, 5840, 5841, 644, 645, 646, 647, 648, 649, 650, 651, 652, 653, 654, 655, 656, 657, 658, 659, 660, 661, 662, 663, 664, 665, 666, 667, 668, 669, 670, 671, 672, 673, 674, 675, 676, 677, 678, 679, 680, 681, 5842, 5843, 7759, 7759, 7759, 7759, 7759, 7759, 7759, 7759, 7759, 7759, 7759, 7759, 7759, 7759, 7759, 7759, 7759, 7759, 7759
7759, 7759, 7759, 7759, 7759, 7759, 7759, 7759, 7759, 7759, 7759, 7759, 7759, 7759, 7759, 7759, 7759, 7759, 7759, 5920, 5921, 724, 725, 726, 727, 728, 729, 730, 731, 732, 733, 734, 735, 736, 737, 738, 739, 740, 741, 742, 743, 744, 745, 746, 747, 748, 749, 750, 751, 752, 753, 754, 755, 756, 757, 7773, 7773, 7773, 7773, 5922, 5923, 7759, 7759, 7759, 7759, 7759, 7759, 7759, 7759, 7759, 7759, 7759, 7759, 7759, 7759, 7759, 7759, 7759, 7759, 7759
7759, 7759, 7759, 7759, 7759, 7759, 7759, 7759, 7759, 7759, 7759, 7759, 7759, 7759, 7759, 7759, 7759, 7759, 7759, 6000, 6001, 804, 805, 806, 807, 808, 809, 810, 811, 812, 813, 814, 815, 816, 817, 818, 819, 820, 821, 822, 823, 824, 825, 826, 827, 828, 829, 830, 831, 832, 833, 834, 835, 836, 837, 7773, 7773, 7773, 7773, 6002, 6003, 7759, 7759, 7759, 7759, 7759, 7759, 7759, 7759, 7759, 7759, 7759, 7759, 7759, 7759, 7759, 7759, 7759, 7759, 7759
7759, 7759, 7759, 7759, 7759, 7759, 7759, 7759, 7759, 7759, 7759, 7759, 7759, 7759, 7759, 7759, 7759, 7759, 7759, 6080, 6081, 884, 885, 886, 887, 888, 889, 890, 891, 892, 893, 894, 895, 896, 897, 898, 899, 900, 901, 902, 903, 904, 905, 906, 907, 908, 909, 910, 911, 912, 913, 914, 915, 916, 917, 7773, 7773, 7773, 7773, 6082, 6083, 7759, 7759, 7759, 7759, 7759, 7759, 7759, 7759, 7759, 7759, 7759, 7759, 7759, 7759, 7759, 7759, 7759, 7759, 7759
7759, 7759, 7759, 7759, 7759, 7759, 7759, 7759, 7759, 7759, 7759, 7759, 7759, 7759, 7759, 7759, 7759, 7759, 7759, 6160, 6161, 964, 965, 966, 967, 968, 969, 970, 971, 972, 973, 974, 975, 976, 977, 978, 979, 980, 981, 982, 983, 984, 985, 986, 987, 988, 989, 990, 991, 992, 993, 994, 995, 996, 997, 998, 999, 1000, 1001, 6162, 6163, 7759, 7759, 7759, 7759, 7759, 7759, 7759, 7759, 7759, 7759, 7759, 7759, 7759, 7759, 7759, 7759, 7759, 7759, 7759
7759, 7759, 7759, 7759, 7759, 7759, 7759, 7759, 7759, 7759, 7759, 7759, 7759, 7759, 7759, 7759, 7759, 7759, 7759, 6240, 6241, 1044, 1045, 1046, 1047, 1048, 1049, 1050, 1051, 1052, 1053, 1054, 1055, 1056, 1057, 1058, 5214, 1060, 1061, 1062, 1063, 1064, 1065, 1066, 5214, 1068, 1069, 1070, 1071, 1072, 1073, 1074, 1075, 1076, 1077, 1078, 1079, 1080, 1081, 6242, 6243, 7759, 7759, 7759, 7759, 7759, 7759, 7759, 7759, 7759, 7759, 7759, 7759, 7759, 7759, 7759, 7759, 7759, 7759, 7759
7759, 7759, 7759, 7759, 7759, 7759, 7759, 7759, 7759, 7759, 7759, 7759, 7759, 7759, 7759, 7759, 7759, 7759, 7759, 6320, 6321, 1124, 1125, 1126, 1127, 1128, 1129, 1130, 1131, 1132, 1133, 1134, 1135, 5132, 5133, 5214, 5214, 5214, 5214, 5214, 5214, 5214, 5214, 5214, 5214, 5214, 1149, 1150, 1151, 1152, 1153, 1154, 1155, 1156, 1157, 1158, 1159, 1160, 1161, 6322, 6323, 7759, 7759, 7759, 7759, 7759, 7759, 7759, 7759, 7759, 7759, 7759, 7759, 7759, 7759, 7759, 7759, 7759, 7759, 7759
7759, 7759, 7759, 7759, 7759, 7759, 7759, 7759, 7759, 7759, 7759, 7759, 7759, 7759, 7759, 7759, 7759, 7759, 7759, 6400, 6401, 1204, 1205, 1206, 1207, 1208, 1209, 1210, 1211, 1212, 1213, 1214, 1215, 5212, 5213, 5214, 5214, 5214, 5214, 5214, 5214, 5214, 5214, 5214, 5214, 5214, 1229, 1230, 1231, 1232, 1233, 1234, 1235, 1236, 1237, 1238, 1239, 1240, 1241, 6402, 6403, 7759, 7759, 7759, 7759, 7759, 7759, 7759, 7759, 7759, 7759, 7759, 7759, 7759, 7759, 7759, 7759, 7759, 7759, 7759
7759, 7759, 7759, 7759, 7759, 7759, 7759, 7759, 7759, 7759, 7759, 7759, 7759, 7759, 7759, 7759, 7759, 7759, 7759, 6480, 6481, 1284, 1285, 1286, 1287, 1288, 1289, 1290, 1291, 1292, 1293, 1294, 1295, 5214, 5214, 5214, 5214, 5214, 5214, 5214, 5214, 5214, 5214, 5214, 5214, 5214, 1309, 1310, 1311, 1312, 1313, 1314, 1315, 1316, 1317, 1318, 1319, 1320, 1321, 6482, 6483, 7759, 7759, 7759, 7759, 7759, 7759, 7759, 7759, 7759, 7759, 7759, 7759, 7759, 7759, 7759, 7759, 7759, 7759, 7759
7759, 7759, 7759, 7759, 7759, 7759, 7759, 7759, 7759, 7759, 7759, 7759, 7759, 7759, 7759, 7759, 7759, 7759, 7759, 6560, 6561, 1364, 1365, 1366, 1367, 1368, 1369, 1370, 1371, 1372, 1373, 1374, 5214, 5214, 5214, 5214, 5214, 5214, 5214, 5214, 5214, 5214, 5214, 5214, 5214, 5214, 5214, 5136, 5137, 1392, 1393, 1394, 1395, 1396, 1397, 1398, 1399, 1400, 1401, 6562, 6563, 7759, 7759, 7759, 7759, 7759, 7759, 7759, 7759, 7759, 7759, 7759, 7759, 7759, 7759, 7759, 7759, 7759, 7759, 7759
7759, 7759, 7759, 7759, 7759, 7759, 7759, 7759, 7759, 7759, 7759, 7759, 7759, 7759, 7759, 7759, 7759, 7759, 7759, 6640, 6641, 1444, 1445, 1446, 1447, 1448, 1449, 1450, 1451, 1452, 5132, 5133, 5214, 5214, 5214, 5214, 5214, 5214, 5214, 5214, 5214, 5214, 5214, 5214, 5214, 5214, 5214, 5216, 5217, 1472, 1473, 1474, 1475, 1476, 1477, 1478, 1479, 1480, 1481, 6642, 6643, 7759, 7759, 7759, 7759, 7759, 7759, 7759, 7759, 7759, 7759, 7759, 7759, 7759, 7759, 7759, 7759, 7759, 7759, 7759
7759, 7759, 7759, 7759, 7759, 7759, 7759, 7759, 7759, 7759, 7759, 7759, 7759, 7759, 7759, 7759, 7759, 7759, 7759, 6720, 6721, 1524, 1525, 1526, 1527, 1528, 1529, 1530, 1531, 1532, 5212, 5213, 5214, 5214, 5214, 5214, 5214, 5214, 5214, 5214, 5214, 5214, 5214, 5214, 5214, 5214, 5214, 5214, 5214, 5136, 5137, 1554, 1555, 1556, 1557, 1558, 1559, 1560, 1561, 6722, 6723, 7759, 7759, 7759, 7759, 7759, 7759, 7759, 7759, 7759, 7759, 7759, 7759, 7759, 7759, 7759, 7759, 7759, 7759, 7759
7759, 7759, 7759, 7759, 7759, 7759, 7759, 7759, 7759, 7759, 7759, 7759, 7759, 7759, 7759, 7759, 7759, 7759, 7759, 6800, 6801, 1604, 1605, 1606, 1607, 1608, 1609, 1610, 1611, 1612, 5214, 5214, 5214, 5214, 5214, 5214, 5214, 5214, 5214, 5214, 5214, 5214, 5214, 5214, 5214, 5214, 5214, 5214, 5214, 5216, 5217, 1634, 1635, 1636, 1637, 1638, 1639, 1640, 1641, 6802, 6803, 7759, 7759, 7759, 7759, 7759, 7759, 7759, 7759, 7759, 7759, 7759, 7759, 7759, 7759, 7759, 7759, 7759, 7759, 7759
7759, 7759, 7759, 7759, 7759, 7759, 7759, 7759, 7759, 7759, 7759, 7759, 7759, 7759, 7759, 7759, 7759, 7759, 7759, 6880, 6881, 1684, 1685, 1686, 1687, 1688, 1689, 1690, 1691, 1692, 5214, 5214, 5214, 5214, 5214, 5214, 5214, 5214, 5214, 5214, 5214, 5214, 5214, 5214, 5214, 5214, 5214, 5214, 5214, 5214, 5214, 1714, 1715, 1716, 1717, 1718, 1719, 1720, 1721, 6882, 6883, 7759, 7759, 7759, 7759, 7759, 7759, 7759, 7759, 7759, 7759, 7759, 7759, 7759, 7759, 7759, 7759, 7759, 7759, 7759
7759, 7759, 7759, 7759, 7759, 7759, 7759, 7759, 7759, 7759, 7759, 7759, 7759, 7759, 7759, 7759, 7759, 7759, 7759, 6960, 6961, 1764, 1765, 1766, 1767, 1768, 1769, 1770, 1771, 1772, 5214, 5214, 5214, 5214, 5214, 5214, 5214, 5214, 5214, 5214, 5214, 5214, 5214, 5214, 5214, 5214, 5214, 5214, 5214, 5214, 5214, 1794, 1795, 1796, 1797, 1798, 1799, 1800, 1801, 6962, 6963, 7759, 7759, 7759, 7759, 7759, 7759, 7759, 7759, 7759, 7759, 7759, 7759, 7759, 7759, 7759, 7759, 7759, 7759, 7759
7759, 7759, 7759, 7759, 7759, 7759, 7759, 7759, 7759, 7759, 7759, 7759, 7759, 7759, 7759, 7759, 7759, 7759, 7759, 7040, 7041, 1844, 1845, 1846, 1847, 1848, 1849, 1850, 1851, 1852, 5214, 5214, 5214, 5214, 5214, 5214, 5214, 5214, 5214, 5214, 5214, 5214, 5214, 5214, 5214, 5214, 5214, 5214, 5214, 5214, 5214, 5214, 1875, 1876, 1877, 1878, 1879, 1880, 1881, 7042, 7043, 7759, 7759, 7759, 7759, 7759, 7759, 7759, 7759, 7759, 7759, 7759, 7759, 7759, 7759, 7759, 7759, 7759, 7759, 7759
7759, 7759, 7759, 7759, 7759, 7759, 7759, 7759, 7759, 7759, 7759, 7759, 7759, 7759, 7759, 7759, 7759, 7759, 7759, 5360, 5361, 1924, 1925, 1926, 1927, 1928, 1929, 1930, 5214, 5214, 5214, 5214, 5214, 5214, 5214, 5214, 5214, 5214, 5214, 5214, 5214, 5214, 5214, 5214, 5214, 5214, 5214, 5214, 5214, 5214, 5214, 5214, 1955, 5214, 1957, 1958, 1959, 1960, 1961, 5362, 5363, 7759, 7759, 7759, 7759, 7759, 7759, 7759, 7759, 7759, 7759, 7759, 7759, 7759, 7759, 7759, 7759, 7759, 7759, 7759
7759, 7759, 7759, 7759, 7759, 7759, 7759, 7759, 7759, 7759, 7759, 7759, 7759, 7759, 7759, 7759, 7759, 7759, 7759, 5440, 5441, 2004, 2005, 2006, 2007, 2008, 2009, 2010, 2011, 5214, 5214, 5214, 5214, 5214, 5214, 5214, 5214, 5214, 5214, 5214, 5214, 5214, 5214, 5214, 5214, 5214, 5214, 5214, 5214, 5214, 5214, 5214, 5214, 5214, 2037, 2038, 2039, 2040, 2041, 5442, 5443, 7759, 7759, 7759, 7759, 7759, 7759, 7759, 7759, 7759, 7759, 7759, 7759, 7759, 7759, 7759, 7759, 7759, 7759, 7759
7759, 7759, 7759, 7759, 7759, 7759, 7759, 7759, 7759, 7759, 7759, 7759, 7759, 7759, 7759, 7759, 7759, 7759, 7759, 5520, 5521, 2084, 2085, 2086, 2087, 2088, 2089, 2090, 2091, 5214, 5214, 5214, 5214, 5214, 5214, 5214, 5214, 5214, 5214, 5214, 5214, 5214, 5214, 5214, 5214, 5214, 5214, 5214, 5214, 5214, 5214, 5214, 2115, 5214, 2117, 2118, 2119, 2120, 2121, 5522, 5523, 7759, 7759, 7759, 7759, 7759, 7759, 7759, 7759, 7759, 7759, 7759, 7759, 7759, 7759, 7759, 7759, 7759, 7759, 7759
7759, 7759, 7759, 7759, 7759, 7759, 7759, 7759, 7759, 7759, 7759, 7759, 7759, 7759, 7759, 7759, 7759, 7759, 7759, 5600, 5601, 2164, 2165, 2166, 2167, 2168, 2169, 2170, 2171, 2172, 5214, 5214, 5214, 5214, 5214, 5214, 5214, 5214, 5214, 5214, 5214, 5214, 5214, 5214, 5214, 5214, 5214, 5214, 5214, 5214, 5214, 2194, 2195, 5214, 2197, 2198, 2199, 2200, 2201, 5602, 5603, 7759, 7759, 7759, 7759, 7759, 7759, 7759, 7759, 7759, 7759, 7759, 7759, 7759, 7759, 7759, 7759, 7759, 7759, 7759
7759, 7759, 7759, 7759, 7759, 7759, 7759, 7759, 7759, 7759, 7759, 7759, 7759, 7759, 7759, 7759, 7759, 7759, 7759, 5680, 5681, 2244, 2245, 2246, 2247, 2248, 2249, 2250, 2251, 2252, 5212, 5213, 5214, 5214, 5214, 5214, 5214, 5214, 5214, 5214, 5214, 5214, 5214, 5214, 5214, 5214, 5214, 5214, 5214, 5214, 5214, 2274, 2275, 5214, 2277, 2278, 2279, 2280, 2281, 5682, 5683, 7759, 7759, 7759, 7759, 7759, 7759, 7759, 7759, 7759, 7759, 7759, 7759, 7759, 7759, 7759, 7759, 7759, 7759, 7759
7759, 7759, 7759, 7759, 7759, 7759, 7759, 7759, 7759, 7759, 7759, 7759, 7759, 7759, 7759, 7759, 7759, 7759, 7759, 5760, 5761, 2324, 2325, 2326, 2327, 2328, 2329, 2330, 2331, 2332, 5292, 5293, 5214, 5214, 5214, 5214, 5214, 5214, 5214, 5214, 5214, 5214, 5214, 5214, 5214, 5214, 5214, 5214, 5214, 5216, 5217, 2354, 2355, 2356, 2357, 2358, 2359, 2360, 2361, 5762, 5763, 7759, 7759, 7759, 7759, 7759, 7759, 7759, 7759, 7759, 7759, 7759, 7759, 7759, 7759, 7759, 7759, 7759, 7759, 7759
7759, 7759, 7759, 7759, 7759, 7759, 7759, 7759, 7759, 7759, 7759, 7759, 7759, 7759, 7759, 7759, 7759, 7759, 7759, 5840, 5841, 2404, 2405, 2406, 2407, 2408, 2409, 2410, 2411, 2412, 2413, 2414, 5214, 5214, 5214, 5214, 5214, 5214, 5214, 5214, 5214, 5214, 5214, 5214, 5214, 5214, 5214, 5214, 5214, 5296, 5297, 2434, 2435, 2436, 2437, 2438, 2439, 2440, 2441, 5842, 5843, 7759, 7759, 7759, 7759, 7759, 7759, 7759, 7759, 7759, 7759, 7759, 7759, 7759, 7759, 7759, 7759, 7759, 7759, 7759
7759, 7759, 7759, 7759, 7759, 7759, 7759, 7759, 7759, 7759, 7759, 7759, 7759, 7759, 7759, 7759, 7759, 7759, 7759, 5920, 5921, 2484, 2485, 2486, 2487, 2488, 2489, 2490, 2491, 2492, 2493, 2494, 5214, 2496, 5214, 5214, 5214, 5214, 5214, 5214, 5214, 5214, 5214, 5214, 5214, 5214, 5214, 5214, 5214, 2512, 2513, 2514, 2515, 2516, 2517, 2518, 2519, 2520, 2521, 5922, 5923, 7759, 7759, 7759, 7759, 7759, 7759, 7759, 7759, 7759, 7759, 7759, 7759, 7759, 7759, 7759, 7759, 7759, 7759, 7759
7759, 7759, 7759, 7759, 7759, 7759, 7759, 7759, 7759, 7759, 7759, 7759, 7759, 7759, 7759, 7759, 7759, 7759, 7759, 6000, 6001, 2564, 2565, 2566, 2567, 2568, 2569, 2570, 2571, 2572, 2573, 2574, 2575, 2576, 2577, 5212, 5213, 5214, 5214, 5214, 5214, 5214, 5214, 5214, 5214, 5216, 5217, 2590, 2591, 2592, 2593, 2594, 2595, 2596, 2597, 2598, 2599, 2600, 2601, 6002, 6003, 7759, 7759, 7759, 7759, 7759, 7759, 7759, 7759, 7759, 7759, 7759, 7759, 7759, 7759, 7759, 7759, 7759, 7759, 7759
7759, 7759, 7759, 7759, 7759, 7759, 7759, 7759, 7759, 7759, 7759, 7759, 7759, 7759, 7759, 7759, 7759, 7759, 7759, 6080, 6081, 2644, 2645, 2646, 2647, 2648, 2649, 2650, 2651, 2652, 2653, 2654, 2655, 2656, 2657, 5292, 5293, 5214, 5214, 5214, 5214, 5214, 5214, 5214, 5214, 5296, 5297, 2670, 2671, 2672, 2673, 2674, 2675, 2676, 2677, 2678, 2679, 2680, 2681, 6082, 6083, 7759, 7759, 7759, 7759, 7759, 7759, 7759, 7759, 7759, 7759, 7759, 7759, 7759, 7759, 7759, 7759, 7759, 7759, 7759
7759, 7759, 7759, 7759, 7759, 7759, 7759, 7759, 7759, 7759, 7759, 7759, 7759, 7759, 7759, 7759, 7759, 7759, 7759, 6160, 6161, 2724, 2725, 2726, 2727, 2728, 2729, 2730, 2731, 2732, 2733, 2734, 2735, 2736, 2737, 2738, 2739, 2740, 2741, 2742, 2743, 2744, 2745, 2746, 2747, 2748, 2749, 2750, 2751, 2752, 2753, 2754, 2755, 2756, 2757, 2758, 2759, 2760, 2761, 6162, 6163, 7759, 7759, 7759, 7759, 7759, 7759, 7759, 7759, 7759, 7759, 7759, 7759, 7759, 7759, 7759, 7759, 7759, 7759, 7759
7759, 7759, 7759, 7759, 7759, 7759, 7759, 7759, 7759, 7759, 7759, 7759, 7759, 7759, 7759, 7759, 7759, 7759, 7759, 6240, 6241, 2804, 2805, 2806, 2807, 2808, 2809, 2810, 2811, 2812, 2813, 2814, 2815, 2816, 2817, 2818, 2819, 2820, 2821, 2822, 2823, 2824, 2825, 2826, 2827, 2828, 2829, 2830, 2831, 2832, 2833, 2834, 2835, 2836, 2837, 2838, 2839, 2840, 2841, 6242, 6243, 7759, 7759, 7759, 7759, 7759, 7759, 7759, 7759, 7759, 7759, 7759, 7759, 7759, 7759, 7759, 7759, 7759, 7759, 7759
7759, 7759, 7759, 7759, 7759, 7759, 7759, 7759, 7759, 7759, 7759, 7759, 7759, 7759, 7759, 7759, 7759, 7759, 7759, 6320, 6321, 7773, 7773, 7773, 7773, 2888, 2889, 2890, 2891, 2892, 2893, 2894, 2895, 2896, 2897, 2898, 2899, 2900, 2901, 2902, 2903, 2904, 2905, 2906, 2907, 2908, 2909, 2910, 2911, 2912, 2913, 2914, 2915, 2916, 2917, 2918, 2919, 2920, 2921, 6322, 6323, 7759, 7759, 7759, 7759, 7759, 7759, 7759, 7759, 7759, 7759, 7759, 7759, 7759, 7759, 7759, 7759, 7759, 7759, 7759
7759, 7759, 7759, 7759, 7759, 7759, 7759, 7759, 7759, 7759, 7759, 7759, 7759, 7759, 7759, 7759, 7759, 7759, 7759, 6400, 6401, 2964, 2965, 2966, 2967, 2968, 2969, 2970, 2971, 2972, 2973, 2974, 2975, 2976, 2977, 2978, 2979, 2980, 2981, 2982, 2983, 2984, 2985, 2986, 2987, 2988, 2989, 2990, 2991, 2992, 2993, 2994, 2995, 2996, 2997, 2998, 2999, 3000, 3001, 6402, 6403, 7759, 7759, 7759, 7759, 7759, 7759, 7759, 7759, 7759, 7759, 7759, 7759, 7759, 7759, 7759, 7759, 7759, 7759, 7759
7759, 7759, 7759, 7759, 7759, 7759, 7759, 7759, 7759, 7759, 7759, 7759, 7759, 7759, 7759, 7759, 7759, 7759, 7759, 6480, 6481, 7322, 7323, 7322, 7323, 3048, 3049, 3050, 3051, 3052, 3053, 3054, 3055, 3056, 3057, 3058, 3059, 3060, 3061, 3062, 3063, 3064, 3065, 3066, 3067, 3068, 3069, 3070, 3071, 3072, 3073, 3074, 3075, 3076, 3077, 3078, 3079, 3080, 3081, 6482, 6483, 7759, 7759, 7759, 7759, 7759, 7759, 7759, 7759, 7759, 7759, 7759, 7759, 7759, 7759, 7759, 7759, 7759, 7759, 7759
7759, 7759, 7759, 7759, 7759, 7759, 7759, 7759, 7759, 7759, 7759, 7759, 7759, 7759, 7759, 7759, 7759, 7759, 7759, 6560, 6561, 7402, 7403, 7402, 7403, 3128, 3129, 3130, 3131, 3132, 3133, 3134, 3135, 3136, 3137, 3138, 3139, 3140, 3141, 3142, 3143, 3144, 3145, 3146, 3147, 3148, 3149, 3150, 3151, 3152, 3153, 3154, 3155, 3156, 3157, 3158, 3159, 3160, 3161, 6562, 6563, 7759, 7759, 7759, 7759, 7759, 7759, 7759, 7759, 7759, 7759, 7759, 7759, 7759, 7759, 7759, 7759, 7759, 7759, 7759
7759, 7759, 7759, 7759, 7759, 7759, 7759, 7759, 7759, 7759, 7759, 7759, 7759, 7759, 7759, 7759, 7759, 7759, 7759, 6640, 6641, 3204, 3205, 3206, 3207, 3208, 3209, 3210, 3211, 5214, 3213, 3214, 5214, 5214, 5214, 5214, 5214, 5214, 3221, 3222, 3223, 3224, 3225, 3226, 3227, 3228, 3229, 3230, 3231, 3232, 3233, 3234, 3235, 3236, 5214, 5214, 5214, 3240, 3241, 6642, 6643, 7759, 7759, 7759, 7759, 7759, 7759, 7759, 7759, 7759, 7759, 7759, 7759, 7759, 7759, 7759, 7759, 7759, 7759, 7759
7759, 7759, 7759, 7759, 7759, 7759, 7759, 7759, 7759, 7759, 7759, 7759, 7759, 7759, 7759, 7759, 7759, 7759, 7759, 6720, 6721, 3284, 3285, 3286, 3287, 3288, 3289, 3290, 3291, 5214, 5214, 5214, 5214, 5214, 5214, 5214, 5214, 5214, 3301, 3302, 3303, 3304, 3305, 3306, 3307, 3308, 3309, 3310, 5214, 5214, 5214, 5214, 5214, 5214, 5214, 5214, 5214, 5214, 3321, 6722, 6723, 7759, 7759, 7759, 7759, 7759, 7759, 7759, 7759, 7759, 7759, 7759, 7759, 7759, 7759, 7759, 7759, 7759, 7759, 7759
7759, 7759, 7759, 7759, 7759, 7759, 7759, 7759, 7759, 7759, 7759, 7759, 7759, 7759, 7759, 7759, 7759, 7759, 7759, 6800, 6801, 3364, 3365, 3366, 3367, 3368, 3369, 3370, 5214, 5214, 5214, 5214, 5214, 5214, 5214, 5214, 5214, 3380, 3381, 3382, 3383, 3384, 3385, 3386, 3387, 3388, 3389, 5214, 5214, 5214, 5214, 5214, 5214, 5214, 5214, 5214, 5214, 5214, 5214, 6802, 6803, 7759, 7759, 7759, 7759, 7759, 7759, 7759, 7759, 7759, 7759, 7759, 7759, 7759, 7759, 7759, 7759, 7759, 7759, 7759
7759, 7759, 7759, 7759, 7759, 7759, 7759, 7759, 7759, 7759, 7759, 7759, 7759, 7759, 7759, 7759, 7759, 7759, 7759, 6880, 6881, 3444, 3445, 3446, 3447, 3448, 3449, 5214, 5214, 5214, 5214, 5214, 5214, 5214, 5214, 5214, 5214, 3460, 3461, 3462, 3463, 3464, 3465, 3466, 3467, 3468, 3469, 5214, 5214, 5214, 5214, 5214, 5214, 5214, 5214, 5214, 5214, 5214, 5214, 6882, 6883, 7759, 7759, 7759, 7759, 7759, 7759, 7759, 7759, 7759, 7759, 7759, 7759, 7759, 7759, 7759, 7759, 7759, 7759, 7759
7759, 7759, 7759, 7759, 7759, 7759, 7759, 7759, 7759, 7759, 7759, 7759, 7759, 7759, 7759, 7759, 7759, 7759, 7759, 6960, 6961, 3524, 3525, 3526, 3527, 3528, 3529, 3530, 5214, 5214, 5214, 5214, 5214, 5214, 5214, 5214, 5214, 3540, 3541, 3542, 3543, 3544, 3545, 3546, 3547, 3548, 5214, 5214, 5214, 5214, 5214, 5214, 5214, 5214, 5214, 5214, 5214, 5214, 5214, 6962, 6963, 7759, 7759, 7759, 7759, 7759, 7759, 7759, 7759, 7759, 7759, 7759, 7759, 7759, 7759, 7759, 7759, 7759, 7759, 7759
7759, 7759, 7759, 7759, 7759, 7759, 7759, 7759, 7759, 7759, 7759, 7759, 7759, 7759, 7759, 7759, 7759, 7759, 7759, 7040, 7041, 3604, 3605, 3606, 3607, 3608, 3609, 3610, 5214, 5214, 5214, 5214, 5214, 5214, 5214, 5214, 5214, 3620, 3621, 3622, 3623, 3624, 3625, 3626, 3627, 3628, 5214, 5214, 5214, 5214, 5214, 5214, 5214, 5214, 5214, 5214, 5214, 5214, 5214, 7042, 7043, 7759, 7759, 7759, 7759, 7759, 7759, 7759, 7759, 7759, 7759, 7759, 7759, 7759, 7759, 7759, 7759, 7759, 7759, 7759
7759, 7759, 7759, 7759, 7759, 7759, 7759, 7759, 7759, 7759, 7759, 7759, 7759, 7759, 7759, 7759, 7759, 7759, 7759, 5844, 5845, 3684, 3685, 3686, 3687, 3688, 3689, 3690, 3691, 5214, 5214, 5214, 5214, 5214, 5214, 5214, 5214, 3700, 3701, 3702, 3703, 3704, 3705, 3706, 3707, 3708, 5214, 5214, 5214, 5214, 5214, 5214, 5214, 5214, 5214, 5214, 5214, 5214, 5214, 5846, 5847, 7759, 7759, 7759, 7759, 7759, 7759, 7759, 7759, 7759, 7759, 7759, 7759, 7759, 7759, 7759, 7759, 7759, 7759, 7759
7759, 7759, 7759, 7759, 7759, 7759, 7759, 7759, 7759, 7759, 7759, 7759, 7759, 7759, 7759, 7759, 7759, 7759, 7759, 5924, 5925, 5526, 5527, 5528, 5529, 5530, 5531, 5532, 5533, 5534, 5535, 5536, 5537, 5538, 5539, 5540, 5541, 5524, 5525, 5526, 5527, 5528, 5529, 5530, 5531, 5532, 5533, 5534, 5535, 5536, 5537, 5538, 5539, 5540, 5541, 5542, 5543, 5544, 5545, 5926, 5927, 7759, 7759, 7759, 7759, 7759, 7759, 7759, 7759, 7759, 7759, 7759, 7759, 7759, 7759, 7759, 7759, 7759, 7759, 7759
7759, 7759, 7759, 7759, 7759, 7759, 7759, 7759, 7759, 7759, 7759, 7759, 7759, 7759, 7759, 7759, 7759, 7759, 7759, 5604, 5605, 5606, 5607, 5608, 5609, 5610, 5611, 5612, 5613, 5614, 5615, 5616, 5617, 5618, 5619, 5620, 5621, 5604, 5605, 5606, 5607, 5608, 5609, 5610, 5611, 5612, 5613, 5614, 5615, 5616, 5617, 5618, 5619, 5620, 5621, 5622, 5623, 5624, 5625, 5626, 5627, 7759, 7759, 7759, 7759, 7759, 7759, 7759, 7759, 7759, 7759, 7759, 7759, 7759, 7759, 7759, 7759, 7759, 7759, 7759
7759, 7759, 7759, 7759, 7759, 7759, 7759, 7759, 7759, 7759, 7759, 7759, 7759, 7759, 7759, 7759, 7759, 7759, 7759, 7759, 7759, 7759, 7759, 7759, 7759, 7759, 7759, 7759, 7759, 7759, 7759, 7759, 7759, 7759, 7759, 7759, 7759, 7759, 7759, 7759, 7759, 7759, 7759, 7759, 7759, 7759, 7759, 7759, 7759, 7759, 7759, 7759, 7759, 7759, 7759, 7759, 7759, 7759, 7759, 7759, 7759, 7759, 7759, 7759, 7759, 7759, 7759, 7759, 7759, 7759, 7759, 7759, 7759, 7759, 7759, 7759, 7759, 7759, 7759, 7759
7759, 7759, 7759, 7759, 7759, 7759, 7759, 7759, 7759, 7759, 7759, 7759, 7759, 7759, 7759, 7759, 7759, 7759, 7759, 7759, 7759, 7759, 7759, 7759, 7759, 7759, 7759, 7759, 7759, 7759, 7759, 7759, 7759, 7759, 7759, 7759, 7759, 7759, 7759, 7759, 7759, 7759, 7759, 7759, 7759, 7759, 7759, 7759, 7759, 7759, 7759, 7759, 7759, 7759, 7759, 7759, 7759, 7759, 7759, 7759, 7759, 7759, 7759, 7759, 7759, 7759, 7759, 7759, 7759, 7759, 7759, 7759, 7759, 7759, 7759, 7759, 7759, 7759, 7759, 7759
7759, 7759, 7759, 7759, 7759, 7759, 7759, 7759, 7759, 7759, 7759, 7759, 7759, 7759, 7759, 7759, 7759, 7759, 7759, 7759, 7759, 7759, 7759, 7759, 7759, 7759, 7759, 7759, 7759, 7759, 7759, 7759, 7759, 7759, 7759, 7759, 7759, 7759, 7759, 7759, 7759, 7759, 7759, 7759, 7759, 7759, 7759, 7759, 7759, 7759, 7759, 7759, 7759, 7759, 7759, 7759, 7759, 7759, 7759, 7759, 7759, 7759, 7759, 7759, 7759, 7759, 7759, 7759, 7759, 7759, 7759, 7759, 7759, 7759, 7759, 7759, 7759, 7759, 7759, 7759
7759, 7759, 7759, 7759, 7759, 7759, 7759, 7759, 7759, 7759, 7759, 7759, 7759, 7759, 7759, 7759, 7759, 7759, 7759, 7759, 7759, 7759, 7759, 7759, 7759, 7759, 7759, 7759, 7759, 7759, 7759, 7759, 7759, 7759, 7759, 7759, 7759, 7759, 7759, 7759, 7759, 7759, 7759, 7759, 7759, 7759, 7759, 7759, 7759, 7759, 7759, 7759, 7759, 7759, 7759, 7759, 7759, 7759, 7759, 7759, 7759, 7759, 7759, 7759, 7759, 7759, 7759, 7759, 7759, 7759, 7759, 7759, 7759, 7759, 7759, 7759, 7759, 7759, 7759, 7759
