1031, 1031, 1031, 1031, 1031, 1031, 1031, 1031, 1031, 1031, 1031, 1031, 1031, 1031, 1031, 1031, 1031, 1031, 1031, 1031, 1031, 1031, 1031, 1031, 1031, 1031, 1031, 1031, 1031, 1031, 1031, 1031, 1031, 1031, 1031, 1031, 1031, 1031, 1031, 1031, 1031, 1031, 1031, 1031, 1031, 1031, 1031, 1031, 1031, 1031, 1031, 1031, 1031, 1031, 1031, 1031, 1031, 1031, 1031, 1031, 1031, 1031, 1031, 1031, 1031, 1031, 1031, 1031, 1031, 1031, 1031, 1031, 1031, 1031, 1031, 1031, 1031, 1031, 1031, 1031
1031, 1031, 1031, 1031, 1031, 1031, 1031, 1031, 1031, 1031, 1031, 1031, 1031, 1031, 1031, 1031, 1031, 1031, 1031, 1031, 1031, 1031, 1031, 1031, 1031, 1031, 1031, 1031, 1031, 1031, 1031, 1031, 1031, 1031, 1031, 1031, 1031, 1031, 1031, 1031, 1031, 1031, 1031, 1031, 1031, 1031, 1031, 1031, 1031, 1031, 1031, 1031, 1031, 1031, 1031, 1031, 1031, 1031, 1031, 1031, 1031, 1031, 1031, 1031, 1031, 1031, 1031, 1031, 1031, 1031, 1031, 1031, 1031, 1031, 1031, 1031, 1031, 1031, 1031, 1031
1031, 1031, 1031, 1031, 1031, 1031, 1031, 1031, 1031, 1031, 1031, 1031, 1031, 1031, 1031, 1031, 1031, 1031, 1031, 1031, 1031, 1031, 1031, 1031, 1031, 1031, 1031, 1031, 1031, 1031, 1031, 1031, 1031, 1031, 1031, 1031, 1031, 1031, 1031, 1031, 1031, 1031, 1031, 1031, 1031, 1031, 1031, 1031, 1031, 1031, 1031, 1031, 1031, 1031, 1031, 1031, 1031, 1031, 1031, 1031, 1031, 1031, 1031, 1031, 1031, 1031, 1031, 1031, 1031, 1031, 1031, 1031, 1031, 1031, 1031, 1031, 1031, 1031, 1031, 1031
1031, 1031, 1031, 1031, 1031, 1031, 1031, 1031, 1031, 1031, 1031, 1031, 1031, 1031, 1031, 1031, 1031, 1031, 1031, 1031, 1031, 1031, 1031, 1031, 1031, 1031, 1031, 1031, 1031, 1031, 1031, 1031, 1031, 1031, 1031, 1031, 1031, 1031, 1031, 1031, 1031, 1031, 1031, 1031, 1031, 1031, 1031, 1031, 1031, 1031, 1031, 1031, 1031, 1031, 1031, 1031, 1031, 1031, 1031, 1031, 1031, 1031, 1031, 1031, 1031, 1031, 1031, 1031, 1031, 1031, 1031, 1031, 1031, 1031, 1031, 1031, 1031, 1031, 1031, 1031
1031, 1031, 1031, 1031, 1031, 1031, 1031, 1031, 1031, 1031, 1031, 1031, 1031, 1031, 1031, 1031, 1031, 1031, 1031, 1031, 1031, 1031, 1031, 1031, 1031, 1031, 1031, 1031, 1031, 1031, 1031, 1031, 1031, 1031, 1031, 1031, 1031, 1031, 1031, 1031, 1031, 1031, 1031, 1031, 1031, 1031, 1031, 1031, 1031, 1031, 1031, 1031, 1031, 1031, 1031, 1031, 1031, 1031, 1031, 1031, 1031, 1031, 1031, 1031, 1031, 1031, 1031, 1031, 1031, 1031, 1031, 1031, 1031, 1031, 1031, 1031, 1031, 1031, 1031, 1031
1031, 1031, 1031, 1031, 1031, 1031, 1031, 1031, 1031, 1031, 1031, 1031, 1031, 1031, 1031, 1031, 1031, 1031, 1031, 1031, 1031, 1031, 1031, 1031, 1031, 1031, 1031, 1031, 1031, 1031, 1031, 1031, 1031, 1031, 1031, 1031, 1031, 1031, 1031, 1031, 1031, 1031, 1031, 1031, 1031, 1031, 1031, 1031, 1031, 1031, 1031, 1031, 1031, 1031, 1031, 1031, 1031, 1031, 1031, 1031, 1031, 1031, 1031, 1031, 1031, 1031, 1031, 1031, 1031, 1031, 1031, 1031, 1031, 1031, 1031, 1031, 1031, 1031, 1031, 1031
1031, 1031, 1031, 1031, 1031, 1031, 1031, 1031, 1031, 1031, 1031, 1031, 1031, 1031, 1031, 1031, 1031, 1031, 1031, 1031, 1031, 1031, 1031, 1031, 1031, 1031, 1031, 1031, 1031, 1031, 1031, 1031, 1031, 1031, 1031, 1031, 1031, 1031, 1031, 1031, 1031, 1031, 1031, 1031, 1031, 1031, 1031, 1031, 1031, 1031, 1031, 1031, 1031, 1031, 1031, 1031, 1031, 1031, 1031, 1031, 1031, 1031, 1031, 1031, 1031, 1031, 1031, 1031, 1031, 1031, 1031, 1031, 1031, 1031, 1031, 1031, 1031, 1031, 1031, 1031
1031, 1031, 1031, 1031, 1031, 1031, 1031, 1031, 1031, 1031, 1031, 1031, 1031, 1031, 1031, 1031, 1031, 1031, 1031, 1031, 1031, 1031, 1031, 1031, 1031, 1031, 1031, 1031, 1031, 1031, 1031, 1031, 1031, 1031, 1031, 1031, 1031, 1031, 1031, 1031, 1031, 1031, 1031, 1031, 1031, 1031, 1031, 1031, 1031, 1031, 1031, 1031, 1031, 1031, 1031, 1031, 1031, 1031, 1031, 1031, 1031, 1031, 1031, 1031, 1031, 1031, 1031, 1031, 1031, 1031, 1031, 1031, 1031, 1031, 1031, 1031, 1031, 1031, 1031, 1031
1031, 1031, 1031, 1031, 1031, 1031, 1089, 1090, 1091, 1092, 1093, 1092, 1093, 1053, 1053, 1096, 1092, 1093, 1094, 1095, 1096, 1092, 1093, 1092, 1093, 1094, 1095, 1096, 1092, 1093, 1094, 1095, 1096, 1092, 1093, 1092, 1093, 1094, 1095, 1096, 1092, 1093, 1094, 1095, 1096, 1092, 1093, 1092, 1093, 1094, 1095, 1096, 1092, 1093, 1094, 1095, 1092, 1093, 1094, 1095, 1096, 1092, 1093, 1053, 1053, 1096, 1092, 1093, 1096, 1097, 1098, 1099, 1100, 1031, 1031, 1031, 1031, 1031, 1031, 1031
1031, 1031, 1031, 1031, 1031, 1031, 1071, 2, 3, 4, 5, 6, 7, 1052, 1052, 10, 11, 12, 13, 14, 15, 16, 17, 18, 19, 20, 21, 22, 23, 24, 25, 34, 35, 36, 37, 38, 39, 40, 41, 42, 43, 44, 45, 46, 47, 48, 49, 50, 51, 52, 53, 54, 55, 56, 57, 105, 106, 107, 108, 109, 110, 111, 112, 1052, 1052, 115, 116, 117, 118, 119, 120, 121, 1074, 1031, 1031, 1031, 1031, 1031, 1031, 1031
1031, 1031, 1031, 1031, 1031, 1031, 1103, 66, 67, 68, 69, 70, 71, 72, 73, 74, 75, 76, 77, 78, 79, 80, 81, 82, 83, 84, 85, 86, 87, 88, 89, 98, 99, 100, 101, 102, 103, 104, 105, 106, 107, 108, 109, 110, 111, 112, 113, 114, 115, 116, 117, 118, 119, 120, 121, 169, 170, 171, 172, 173, 174, 175, 176, 177, 178, 179, 180, 181, 182, 183, 184, 185, 1106, 1031, 1031, 1031, 1031, 1031, 1031, 1031
1031, 1031, 1031, 1031, 1031, 1031, 1135, 130, 131, 132, 133, 134, 135, 136, 137, 138, 139, 140, 141, 142, 143, 144, 145, 146, 147, 148, 149, 150, 151, 152, 153, 162, 163, 164, 165, 166, 167, 168, 169, 170, 171, 172, 173, 174, 175, 176, 177, 178, 179, 180, 181, 182, 183, 184, 185, 233, 234, 235, 236, 237, 238, 239, 240, 241, 242, 243, 244, 245, 246, 247, 248, 249, 1138, 1031, 1031, 1031, 1031, 1031, 1031, 1031
1031, 1031, 1031, 1031, 1031, 1031, 1071, 194, 195, 196, 197, 198, 199, 200, 201, 202, 203, 204, 205, 206, 207, 208, 209, 210, 211, 212, 213, 214, 215, 216, 217, 226, 227, 228, 229, 230, 231, 232, 233, 234, 235, 236, 237, 238, 239, 240, 241, 242, 243, 244, 245, 246, 247, 248, 249, 297, 298, 299, 300, 301, 302, 303, 304, 305, 306, 307, 308, 309, 310, 311, 312, 313, 1074, 1031, 1031, 1031, 1031, 1031, 1031, 1031
1031, 1031, 1031, 1031, 1031, 1031, 1103, 258, 259, 260, 261, 262, 263, 264, 265, 266, 267, 268, 269, 270, 271, 272, 273, 274, 275, 276, 277, 278, 279, 280, 281, 290, 291, 292, 293, 294, 295, 296, 297, 298, 299, 300, 301, 302, 303, 304, 305, 306, 307, 308, 309, 310, 311, 312, 313, 105, 106, 107, 108, 109, 110, 111, 112, 113, 114, 115, 116, 117, 118, 119, 120, 121, 1106, 1031, 1031, 1031, 1031, 1031, 1031, 1031
1031, 1031, 1031, 1031, 1031, 1031, 1135, 322, 323, 324, 325, 326, 327, 328, 329, 2, 3, 4, 5, 6, 7, 8, 9, 10, 11, 12, 13, 14, 15, 16, 17, 18, 19, 20, 21, 22, 23, 24, 25, 34, 35, 36, 37, 38, 39, 40, 41, 42, 43, 44, 45, 46, 47, 48, 49, 50, 51, 52, 53, 54, 55, 56, 57, 177, 178, 179, 180, 181, 182, 183, 184, 185, 1138, 1031, 1031, 1031, 1031, 1031, 1031, 1031
1031, 1031, 1031, 1031, 1031, 1031, 1071, 386, 387, 388, 389, 390, 391, 392, 393, 66, 67, 68, 69, 70, 71, 72, 73, 74, 75, 76, 77, 78, 79, 80, 81, 82, 83, 84, 85, 86, 87, 88, 89, 98, 99, 100, 101, 102, 103, 104, 105, 106, 107, 108, 109, 110, 111, 112, 113, 114, 115, 116, 117, 118, 119, 120, 121, 241, 242, 243, 244, 245, 246, 247, 248, 249, 1074, 1031, 1031, 1031, 1031, 1031, 1031, 1031
1031, 1031, 1031, 1031, 1031, 1031, 1103, 450, 451, 452, 453, 454, 455, 456, 457, 130, 131, 132, 133, 134, 135, 136, 137, 138, 139, 140, 141, 142, 143, 144, 145, 146, 147, 148, 149, 150, 151, 152, 153, 162, 163, 164, 165, 166, 167, 168, 169, 170, 171, 172, 173, 174, 175, 176, 177, 178, 179, 180, 181, 182, 183, 184, 185, 305, 306, 307, 308, 309, 310, 311, 312, 313, 1106, 1031, 1031, 1031, 1031, 1031, 1031, 1031
1031, 1031, 1031, 1031, 1031, 1031, 1135, 2, 3, 4, 5, 6, 7, 8, 9, 194, 195, 196, 197, 198, 199, 200, 201, 202, 203, 204, 205, 206, 207, 208, 209, 210, 211, 212, 213, 214, 215, 216, 217, 226, 227, 228, 229, 230, 231, 232, 233, 234, 235, 236, 237, 238, 239, 240, 241, 242, 243, 244, 245, 246, 247, 248, 249, 113, 114, 115, 116, 117, 118, 119, 120, 121, 1138, 1031, 1031, 1031, 1031, 1031, 1031, 1031
1031, 1031, 1031, 1031, 1031, 1031, 1071, 66, 67, 68, 69, 70, 71, 72, 73, 258, 259, 260, 261, 262, 263, 264, 265, 266, 267, 268, 269, 270, 271, 272, 273, 274, 275, 276, 277, 278, 279, 280, 281, 290, 291, 292, 293, 294, 295, 296, 297, 298, 299, 300, 301, 302, 303, 304, 305, 306, 307, 308, 309, 310, 311, 312, 313, 177, 178, 179, 180, 181, 182, 183, 184, 185, 1074, 1031, 1031, 1031, 1031, 1031, 1031, 1031
1031, 1031, 1031, 1031, 1031, 1031, 1103, 130, 131, 132, 133, 134, 135, 136, 137, 322, 217, 324, 325, 326, 327, 328, 329, 330, 331, 332, 333, 334, 335, 336, 337, 338, 339, 340, 341, 342, 343, 344, 345, 354, 355, 356, 357, 358, 359, 360, 361, 362, 363, 364, 365, 366, 367, 368, 369, 370, 371, 372, 373, 374, 375, 376, 377, 57, 242, 243, 244, 245, 246, 247, 248, 249, 1106, 1031, 1031, 1031, 1031, 1031, 1031, 1031
1031, 1031, 1031, 1031, 1031, 1031, 1135, 194, 195, 196, 197, 198, 199, 200, 201, 386, 217, 388, 389, 390, 391, 392, 393, 394, 395, 396, 397, 398, 399, 400, 401, 402, 403, 404, 405, 406, 407, 408, 409, 418, 419, 420, 421, 422, 423, 424, 425, 426, 427, 428, 429, 430, 431, 432, 433, 434, 435, 436, 437, 438, 439, 440, 441, 121, 306, 307, 308, 309, 310, 311, 312, 313, 1138, 1031, 1031, 1031, 1031, 1031, 1031, 1031
1031, 1031, 1031, 1031, 1031, 1031, 1103, 258, 259, 260, 261, 262, 263, 1027, 1027, 1027, 1027, 1027, 1027, 454, 455, 456, 457, 458, 459, 460, 461, 462, 463, 464, 465, 466, 467, 468, 469, 470, 471, 472, 473, 482, 483, 484, 485, 486, 487, 488, 489, 490, 491, 492, 493, 494, 495, 496, 497, 498, 499, 500, 501, 1026, 1026, 1026, 1026, 1026, 1026, 115, 116, 117, 118, 119, 120, 121, 1138, 1031, 1031, 1031, 1031, 1031, 1031, 1031
1031, 1031, 1031, 1031, 1031, 1031, 1135, 322, 323, 324, 325, 326, 327, 275, 275, 275, 3, 4, 5, 6, 7, 8, 9, 10, 11, 12, 13, 14, 15, 16, 17, 18, 19, 20, 21, 22, 23, 24, 25, 34, 35, 36, 37, 38, 39, 40, 41, 42, 43, 44, 45, 46, 47, 48, 49, 50, 51, 52, 53, 54, 55, 56, 57, 249, 178, 179, 180, 181, 182, 183, 184, 185, 1074, 1031, 1031, 1031, 1031, 1031, 1031, 1031
1031, 1031, 1031, 1031, 1031, 1031, 1071, 386, 387, 388, 389, 390, 391, 392, 393, 66, 67, 68, 69, 70, 71, 72, 73, 74, 75, 76, 77, 78, 79, 80, 81, 82, 83, 84, 85, 86, 87, 88, 89, 98, 99, 100, 101, 102, 103, 104, 105, 106, 107, 108, 109, 110, 111, 112, 113, 114, 115, 116, 117, 118, 119, 120, 121, 313, 242, 243, 244, 245, 246, 247, 248, 249, 1106, 1031, 1031, 1031, 1031, 1031, 1031, 1031
1031, 1031, 1031, 1031, 1031, 1031, 1103, 450, 451, 452, 453, 454, 455, 456, 457, 130, 131, 132, 133, 134, 135, 136, 137, 138, 139, 140, 141, 142, 143, 144, 145, 146, 147, 148, 149, 150, 151, 152, 153, 162, 163, 164, 165, 166, 167, 168, 169, 170, 171, 172, 173, 174, 175, 176, 177, 178, 179, 180, 181, 182, 183, 184, 185, 377, 306, 307, 308, 309, 310, 311, 312, 313, 1138, 1031, 1031, 1031, 1031, 1031, 1031, 1031
1031, 1031, 1031, 1031, 1031, 1031, 1135, 2, 3, 4, 5, 6, 7, 8, 9, 194, 195, 196, 197, 198, 199, 200, 201, 202, 203, 204, 205, 206, 207, 208, 209, 210, 211, 212, 213, 214, 215, 216, 217, 226, 227, 228, 229, 230, 231, 232, 233, 234, 235, 236, 237, 238, 239, 240, 241, 242, 243, 244, 245, 246, 247, 248, 249, 441, 114, 115, 116, 117, 118, 119, 120, 121, 1138, 1031, 1031, 1031, 1031, 1031, 1031, 1031
1031, 1031, 1031, 1031, 1031, 1031, 1071, 66, 67, 68, 69, 70, 71, 72, 73, 258, 259, 260, 261, 262, 263, 264, 265, 266, 267, 268, 269, 270, 271, 272, 273, 274, 275, 276, 277, 278, 279, 280, 281, 290, 291, 292, 293, 294, 295, 296, 297, 298, 299, 300, 301, 302, 303, 304, 305, 306, 307, 308, 309, 310, 311, 312, 313, 505, 178, 179, 180, 181, 182, 183, 184, 185, 1074, 1031, 1031, 1031, 1031, 1031, 1031, 1031
1031, 1031, 1031, 1031, 1031, 1031, 1103, 130, 131, 132, 133, 134, 135, 136, 137, 322, 323, 324, 325, 326, 327, 328, 329, 330, 331, 332, 333, 334, 335, 336, 337, 338, 339, 340, 341, 342, 343, 344, 345, 354, 355, 356, 357, 358, 359, 360, 361, 362, 363, 364, 365, 366, 367, 368, 369, 370, 371, 372, 373, 374, 375, 376, 377, 57, 242, 243, 244, 245, 246, 247, 248, 249, 1106, 1031, 1031, 1031, 1031, 1031, 1031, 1031
1031, 1031, 1031, 1031, 1031, 1031, 1135, 194, 195, 196, 197, 198, 199, 200, 2, 386, 387, 388, 389, 390, 391, 392, 393, 394, 395, 396, 397, 398, 399, 400, 401, 402, 403, 404, 405, 406, 407, 408, 409, 418, 419, 420, 421, 422, 423, 424, 425, 426, 427, 428, 429, 430, 431, 432, 433, 434, 435, 436, 437, 438, 439, 440, 441, 121, 306, 307, 308, 309, 310, 311, 312, 313, 1138, 1031, 1031, 1031, 1031, 1031, 1031, 1031
1031, 1031, 1031, 1031, 1031, 1031, 1071, 258, 259, 260, 261, 262, 263, 264, 66, 450, 451, 452, 453, 454, 455, 456, 457, 458, 459, 460, 461, 462, 463, 464, 465, 466, 467, 468, 469, 470, 471, 472, 473, 482, 483, 484, 485, 486, 487, 488, 489, 490, 491, 492, 493, 494, 495, 496, 497, 498, 499, 500, 501, 502, 503, 504, 505, 185, 114, 115, 116, 117, 118, 119, 120, 121, 1074, 1031, 1031, 1031, 1031, 1031, 1031, 1031
1031, 1031, 1031, 1031, 1031, 1031, 1103, 322, 323, 324, 325, 326, 327, 328, 130, 2, 3, 4, 5, 6, 7, 8, 9, 10, 11, 12, 13, 14, 15, 16, 17, 18, 19, 20, 21, 22, 23, 24, 25, 34, 35, 36, 37, 38, 39, 40, 41, 42, 43, 44, 45, 46, 47, 48, 49, 50, 51, 52, 53, 54, 55, 56, 57, 249, 178, 179, 180, 181, 182, 183, 184, 185, 1106, 1031, 1031, 1031, 1031, 1031, 1031, 1031
1031, 1031, 1031, 1031, 1031, 1031, 1135, 2, 3, 4, 5, 6, 7, 8, 194, 66, 67, 68, 69, 70, 71, 72, 73, 74, 75, 76, 77, 78, 79, 80, 81, 82, 83, 84, 85, 86, 87, 88, 89, 98, 99, 100, 101, 102, 103, 104, 105, 106, 107, 108, 109, 110, 111, 112, 113, 114, 115, 116, 117, 118, 119, 120, 121, 313, 50, 51, 52, 53, 54, 55, 56, 57, 1138, 1031, 1031, 1031, 1031, 1031, 1031, 1031
1031, 1031, 1031, 1031, 1031, 1031, 1071, 66, 67, 68, 69, 70, 71, 72, 258, 130, 131, 132, 133, 134, 135, 136, 137, 138, 139, 140, 141, 142, 143, 144, 145, 146, 147, 148, 149, 150, 151, 152, 153, 162, 163, 164, 165, 166, 167, 168, 169, 170, 171, 172, 173, 174, 175, 176, 177, 178, 179, 180, 181, 182, 183, 184, 185, 377, 114, 115, 116, 117, 118, 119, 120, 121, 1106, 1031, 1031, 1031, 1031, 1031, 1031, 1031
1031, 1031, 1031, 1031, 1031, 1031, 1103, 130, 131, 132, 133, 134, 135, 136, 322, 194, 195, 196, 197, 198, 199, 200, 201, 202, 203, 204, 205, 206, 207, 208, 209, 210, 211, 212, 213, 214, 215, 216, 217, 226, 227, 228, 229, 230, 231, 232, 233, 234, 235, 236, 237, 238, 239, 240, 241, 242, 243, 244, 245, 246, 247, 248, 249, 441, 178, 179, 180, 181, 182, 183, 184, 185, 1138, 1031, 1031, 1031, 1031, 1031, 1031, 1031
1031, 1031, 1031, 1031, 1031, 1031, 1135, 194, 195, 196, 197, 198, 199, 200, 386, 258, 259, 260, 261, 262, 263, 264, 265, 266, 267, 268, 269, 270, 271, 272, 273, 274, 275, 276, 277, 278, 279, 280, 281, 290, 291, 292, 293, 294, 295, 296, 297, 298, 299, 300, 301, 302, 303, 304, 305, 306, 307, 308, 309, 310, 311, 312, 313, 505, 242, 243, 244, 245, 246, 247, 248, 249, 1074, 1031, 1031, 1031, 1031, 1031, 1031, 1031
1031, 1031, 1031, 1031, 1031, 1031, 1071, 258, 259, 260, 261, 262, 263, 264, 450, 322, 323, 324, 325, 326, 327, 328, 329, 330, 331, 332, 333, 334, 335, 336, 337, 338, 339, 340, 341, 342, 343, 344, 345, 354, 355, 356, 357, 358, 359, 360, 361, 362, 363, 364, 365, 366, 367, 368, 369, 370, 371, 372, 373, 374, 375, 376, 377, 57, 306, 307, 308, 309, 310, 311, 312, 313, 1106, 1031, 1031, 1031, 1031, 1031, 1031, 1031
1031, 1031, 1031, 1031, 1031, 1031, 1103, 322, 323, 324, 325, 326, 327, 328, 2, 386, 387, 388, 389, 390, 391, 392, 393, 394, 395, 396, 397, 398, 399, 400, 401, 402, 403, 1024, 1025, 1024, 1026, 1026, 1026, 1026, 1027, 1027, 1027, 1027, 1024, 1025, 1024, 426, 427, 428, 429, 430, 431, 432, 433, 434, 435, 436, 437, 438, 439, 440, 441, 121, 370, 371, 372, 373, 374, 375, 376, 377, 1138, 1031, 1031, 1031, 1031, 1031, 1031, 1031
1031, 1031, 1031, 1031, 1031, 1031, 1135, 386, 387, 388, 389, 390, 391, 392, 66, 450, 451, 452, 453, 454, 455, 456, 457, 458, 459, 460, 461, 462, 463, 464, 465, 466, 467, 468, 469, 470, 471, 472, 473, 482, 483, 484, 485, 486, 487, 488, 489, 490, 491, 492, 493, 494, 495, 496, 497, 498, 499, 500, 501, 502, 503, 504, 505, 185, 434, 435, 436, 437, 438, 439, 440, 441, 1074, 1031, 1031, 1031, 1031, 1031, 1031, 1031
1031, 1031, 1031, 1031, 1031, 1031, 1071, 450, 451, 452, 453, 454, 455, 456, 130, 131, 132, 133, 134, 135, 136, 137, 138, 139, 140, 141, 142, 143, 144, 145, 146, 147, 148, 149, 150, 151, 152, 153, 162, 163, 164, 165, 166, 167, 168, 169, 170, 171, 172, 173, 174, 175, 176, 177, 178, 179, 180, 181, 182, 183, 184, 185, 248, 249, 498, 499, 500, 501, 502, 503, 504, 505, 1106, 1031, 1031, 1031, 1031, 1031, 1031, 1031
1031, 1031, 1031, 1031, 1031, 1031, 1103, 2, 3, 4, 5, 6, 7, 8, 194, 195, 196, 197, 198, 199, 200, 201, 202, 203, 204, 205, 206, 207, 208, 209, 210, 211, 212, 213, 214, 215, 216, 217, 226, 227, 228, 229, 230, 231, 232, 233, 234, 235, 236, 237, 238, 239, 240, 241, 242, 243, 244, 245, 246, 247, 248, 249, 312, 313, 50, 51, 52, 53, 54, 55, 56, 57, 1138, 1031, 1031, 1031, 1031, 1031, 1031, 1031
1031, 1031, 1031, 1031, 1031, 1031, 1135, 66, 67, 68, 69, 70, 71, 72, 258, 259, 260, 261, 262, 263, 264, 265, 266, 267, 268, 269, 270, 271, 272, 273, 274, 275, 276, 277, 278, 279, 280, 281, 290, 291, 292, 293, 294, 295, 296, 297, 298, 299, 300, 301, 302, 303, 304, 305, 306, 307, 308, 309, 310, 311, 312, 313, 376, 377, 114, 115, 116, 117, 118, 119, 120, 121, 1106, 1031, 1031, 1031, 1031, 1031, 1031, 1031
1031, 1031, 1031, 1031, 1031, 1031, 1071, 130, 131, 132, 133, 134, 135, 136, 322, 323, 324, 325, 326, 327, 328, 329, 330, 331, 332, 333, 334, 335, 336, 337, 338, 339, 340, 341, 342, 343, 344, 345, 354, 355, 356, 357, 358, 359, 360, 361, 362, 363, 364, 365, 366, 367, 368, 369, 370, 371, 372, 373, 374, 375, 376, 377, 440, 441, 178, 179, 180, 181, 182, 183, 184, 185, 1138, 1031, 1031, 1031, 1031, 1031, 1031, 1031
1031, 1031, 1031, 1031, 1031, 1031, 1103, 194, 195, 196, 197, 198, 199, 200, 386, 387, 388, 389, 390, 391, 392, 393, 394, 395, 396, 397, 398, 399, 400, 401, 402, 403, 404, 405, 406, 407, 408, 409, 418, 419, 420, 421, 422, 423, 424, 425, 426, 427, 428, 429, 430, 431, 432, 433, 434, 435, 436, 437, 438, 439, 440, 441, 504, 505, 242, 243, 244, 245, 246, 247, 248, 249, 1074, 1031, 1031, 1031, 1031, 1031, 1031, 1031
1031, 1031, 1031, 1031, 1031, 1031, 1135, 258, 259, 260, 261, 262, 263, 264, 450, 451, 452, 453, 454, 455, 456, 457, 458, 459, 460, 461, 462, 463, 464, 465, 466, 467, 468, 469, 470, 471, 472, 473, 482, 483, 484, 485, 486, 487, 488, 489, 490, 491, 492, 493, 494, 495, 496, 497, 498, 499, 500, 501, 502, 503, 504, 505, 304, 305, 306, 307, 308, 309, 310, 311, 312, 313, 1106, 1031, 1031, 1031, 1031, 1031, 1031, 1031
1031, 1031, 1031, 1031, 1031, 1031, 1103, 322, 323, 324, 325, 326, 327, 328, 2, 3, 4, 5, 6, 7, 8, 9, 10, 11, 12, 13, 14, 15, 16, 17, 18, 19, 20, 21, 22, 23, 24, 25, 34, 35, 36, 37, 38, 39, 40, 41, 42, 43, 44, 45, 46, 47, 48, 49, 50, 51, 52, 53, 54, 55, 56, 57, 368, 369, 370, 371, 372, 373, 374, 375, 376, 377, 1138, 1031, 1031, 1031, 1031, 1031, 1031, 1031
1031, 1031, 1031, 1031, 1031, 1031, 1135, 386, 387, 388, 389, 390, 391, 392, 66, 67, 68, 69, 70, 71, 72, 73, 74, 75, 76, 77, 78, 79, 80, 81, 82, 83, 84, 85, 86, 87, 88, 89, 98, 99, 100, 101, 102, 103, 104, 105, 106, 107, 108, 109, 110, 111, 112, 113, 114, 115, 116, 117, 118, 119, 120, 121, 432, 433, 434, 435, 436, 437, 438, 439, 440, 441, 1074, 1031, 1031, 1031, 1031, 1031, 1031, 1031
1031, 1031, 1031, 1031, 1031, 1031, 1071, 450, 451, 452, 453, 454, 455, 456, 130, 131, 132, 133, 134, 135, 136, 137, 138, 139, 140, 141, 142, 143, 144, 145, 146, 147, 148, 149, 150, 151, 152, 153, 162, 163, 164, 165, 166, 167, 168, 169, 170, 171, 172, 173, 174, 175, 176, 177, 178, 179, 180, 181, 182, 183, 184, 185, 496, 497, 498, 499, 500, 501, 502, 503, 504, 505, 1106, 1031, 1031, 1031, 1031, 1031, 1031, 1031
1031, 1031, 1031, 1031, 1031, 1031, 1103, 2, 3, 4, 5, 6, 7, 8, 194, 195, 196, 197, 198, 199, 200, 201, 202, 203, 204, 205, 206, 207, 208, 209, 210, 211, 212, 213, 214, 215, 216, 217, 226, 227, 228, 229, 230, 231, 232, 233, 234, 235, 236, 237, 238, 239, 240, 241, 242, 243, 244, 245, 246, 247, 248, 249, 48, 49, 50, 51, 52, 53, 54, 55, 56, 57, 1138, 1031, 1031, 1031, 1031, 1031, 1031, 1031
1031, 1031, 1031, 1031, 1031, 1031, 1135, 66, 67, 68, 69, 70, 71, 72, 258, 259, 260, 261, 262, 263, 264, 265, 266, 267, 268, 269, 270, 271, 272, 273, 274, 275, 276, 277, 278, 279, 280, 281, 290, 291, 292, 293, 294, 295, 296, 297, 298, 299, 300, 301, 302, 303, 304, 305, 306, 307, 308, 309, 310, 311, 312, 313, 112, 113, 114, 115, 116, 117, 118, 119, 120, 121, 1138, 1031, 1031, 1031, 1031, 1031, 1031, 1031
1031, 1031, 1031, 1031, 1031, 1031, 1071, 130, 131, 132, 133, 134, 135, 136, 322, 323, 324, 325, 326, 327, 328, 329, 330, 331, 332, 333, 334, 335, 336, 337, 338, 339, 340, 341, 342, 343, 344, 345, 354, 355, 356, 357, 358, 359, 360, 361, 362, 363, 364, 365, 366, 367, 368, 369, 370, 371, 372, 373, 374, 375, 376, 377, 176, 177, 178, 179, 180, 181, 182, 183, 184, 185, 1074, 1031, 1031, 1031, 1031, 1031, 1031, 1031
1031, 1031, 1031, 1031, 1031, 1031, 1103, 194, 195, 196, 197, 198, 199, 200, 386, 387, 388, 389, 390, 391, 392, 393, 394, 395, 396, 397, 398, 399, 400, 401, 402, 403, 404, 405, 406, 407, 408, 409, 418, 419, 420, 421, 422, 423, 424, 425, 426, 427, 428, 429, 430, 431, 432, 433, 434, 435, 436, 437, 438, 439, 440, 441, 240, 241, 242, 243, 244, 245, 246, 247, 248, 249, 1106, 1031, 1031, 1031, 1031, 1031, 1031, 1031
1031, 1031, 1031, 1031, 1031, 1031, 1135, 258, 259, 260, 261, 262, 263, 264, 450, 451, 452, 453, 454, 455, 456, 457, 458, 459, 460, 461, 462, 463, 464, 465, 466, 467, 468, 469, 470, 471, 472, 473, 482, 483, 484, 485, 486, 487, 488, 489, 490, 491, 492, 493, 494, 495, 496, 497, 498, 499, 500, 501, 502, 503, 504, 505, 304, 305, 306, 307, 308, 309, 310, 311, 312, 313, 1138, 1031, 1031, 1031, 1031, 1031, 1031, 1031
1031, 1031, 1031, 1031, 1031, 1031, 1071, 322, 323, 324, 325, 326, 327, 328, 329, 330, 331, 332, 333, 334, 335, 336, 337, 338, 322, 323, 324, 325, 326, 327, 328, 329, 330, 331, 332, 333, 334, 335, 336, 337, 338, 339, 340, 341, 342, 343, 344, 345, 354, 355, 356, 357, 358, 359, 360, 361, 362, 363, 364, 365, 366, 367, 368, 369, 370, 371, 372, 373, 374, 375, 376, 377, 1074, 1031, 1031, 1031, 1031, 1031, 1031, 1031
1031, 1031, 1031, 1031, 1031, 1031, 1103, 386, 387, 388, 389, 390, 391, 392, 393, 394, 395, 396, 397, 398, 399, 400, 401, 402, 386, 387, 388, 389, 390, 391, 392, 393, 394, 395, 396, 397, 398, 399, 400, 401, 402, 403, 404, 405, 406, 407, 408, 409, 418, 419, 420, 421, 422, 423, 424, 425, 426, 427, 428, 429, 430, 431, 432, 433, 434, 435, 436, 437, 438, 439, 440, 441, 1106, 1031, 1031, 1031, 1031, 1031, 1031, 1031
1031, 1031, 1031, 1031, 1031, 1031, 1135, 450, 451, 452, 453, 454, 455, 456, 457, 458, 459, 460, 461, 462, 463, 464, 465, 466, 450, 451, 452, 453, 454, 455, 456, 457, 458, 459, 460, 461, 462, 463, 177, 1052, 1052, 467, 468, 469, 470, 471, 472, 473, 482, 483, 484, 485, 486, 487, 488, 489, 490, 491, 492, 493, 494, 495, 496, 497, 498, 499, 500, 501, 502, 503, 504, 505, 1138, 1031, 1031, 1031, 1031, 1031, 1031, 1031
1031, 1031, 1031, 1031, 1031, 1031, 1057, 1058, 1059, 1060, 1061, 1060, 1061, 1062, 1063, 1064, 1060, 1061, 1062, 1063, 1064, 1060, 1061, 1060, 1061, 1062, 1063, 1064, 1060, 1061, 1062, 1063, 1064, 1060, 1061, 1060, 1061, 1062, 1063, 1053, 1053, 1061, 1062, 1063, 1064, 1060, 1061, 1060, 1061, 1062, 1063, 1064, 1060, 1061, 1062, 1063, 1064, 1060, 1061, 1062, 1063, 1064, 1060, 1061, 1062, 1063, 1064, 1060, 1061, 1065, 1066, 1067, 1068, 1031, 1031, 1031, 1031, 1031, 1031, 1031
1031, 1031, 1031, 1031, 1031, 1031, 1031, 1031, 1031, 1031, 1031, 1031, 1031, 1031, 1031, 1031, 1031, 1031, 1031, 1031, 1031, 1031, 1031, 1031, 1031, 1031, 1031, 1031, 1031, 1031, 1031, 1031, 1031, 1031, 1031, 1031, 1031, 1031, 1031, 1031, 1031, 1031, 1031, 1031, 1031, 1031, 1031, 1031, 1031, 1031, 1031, 1031, 1031, 1031, 1031, 1031, 1031, 1031, 1031, 1031, 1031, 1031, 1031, 1031, 1031, 1031, 1031, 1031, 1031, 1031, 1031, 1031, 1031, 1031, 1031, 1031, 1031, 1031, 1031, 1031
1031, 1031, 1031, 1031, 1031, 1031, 1031, 1031, 1031, 1031, 1031, 1031, 1031, 1031, 1031, 1031, 1031, 1031, 1031, 1031, 1031, 1031, 1031, 1031, 1031, 1031, 1031, 1031, 1031, 1031, 1031, 1031, 1031, 1031, 1031, 1031, 1031, 1031, 1031, 1031, 1031, 1031, 1031, 1031, 1031, 1031, 1031, 1031, 1031, 1031, 1031, 1031, 1031, 1031, 1031, 1031, 1031, 1031, 1031, 1031, 1031, 1031, 1031, 1031, 1031, 1031, 1031, 1031, 1031, 1031, 1031, 1031, 1031, 1031, 1031, 1031, 1031, 1031, 1031, 1031
1031, 1031, 1031, 1031, 1031, 1031, 1031, 1031, 1031, 1031, 1031, 1031, 1031, 1031, 1031, 1031, 1031, 1031, 1031, 1031, 1031, 1031, 1031, 1031, 1031, 1031, 1031, 1031, 1031, 1031, 1031, 1031, 1031, 1031, 1031, 1031, 1031, 1031, 1031, 1031, 1031, 1031, 1031, 1031, 1031, 1031, 1031, 1031, 1031, 1031, 1031, 1031, 1031, 1031, 1031, 1031, 1031, 1031, 1031, 1031, 1031, 1031, 1031, 1031, 1031, 1031, 1031, 1031, 1031, 1031, 1031, 1031, 1031, 1031, 1031, 1031, 1031, 1031, 1031, 1031
1031, 1031, 1031, 1031, 1031, 1031, 1031, 1031, 1031, 1031, 1031, 1031, 1031, 1031, 1031, 1031, 1031, 1031, 1031, 1031, 1031, 1031, 1031, 1031, 1031, 1031, 1031, 1031, 1031, 1031, 1031, 1031, 1031, 1031, 1031, 1031, 1031, 1031, 1031, 1031, 1031, 1031, 1031, 1031, 1031, 1031, 1031, 1031, 1031, 1031, 1031, 1031, 1031, 1031, 1031, 1031, 1031, 1031, 1031, 1031, 1031, 1031, 1031, 1031, 1031, 1031, 1031, 1031, 1031, 1031, 1031, 1031, 1031, 1031, 1031, 1031, 1031, 1031, 1031, 1031
