7759, 7759, 7759, 7759, 7759, 7759, 7759, 7759, 7759, 7759, 7759, 7759, 7759, 7759, 7759, 7759, 7759, 7759, 7759, 7759, 7759, 7759, 7759, 7759, 7759, 7759, 7759, 7759, 7759, 7759, 7759, 7759, 7759, 7759, 7759, 7759, 7759, 7759, 7759, 7759, 7759, 7759, 7759, 7759, 7759, 7759, 7759, 7759, 7759, 7759, 7759, 7759, 7759, 7759, 7759, 7759, 7759, 7759, 7759, 7759, 7759, 7759, 7759, 7759, 7759, 7759, 7759, 7759, 7759, 7759, 7759, 7759, 7759, 7759, 7759, 7759, 7759, 7759, 7759, 7759
7759, 7759, 7759, 7759, 7759, 7759, 7759, 7759, 7759, 7759, 7759, 7759, 7759, 7759, 7759, 7759, 7759, 7759, 7759, 7759, 7759, 7759, 7759, 7759, 7759, 7759, 7759, 7759, 7759, 7759, 7759, 7759, 7759, 7759, 7759, 7759, 7759, 7759, 7759, 7759, 7759, 7759, 7759, 7759, 7759, 7759, 7759, 7759, 7759, 7759, 7759, 7759, 7759, 7759, 7759, 7759, 7759, 7759, 7759, 7759, 7759, 7759, 7759, 7759, 7759, 7759, 7759, 7759, 7759, 7759, 7759, 7759, 7759, 7759, 7759, 7759, 7759, 7759, 7759, 7759
7759, 7759, 7759, 7759, 7759, 7759, 7759, 7759, 7759, 7759, 7759, 7759, 7759, 7759, 7759, 7759, 7759, 7759, 7759, 7759, 7759, 7759, 7759, 7759, 7759, 7759, 7759, 7759, 7759, 7759, 7759, 7759, 7759, 7759, 7759, 7759, 7759, 7759, 7759, 7759, 7759, 7759, 7759, 7759, 7759, 7759, 7759, 7759, 7759, 7759, 7759, 7759, 7759, 7759, 7759, 7759, 7759, 7759, 7759, 7759, 7759, 7759, 7759, 7759, 7759, 7759, 7759, 7759, 7759, 7759, 7759, 7759, 7759, 7759, 7759, 7759, 7759, 7759, 7759, 7759
7759, 7759, 7759, 7759, 7759, 7759, 7759, 7759, 7759, 7759, 7759, 7759, 7759, 7759, 7759, 7759, 7759, 7759, 7759, 7759, 7759, 7759, 7759, 7759, 7759, 7759, 7759, 7759, 7759, 7759, 7759, 7759, 7759, 7759, 7759, 7759, 7759, 7759, 7759, 7759, 7759, 7759, 7759, 7759, 7759, 7759, 7759, 7759, 7759, 7759, 7759, 7759, 7759, 7759, 7759, 7759, 7759, 7759, 7759, 7759, 7759, 7759, 7759, 7759, 7759, 7759, 7759, 7759, 7759, 7759, 7759, 7759, 7759, 7759, 7759, 7759, 7759, 7759, 7759, 7759
7759, 7759, 7759, 7759, 7759, 7759, 7759, 7759, 7759, 7759, 7759, 7759, 7759, 7759, 7759, 7759, 7759, 7759, 7759, 7759, 7759, 7759, 7759, 7759, 7759, 7759, 7759, 7759, 7759, 7759, 7759, 7759, 7759, 7759, 7759, 7759, 7759, 7759, 7759, 7759, 7759, 7759, 7759, 7759, 7759, 7759, 7759, 7759, 7759, 7759, 7759, 7759, 7759, 7759, 7759, 7759, 7759, 7759, 7759, 7759, 7759, 7759, 7759, 7759, 7759, 7759, 7759, 7759, 7759, 7759, 7759, 7759, 7759, 7759, 7759, 7759, 7759, 7759, 7759, 7759
7759, 7759, 7759, 7759, 7759, 7759, 7759, 7759, 7759, 7759, 7759, 7759, 7759, 7759, 7759, 7759, 7759, 7759, 7759, 7759, 7759, 7759, 7759, 7759, 7759, 7759, 7759, 7759, 7759, 7759, 7759, 7759, 7759, 7759, 7759, 7759, 7759, 7759, 7759, 7759, 7759, 7759, 7759, 7759, 7759, 7759, 7759, 7759, 7759, 7759, 7759, 7759, 7759, 7759, 7759, 7759, 7759, 7759, 7759, 7759, 7759, 7759, 7759, 7759, 7759, 7759, 7759, 7759, 7759, 7759, 7759, 7759, 7759, 7759, 7759, 7759, 7759, 7759, 7759, 7759
7759, 7759, 7759, 7759, 7759, 7759, 7759, 7759, 7759, 7759, 7759, 7759, 7759, 7759, 7759, 7759, 7759, 7759, 7759, 7759, 7759, 7759, 7759, 7759, 7759, 7759, 7759, 7759, 7759, 7759, 7759, 7759, 7759, 7759, 7759, 7759, 7759, 7759, 7759, 7759, 7759, 7759, 7759, 7759, 7759, 7759, 7759, 7759, 7759, 7759, 7759, 7759, 7759, 7759, 7759, 7759, 7759, 7759, 7759, 7759, 7759, 7759, 7759, 7759, 7759, 7759, 7759, 7759, 7759, 7759, 7759, 7759, 7759, 7759, 7759, 7759, 7759, 7759, 7759, 7759
7759, 7759, 7759, 7759, 7759, 7759, 7759, 7759, 7759, 7759, 7759, 7759, 7759, 7759, 7759, 7759, 7759, 7759, 7759, 7759, 7759, 7759, 7759, 7759, 7759, 7759, 7759, 7759, 7759, 7759, 7759, 7759, 7759, 7759, 7759, 7759, 7759, 7759, 7759, 7759, 7759, 7759, 7759, 7759, 7759, 7759, 7759, 7759, 7759, 7759, 7759, 7759, 7759, 7759, 7759, 7759, 7759, 7759, 7759, 7759, 7759, 7759, 7759, 7759, 7759, 7759, 7759, 7759, 7759, 7759, 7759, 7759, 7759, 7759, 7759, 7759, 7759, 7759, 7759, 7759
5684, 5685, 5364, 5365, 5366, 5367, 5368, 5369, 5370, 5371, 5372, 5373, 5374, 5375, 5376, 5377, 5378, 5379, 5380, 5381, 5382, 5383, 5384, 5385, 5386, 5387, 5388, 5389, 5390, 5391, 5392, 5393, 5394, 5395, 5396, 5397, 5398, 5399, 5400, 5401, 5402, 5403, 5404, 5405, 5406, 5407, 5408, 5409, 5410, 5411, 5412, 5413, 5414, 5415, 5416, 5417, 5418, 5419, 5420, 5421, 5422, 5423, 5424, 5425, 5426, 5427, 5428, 5429, 5430, 5431, 5432, 5686, 5687, 7759, 7759, 7759, 7759, 7759, 7759, 7759
5764, 5765, 5444, 5445, 5446, 5447, 5448, 5449, 5450, 5451, 5452, 5453, 5454, 5455, 5456, 5457, 5458, 5459, 5460, 5461, 5462, 5463, 5464, 5465, 5466, 5467, 5468, 5469, 5470, 5471, 5472, 5473, 5474, 5475, 5476, 5477, 5478, 5479, 5480, 5481, 5482, 5483, 5484, 5485, 5486, 5487, 5488, 5489, 5490, 5491, 5492, 5493, 5494, 5495, 5496, 5497, 5498, 5499, 5500, 5501, 5502, 5503, 5504, 5505, 5506, 5507, 5508, 5509, 5510, 5511, 5512, 5766, 5767, 7759, 7759, 7759, 7759, 7759, 7759, 7759
5360, 5361, 47, 48, 49, 50, 51, 52, 53, 7760, 7760, 0, 0, 0, 1020, 5040, 5040, 79, 80, 47, 48, 49, 50, 51, 52, 53, 131, 132, 133, 48, 49, 50, 51, 52, 53, 49, 50, 51, 52, 53, 47, 48, 49, 50, 51, 52, 53, 51, 52, 53, 7760, 7760, 47, 48, 49, 50, 51, 52, 53, 51, 52, 53, 7760, 7760, 47, 48, 49, 50, 51, 52, 53, 5362, 5363, 7759, 7759, 7759, 7759, 7759, 7759, 7759
5440, 5441, 127, 128, 129, 130, 131, 132, 133, 7760, 7760, 47, 48, 49, 50, 51, 52, 53, 49, 50, 51, 52, 53, 131, 132, 133, 211, 212, 213, 128, 129, 130, 131, 132, 133, 129, 130, 131, 132, 133, 127, 128, 129, 130, 131, 132, 133, 131, 132, 133, 7760, 7760, 127, 128, 129, 130, 131, 132, 133, 131, 132, 133, 7760, 7760, 127, 128, 129, 130, 131, 132, 133, 5442, 5443, 7759, 7759, 7759, 7759, 7759, 7759, 7759
5520, 5521, 207, 208, 209, 210, 211, 212, 213, 7760, 7760, 127, 128, 129, 130, 131, 132, 133, 129, 130, 131, 132, 133, 211, 212, 213, 291, 292, 293, 208, 209, 210, 211, 212, 213, 209, 210, 211, 212, 213, 207, 208, 209, 210, 211, 212, 213, 211, 212, 47, 48, 49, 50, 51, 52, 53, 211, 212, 213, 211, 212, 213, 49, 50, 207, 208, 209, 210, 211, 212, 213, 5522, 5523, 7759, 7759, 7759, 7759, 7759, 7759, 7759
5600, 5601, 287, 288, 289, 290, 291, 292, 293, 7760, 7760, 207, 208, 209, 210, 211, 212, 213, 209, 210, 211, 212, 213, 291, 292, 293, 371, 372, 373, 288, 289, 290, 291, 292, 293, 289, 290, 291, 292, 293, 287, 288, 289, 290, 291, 292, 293, 291, 292, 127, 128, 129, 130, 131, 132, 133, 291, 292, 293, 291, 292, 293, 53, 127, 287, 288, 289, 290, 291, 292, 293, 5602, 5603, 7759, 7759, 7759, 7759, 7759, 7759, 7759
5680, 5681, 367, 368, 369, 370, 371, 372, 373, 7760, 7760, 287, 288, 289, 290, 291, 292, 293, 289, 290, 291, 292, 293, 371, 372, 373, 451, 452, 453, 368, 369, 370, 371, 372, 373, 369, 370, 371, 372, 373, 367, 368, 369, 370, 371, 372, 373, 371, 372, 207, 208, 209, 210, 211, 212, 213, 371, 372, 373, 371, 372, 373, 130, 131, 367, 368, 369, 370, 371, 372, 373, 5682, 5683, 7759, 7759, 7759, 7759, 7759, 7759, 7759
5760, 5761, 447, 448, 449, 450, 451, 452, 453, 7760, 7760, 367, 368, 369, 370, 371, 372, 373, 369, 370, 371, 372, 373, 451, 452, 453, 531, 532, 533, 448, 449, 450, 451, 452, 453, 449, 450, 451, 452, 453, 447, 448, 449, 450, 451, 452, 453, 451, 452, 47, 48, 49, 50, 51, 52, 53, 451, 452, 453, 451, 452, 453, 207, 208, 447, 448, 449, 450, 451, 452, 453, 5762, 5763, 7759, 7759, 7759, 7759, 7759, 7759, 7759
5840, 5841, 527, 528, 529, 530, 531, 532, 533, 7760, 7760, 447, 448, 449, 450, 451, 452, 453, 449, 450, 451, 452, 453, 531, 532, 533, 611, 612, 613, 528, 529, 530, 531, 532, 533, 529, 530, 531, 532, 533, 527, 528, 47, 48, 49, 50, 51, 52, 53, 127, 128, 129, 130, 131, 132, 133, 531, 532, 533, 531, 532, 533, 211, 212, 527, 528, 529, 530, 531, 532, 533, 5842, 5843, 7759, 7759, 7759, 7759, 7759, 7759, 7759
5920, 5921, 607, 608, 609, 610, 611, 612, 613, 7760, 7760, 527, 528, 529, 530, 531, 532, 533, 529, 530, 531, 532, 533, 611, 612, 613, 691, 692, 693, 608, 609, 610, 611, 612, 613, 609, 610, 611, 612, 613, 7760, 7760, 127, 128, 129, 130, 131, 47, 48, 207, 208, 209, 210, 211, 212, 213, 298, 299, 300, 323, 213, 287, 288, 289, 607, 608, 609, 610, 611, 612, 613, 5922, 5923, 7759, 7759, 7759, 7759, 7759, 7759, 7759
6000, 6001, 687, 688, 689, 690, 691, 692, 693, 7760, 7760, 607, 608, 609, 610, 611, 612, 613, 609, 610, 611, 612, 613, 691, 692, 693, 771, 772, 773, 688, 689, 690, 691, 692, 693, 689, 690, 691, 692, 693, 7760, 7760, 207, 208, 209, 210, 211, 127, 128, 287, 288, 289, 290, 291, 292, 293, 362, 363, 7760, 7760, 290, 291, 292, 293, 687, 688, 689, 690, 691, 692, 693, 6002, 6003, 7759, 7759, 7759, 7759, 7759, 7759, 7759
6080, 6081, 767, 768, 769, 770, 771, 772, 773, 7760, 7760, 687, 688, 689, 690, 691, 692, 693, 689, 690, 691, 692, 693, 771, 772, 773, 851, 852, 853, 768, 769, 770, 771, 772, 773, 769, 770, 771, 772, 773, 7760, 7760, 47, 48, 49, 47, 48, 207, 208, 367, 368, 369, 370, 371, 372, 373, 106, 107, 7760, 7760, 367, 368, 369, 370, 767, 768, 769, 770, 771, 772, 773, 6082, 6083, 7759, 7759, 7759, 7759, 7759, 7759, 7759
6160, 6161, 847, 848, 849, 850, 851, 852, 853, 7760, 7760, 767, 768, 769, 770, 771, 772, 773, 769, 770, 47, 48, 49, 50, 51, 52, 53, 932, 933, 848, 849, 850, 851, 852, 853, 849, 850, 851, 852, 853, 7760, 7760, 127, 128, 129, 127, 128, 287, 288, 447, 448, 449, 450, 451, 452, 453, 7760, 7760, 47, 48, 49, 50, 373, 447, 847, 848, 849, 850, 851, 852, 853, 6162, 6163, 7759, 7759, 7759, 7759, 7759, 7759, 7759
6240, 6241, 927, 928, 929, 930, 931, 932, 933, 7760, 7760, 847, 848, 849, 850, 851, 852, 853, 849, 850, 127, 128, 129, 130, 131, 132, 133, 1012, 1013, 928, 929, 930, 931, 932, 933, 929, 930, 931, 932, 933, 7760, 7760, 207, 208, 209, 207, 208, 367, 368, 527, 528, 529, 530, 531, 532, 533, 7760, 7760, 51, 52, 53, 127, 450, 451, 927, 928, 929, 930, 931, 932, 933, 6242, 6243, 7759, 7759, 7759, 7759, 7759, 7759, 7759
6320, 6321, 1007, 1008, 1009, 1010, 1011, 1012, 1013, 7760, 7760, 927, 928, 929, 930, 931, 932, 933, 929, 930, 207, 208, 209, 210, 211, 212, 213, 52, 53, 48, 49, 50, 51, 52, 53, 1009, 1010, 1011, 1012, 1013, 7760, 7760, 287, 288, 289, 287, 288, 447, 448, 449, 450, 451, 452, 453, 7760, 7760, 47, 48, 128, 129, 130, 131, 49, 50, 1007, 1008, 1009, 1010, 1011, 1012, 1013, 6322, 6323, 7759, 7759, 7759, 7759, 7759, 7759, 7759
6400, 6401, 1087, 1088, 1089, 1090, 1091, 1092, 1093, 7760, 7760, 1007, 1008, 1009, 1010, 1011, 1012, 1013, 1009, 1010, 287, 288, 289, 290, 291, 292, 293, 132, 133, 128, 129, 130, 131, 132, 133, 1089, 1090, 1091, 1092, 1093, 7760, 7760, 367, 368, 369, 367, 368, 527, 528, 529, 530, 531, 532, 533, 7760, 7760, 51, 52, 132, 133, 207, 208, 53, 127, 1087, 1088, 1089, 1090, 1091, 1092, 1093, 6402, 6403, 7759, 7759, 7759, 7759, 7759, 7759, 7759
6480, 6481, 1167, 1168, 1169, 1170, 1171, 1172, 1173, 7760, 7760, 1087, 1088, 1089, 1090, 1091, 1092, 1093, 1089, 1090, 367, 368, 369, 370, 371, 372, 373, 212, 213, 208, 209, 210, 211, 212, 213, 1169, 1170, 1171, 1172, 1173, 7760, 7760, 447, 448, 449, 447, 448, 449, 450, 451, 452, 453, 7760, 7760, 47, 48, 49, 50, 51, 52, 53, 212, 130, 131, 1167, 1168, 1169, 1170, 1171, 1172, 1173, 6482, 6483, 7759, 7759, 7759, 7759, 7759, 7759, 7759
6560, 6561, 1247, 1248, 1249, 1250, 1251, 1252, 1253, 7760, 7760, 7760, 7760, 7760, 7760, 7760, 7760, 7760, 7760, 7760, 447, 448, 449, 450, 451, 452, 453, 292, 293, 288, 289, 290, 291, 292, 293, 1249, 1250, 1251, 1252, 1253, 7760, 7760, 527, 528, 529, 527, 528, 529, 530, 531, 532, 533, 7760, 7760, 127, 128, 129, 130, 131, 132, 133, 289, 207, 208, 1247, 1248, 1249, 1250, 1251, 1252, 1253, 6562, 6563, 7759, 7759, 7759, 7759, 7759, 7759, 7759
6640, 6641, 1327, 1328, 1329, 1330, 1331, 1332, 1333, 7760, 7760, 7760, 7760, 7760, 7760, 7760, 7760, 7760, 7760, 7760, 527, 528, 529, 530, 531, 532, 533, 372, 373, 368, 369, 370, 371, 372, 373, 1329, 1330, 1331, 1332, 1333, 7760, 7760, 7760, 7760, 7760, 7760, 7760, 7760, 7760, 7760, 7760, 7760, 47, 48, 207, 208, 209, 210, 211, 212, 213, 293, 211, 212, 1327, 1328, 1329, 1330, 1331, 1332, 1333, 6642, 6643, 7759, 7759, 7759, 7759, 7759, 7759, 7759
6720, 6721, 1407, 1408, 1409, 1410, 1411, 1412, 47, 48, 49, 50, 51, 47, 48, 49, 50, 51, 52, 53, 7760, 7760, 447, 448, 449, 450, 451, 452, 453, 448, 449, 450, 451, 452, 453, 1409, 1410, 1411, 1412, 1413, 7760, 7760, 7760, 7760, 7760, 7760, 7760, 7760, 7760, 7760, 7760, 7760, 127, 128, 287, 288, 289, 290, 291, 292, 293, 370, 288, 289, 1407, 1408, 1409, 1410, 1411, 1412, 1413, 6722, 6723, 7759, 7759, 7759, 7759, 7759, 7759, 7759
6800, 6801, 1487, 1488, 1489, 1490, 1491, 1492, 127, 128, 129, 130, 131, 127, 128, 129, 130, 131, 132, 133, 7760, 7760, 527, 528, 529, 530, 531, 532, 533, 528, 529, 530, 531, 532, 533, 1489, 1490, 1491, 1492, 1493, 7760, 7760, 138, 139, 140, 138, 139, 140, 138, 139, 47, 48, 207, 208, 367, 368, 369, 370, 371, 372, 373, 447, 292, 293, 1487, 1488, 1489, 1490, 1491, 1492, 1493, 6802, 6803, 7759, 7759, 7759, 7759, 7759, 7759, 7759
6880, 6881, 1567, 1568, 1569, 1570, 1571, 1572, 207, 208, 209, 210, 211, 207, 208, 209, 210, 211, 47, 48, 49, 50, 7760, 7760, 7760, 7760, 7760, 7760, 607, 608, 609, 610, 611, 612, 613, 1569, 1570, 47, 48, 49, 50, 51, 52, 53, 201, 201, 67, 68, 69, 70, 127, 128, 287, 288, 447, 448, 449, 450, 451, 452, 453, 451, 369, 370, 1567, 1568, 1569, 1570, 1571, 1572, 1573, 6882, 6883, 7759, 7759, 7759, 7759, 7759, 7759, 7759
6960, 6961, 1647, 1648, 1649, 1650, 1651, 1652, 287, 288, 289, 290, 291, 287, 288, 289, 290, 291, 51, 52, 53, 127, 7760, 7760, 7760, 7760, 7760, 7760, 687, 688, 689, 690, 691, 692, 693, 1649, 1650, 127, 128, 129, 130, 131, 132, 133, 201, 201, 99, 100, 101, 102, 207, 208, 367, 368, 527, 528, 529, 530, 531, 532, 533, 528, 373, 447, 1647, 1648, 1649, 1650, 1651, 1652, 1653, 6962, 6963, 7759, 7759, 7759, 7759, 7759, 7759, 7759
7040, 7041, 1727, 1728, 1729, 1730, 1731, 1732, 367, 47, 48, 49, 50, 51, 52, 53, 370, 371, 128, 129, 130, 131, 48, 49, 50, 7760, 7760, 368, 767, 768, 769, 770, 771, 772, 773, 1729, 1730, 207, 208, 209, 210, 211, 212, 213, 0, 201, 131, 132, 563, 563, 287, 288, 447, 448, 449, 450, 451, 452, 453, 530, 531, 532, 450, 451, 1727, 1728, 1729, 1730, 1731, 1732, 1733, 7042, 7043, 7759, 7759, 7759, 7759, 7759, 7759, 7759
7120, 7121, 1807, 1808, 1809, 1810, 1811, 1812, 447, 127, 128, 129, 130, 131, 132, 133, 450, 451, 132, 133, 207, 208, 52, 53, 127, 7760, 7760, 168, 847, 848, 849, 850, 851, 852, 853, 1809, 1810, 287, 288, 289, 290, 291, 292, 293, 108, 168, 163, 7760, 7760, 563, 367, 368, 527, 528, 529, 530, 531, 532, 533, 607, 608, 609, 527, 528, 1807, 1808, 1809, 1810, 1811, 1812, 1813, 7122, 7123, 7759, 7759, 7759, 7759, 7759, 7759, 7759
7200, 7201, 1887, 1888, 1889, 1890, 1891, 47, 48, 207, 208, 209, 210, 211, 212, 213, 530, 531, 532, 533, 5, 128, 129, 130, 47, 48, 49, 50, 927, 928, 929, 930, 931, 932, 933, 1889, 1890, 367, 368, 369, 370, 371, 372, 373, 140, 168, 195, 7760, 7760, 563, 447, 448, 207, 208, 209, 210, 211, 212, 213, 611, 612, 613, 531, 532, 1887, 1888, 1889, 1890, 1891, 1892, 1893, 7202, 7203, 7759, 7759, 7759, 7759, 7759, 7759, 7759
7280, 7281, 1967, 1968, 1969, 1970, 1971, 127, 128, 287, 288, 289, 290, 291, 292, 293, 610, 611, 612, 613, 143, 132, 133, 207, 51, 52, 53, 127, 1007, 1008, 1009, 1010, 1011, 1012, 1013, 1969, 1970, 447, 448, 449, 450, 451, 452, 453, 7760, 7760, 7760, 7760, 7760, 7760, 527, 528, 287, 288, 289, 290, 291, 292, 293, 688, 689, 690, 608, 609, 1967, 1968, 1969, 1970, 1971, 1972, 1973, 7282, 7283, 7759, 7759, 7759, 7759, 7759, 7759, 7759
7360, 7361, 2047, 2048, 2049, 2050, 2051, 207, 208, 367, 368, 369, 370, 371, 372, 373, 690, 691, 692, 693, 47, 48, 49, 50, 128, 129, 130, 131, 1087, 1088, 1089, 1090, 1091, 1092, 1093, 2049, 2050, 527, 528, 529, 530, 531, 532, 533, 7760, 7760, 7760, 7760, 7760, 7760, 251, 251, 367, 368, 369, 370, 371, 372, 373, 692, 693, 767, 612, 613, 2047, 2048, 2049, 2050, 2051, 2052, 2053, 7362, 7363, 7759, 7759, 7759, 7759, 7759, 7759, 7759
7440, 7441, 2127, 2128, 2129, 2130, 2131, 287, 288, 447, 448, 449, 450, 451, 452, 453, 770, 771, 772, 773, 51, 52, 53, 127, 132, 133, 207, 208, 109, 110, 111, 410, 410, 2127, 2128, 2129, 2130, 607, 608, 609, 610, 611, 47, 48, 49, 50, 51, 52, 53, 149, 7760, 7760, 447, 448, 449, 450, 451, 452, 453, 690, 687, 688, 689, 690, 2127, 2128, 2129, 2130, 2131, 2132, 2133, 7442, 7443, 7759, 7759, 7759, 7759, 7759, 7759, 7759
7520, 7521, 2207, 2208, 2209, 2210, 2211, 367, 368, 527, 528, 529, 530, 531, 532, 533, 850, 851, 852, 853, 128, 129, 130, 131, 128, 129, 130, 131, 141, 142, 143, 410, 410, 2207, 2208, 2209, 2210, 687, 688, 689, 690, 691, 127, 128, 129, 130, 131, 132, 133, 181, 7760, 7760, 527, 528, 529, 530, 531, 532, 533, 767, 691, 692, 693, 767, 2207, 2208, 2209, 2210, 2211, 2212, 2213, 7522, 7523, 7759, 7759, 7759, 7759, 7759, 7759, 7759
7600, 7601, 2287, 2288, 2289, 2290, 2291, 447, 448, 607, 608, 609, 610, 611, 612, 613, 930, 931, 932, 933, 132, 133, 207, 208, 132, 133, 207, 208, 173, 174, 175, 7760, 7760, 2287, 2288, 2289, 2290, 767, 768, 47, 48, 49, 50, 51, 52, 53, 48, 49, 50, 51, 52, 53, 7760, 7760, 7760, 7760, 7760, 7760, 7760, 7760, 7760, 7760, 7760, 7760, 2287, 2288, 2289, 2290, 2291, 2292, 2293, 7602, 7603, 7759, 7759, 7759, 7759, 7759, 7759, 7759
7680, 7681, 2367, 2368, 2369, 47, 48, 49, 50, 51, 52, 53, 690, 691, 692, 693, 1010, 1011, 1012, 1013, 7760, 7760, 7760, 7760, 7760, 7760, 7760, 7760, 7760, 7760, 7760, 7760, 7760, 2367, 2368, 2369, 2370, 847, 47, 127, 128, 129, 130, 131, 132, 133, 48, 49, 50, 51, 52, 53, 7760, 7760, 7760, 7760, 7760, 7760, 7760, 7760, 7760, 7760, 7760, 7760, 2367, 2368, 2369, 2370, 2371, 2372, 2373, 7682, 7683, 7759, 7759, 7759, 7759, 7759, 7759, 7759
5360, 5361, 2447, 2448, 2449, 127, 128, 129, 130, 131, 132, 133, 770, 771, 772, 773, 1090, 1091, 1092, 1093, 7760, 7760, 7760, 7760, 7760, 7760, 7760, 7760, 7760, 7760, 7760, 7760, 7760, 2447, 2448, 2449, 2450, 927, 127, 207, 208, 209, 210, 211, 212, 213, 128, 129, 130, 131, 132, 133, 47, 48, 49, 50, 51, 52, 53, 51, 52, 53, 7760, 7760, 2447, 2448, 2449, 2450, 2451, 2452, 2453, 5362, 5363, 7759, 7759, 7759, 7759, 7759, 7759, 7759
5440, 5441, 2527, 2528, 2529, 207, 208, 209, 210, 211, 212, 213, 850, 851, 852, 853, 133, 134, 7760, 7760, 47, 48, 49, 50, 51, 52, 53, 50, 51, 52, 53, 7760, 7760, 2527, 2528, 2529, 2530, 1007, 207, 287, 288, 289, 290, 291, 292, 293, 208, 209, 210, 211, 212, 213, 127, 128, 129, 130, 131, 132, 133, 131, 132, 133, 7760, 7760, 2527, 2528, 2529, 2530, 2531, 2532, 2533, 5442, 5443, 7759, 7759, 7759, 7759, 7759, 7759, 7759
5520, 5521, 2607, 2608, 2609, 287, 288, 289, 290, 291, 292, 293, 930, 931, 932, 933, 136, 137, 7760, 7760, 127, 128, 129, 130, 131, 132, 133, 130, 131, 132, 133, 7760, 7760, 2607, 2608, 2609, 2610, 1087, 287, 367, 368, 369, 370, 371, 372, 373, 288, 289, 290, 291, 292, 293, 207, 208, 209, 210, 211, 212, 213, 211, 212, 213, 7760, 7760, 2607, 2608, 2609, 2610, 2611, 2612, 2613, 5522, 5523, 7759, 7759, 7759, 7759, 7759, 7759, 7759
5600, 5601, 2687, 2688, 2689, 367, 368, 369, 370, 371, 372, 373, 1010, 1011, 1012, 1013, 7760, 7760, 47, 48, 49, 50, 209, 210, 211, 212, 213, 210, 211, 212, 213, 7760, 7760, 2687, 2688, 2689, 2690, 1167, 367, 447, 448, 449, 450, 451, 452, 453, 368, 369, 370, 371, 372, 373, 287, 288, 289, 290, 291, 292, 293, 291, 292, 293, 7760, 7760, 2687, 2688, 2689, 2690, 2691, 2692, 2693, 5602, 5603, 7759, 7759, 7759, 7759, 7759, 7759, 7759
5680, 5681, 2767, 2768, 2769, 447, 448, 449, 450, 451, 452, 453, 1090, 1091, 1092, 1093, 7760, 7760, 51, 52, 53, 127, 289, 290, 291, 292, 293, 290, 291, 292, 293, 7760, 7760, 2767, 2768, 2769, 2770, 1247, 447, 527, 528, 529, 530, 531, 532, 533, 448, 449, 450, 451, 452, 453, 367, 368, 369, 370, 371, 372, 373, 371, 372, 373, 7760, 7760, 2767, 2768, 2769, 2770, 2771, 2772, 2773, 5682, 5683, 7759, 7759, 7759, 7759, 7759, 7759, 7759
5760, 5761, 2847, 2848, 2849, 527, 528, 529, 530, 531, 532, 533, 1012, 1013, 7760, 7760, 47, 48, 49, 50, 130, 131, 369, 370, 371, 372, 373, 370, 371, 372, 373, 7760, 7760, 2847, 2848, 2849, 2850, 2851, 527, 607, 608, 609, 610, 611, 612, 613, 528, 529, 530, 531, 532, 533, 447, 448, 449, 450, 451, 452, 453, 451, 452, 453, 7760, 7760, 2847, 2848, 2849, 2850, 2851, 2852, 2853, 5762, 5763, 7759, 7759, 7759, 7759, 7759, 7759, 7759
5840, 5841, 2927, 2928, 2929, 607, 608, 609, 610, 611, 612, 613, 1092, 1093, 7760, 7760, 51, 52, 53, 127, 207, 208, 449, 450, 451, 452, 453, 450, 451, 452, 453, 7760, 7760, 2927, 2928, 2929, 2930, 2931, 607, 687, 688, 689, 690, 691, 692, 693, 608, 609, 610, 611, 612, 613, 527, 528, 529, 530, 531, 532, 533, 531, 532, 533, 7760, 7760, 2927, 2928, 2929, 2930, 2931, 2932, 2933, 5842, 5843, 7759, 7759, 7759, 7759, 7759, 7759, 7759
5920, 5921, 3007, 3008, 3009, 687, 688, 689, 690, 691, 692, 693, 7760, 7760, 47, 48, 49, 50, 130, 131, 527, 528, 529, 530, 531, 532, 533, 530, 531, 532, 533, 184, 184, 3007, 3008, 3009, 3010, 3011, 687, 767, 768, 769, 770, 771, 772, 773, 688, 689, 690, 691, 692, 693, 607, 608, 609, 610, 611, 612, 613, 611, 612, 613, 7760, 7760, 3007, 3008, 3009, 3010, 3011, 3012, 3013, 5922, 5923, 7759, 7759, 7759, 7759, 7759, 7759, 7759
6000, 6001, 3087, 3088, 3089, 767, 768, 769, 770, 771, 772, 773, 7760, 7760, 51, 52, 53, 127, 49, 50, 607, 608, 609, 610, 611, 612, 613, 610, 611, 612, 613, 184, 184, 3087, 3088, 3089, 3090, 3091, 767, 847, 848, 849, 850, 851, 852, 853, 768, 769, 770, 771, 772, 773, 687, 688, 689, 690, 691, 692, 693, 691, 692, 693, 7760, 7760, 3087, 3088, 3089, 3090, 3091, 3092, 3093, 6002, 6003, 7759, 7759, 7759, 7759, 7759, 7759, 7759
6080, 6081, 3167, 3168, 3169, 847, 848, 849, 850, 851, 852, 47, 48, 49, 50, 129, 130, 131, 53, 127, 687, 688, 689, 690, 691, 692, 693, 690, 691, 692, 693, 184, 184, 3167, 3168, 3169, 3170, 3171, 847, 927, 928, 929, 930, 931, 932, 933, 848, 849, 850, 851, 852, 853, 767, 768, 769, 770, 771, 772, 773, 771, 772, 773, 7760, 7760, 3167, 3168, 3169, 3170, 3171, 3172, 3173, 6082, 6083, 7759, 7759, 7759, 7759, 7759, 7759, 7759
6160, 6161, 3247, 3248, 3249, 927, 928, 929, 930, 931, 932, 51, 52, 53, 127, 133, 207, 208, 49, 50, 767, 768, 769, 770, 771, 772, 773, 770, 771, 772, 773, 184, 184, 3247, 3248, 3249, 3250, 3251, 927, 1007, 1008, 1009, 1010, 1011, 1012, 1013, 928, 929, 930, 931, 932, 933, 847, 848, 849, 850, 851, 852, 853, 851, 852, 853, 7760, 7760, 3247, 3248, 3249, 3250, 3251, 3252, 3253, 6162, 6163, 7759, 7759, 7759, 7759, 7759, 7759, 7759
6240, 6241, 3327, 3328, 3329, 1007, 1008, 1009, 1010, 1011, 1012, 128, 47, 48, 49, 50, 51, 52, 53, 127, 847, 848, 849, 850, 851, 852, 853, 850, 851, 852, 853, 184, 184, 3327, 3328, 3329, 3330, 3331, 1007, 1087, 1088, 1089, 1090, 1091, 1092, 1093, 1008, 1009, 1010, 1011, 1012, 1013, 927, 928, 929, 930, 931, 932, 933, 931, 932, 933, 7760, 7760, 3327, 3328, 3329, 3330, 3331, 3332, 3333, 6242, 6243, 7759, 7759, 7759, 7759, 7759, 7759, 7759
6320, 6321, 3407, 3408, 3409, 1087, 1088, 1089, 1090, 1091, 1092, 132, 51, 52, 53, 127, 128, 129, 130, 131, 927, 928, 929, 930, 931, 932, 933, 930, 931, 932, 933, 184, 184, 3407, 3408, 3409, 3410, 3411, 1087, 1088, 1089, 1090, 1091, 1092, 1093, 1087, 1088, 1089, 1090, 1091, 1092, 1093, 1007, 1008, 1009, 1010, 1011, 1012, 1013, 1011, 1012, 1013, 7760, 7760, 3407, 3408, 3409, 3410, 3411, 3412, 3413, 6322, 6323, 7759, 7759, 7759, 7759, 7759, 7759, 7759
6400, 6401, 480, 481, 482, 312, 312, 7760, 7760, 487, 488, 489, 128, 129, 130, 131, 132, 133, 207, 208, 1007, 1008, 1009, 1010, 1011, 1012, 1013, 1010, 1011, 1012, 1013, 184, 184, 3487, 3488, 3489, 3490, 3491, 1167, 1168, 1169, 1170, 1171, 1172, 1173, 1167, 1168, 1169, 1170, 1171, 1172, 1173, 1087, 1088, 1089, 1090, 1091, 1092, 1093, 1091, 1092, 1093, 7760, 7760, 3487, 3488, 3489, 3490, 3491, 3492, 3493, 6402, 6403, 7759, 7759, 7759, 7759, 7759, 7759, 7759
6480, 6481, 512, 513, 514, 515, 516, 7760, 7760, 519, 520, 521, 132, 133, 207, 208, 312, 358, 359, 360, 1087, 1088, 1089, 1090, 1091, 1092, 1093, 1090, 1091, 1092, 1093, 184, 184, 3567, 3568, 3569, 3570, 3571, 1247, 1248, 1249, 1250, 1251, 1252, 1253, 1247, 1248, 1249, 1250, 1251, 1252, 1253, 208, 208, 208, 208, 5040, 5040, 208, 208, 208, 208, 7760, 7760, 3567, 3568, 3569, 3570, 3571, 3572, 3573, 6482, 6483, 7759, 7759, 7759, 7759, 7759, 7759, 7759
5844, 5845, 5524, 5525, 5526, 5527, 5528, 5529, 5530, 5531, 5532, 5533, 5534, 5535, 5536, 5537, 5538, 5539, 5540, 5541, 5542, 5543, 5544, 5545, 5546, 5547, 5548, 5549, 5550, 5551, 5552, 5553, 5554, 5555, 5556, 5557, 5558, 5559, 5560, 5561, 5562, 5563, 5564, 5565, 5566, 5567, 5568, 5569, 5570, 5571, 5572, 5573, 5574, 5575, 5576, 5577, 5578, 5579, 5580, 5581, 5582, 5583, 5584, 5585, 5586, 5587, 5588, 5589, 5590, 5591, 5592, 5846, 5847, 7759, 7759, 7759, 7759, 7759, 7759, 7759
5924, 5925, 5604, 5605, 5606, 5607, 5608, 5609, 5610, 5611, 5612, 5613, 5614, 5615, 5616, 5617, 5618, 5619, 5620, 5621, 5622, 5623, 5624, 5625, 5626, 5627, 5628, 5629, 5630, 5631, 5632, 5633, 5634, 5635, 5636, 5637, 5638, 5639, 5640, 5641, 5642, 5643, 5644, 5645, 5646, 5647, 5648, 5649, 5650, 5651, 5652, 5653, 5654, 5655, 5656, 5657, 5658, 5659, 5660, 5661, 5662, 5663, 5664, 5665, 5666, 5667, 5668, 5669, 5670, 5671, 5672, 5926, 5927, 7759, 7759, 7759, 7759, 7759, 7759, 7759
7759, 7759, 7759, 7759, 7759, 7759, 7759, 7759, 7759, 7759, 7759, 7759, 7759, 7759, 7759, 7759, 7759, 7759, 7759, 7759, 7759, 7759, 7759, 7759, 7759, 7759, 7759, 7759, 7759, 7759, 7759, 7759, 7759, 7759, 7759, 7759, 7759, 7759, 7759, 7759, 7759, 7759, 7759, 7759, 7759, 7759, 7759, 7759, 7759, 7759, 7759, 7759, 7759, 7759, 7759, 7759, 7759, 7759, 7759, 7759, 7759, 7759, 7759, 7759, 7759, 7759, 7759, 7759, 7759, 7759, 7759, 7759, 7759, 7759, 7759, 7759, 7759, 7759, 7759, 7759
7759, 7759, 7759, 7759, 7759, 7759, 7759, 7759, 7759, 7759, 7759, 7759, 7759, 7759, 7759, 7759, 7759, 7759, 7759, 7759, 7759, 7759, 7759, 7759, 7759, 7759, 7759, 7759, 7759, 7759, 7759, 7759, 7759, 7759, 7759, 7759, 7759, 7759, 7759, 7759, 7759, 7759, 7759, 7759, 7759, 7759, 7759, 7759, 7759, 7759, 7759, 7759, 7759, 7759, 7759, 7759, 7759, 7759, 7759, 7759, 7759, 7759, 7759, 7759, 7759, 7759, 7759, 7759, 7759, 7759, 7759, 7759, 7759, 7759, 7759, 7759, 7759, 7759, 7759, 7759
7759, 7759, 7759, 7759, 7759, 7759, 7759, 7759, 7759, 7759, 7759, 7759, 7759, 7759, 7759, 7759, 7759, 7759, 7759, 7759, 7759, 7759, 7759, 7759, 7759, 7759, 7759, 7759, 7759, 7759, 7759, 7759, 7759, 7759, 7759, 7759, 7759, 7759, 7759, 7759, 7759, 7759, 7759, 7759, 7759, 7759, 7759, 7759, 7759, 7759, 7759, 7759, 7759, 7759, 7759, 7759, 7759, 7759, 7759, 7759, 7759, 7759, 7759, 7759, 7759, 7759, 7759, 7759, 7759, 7759, 7759, 7759, 7759, 7759, 7759, 7759, 7759, 7759, 7759, 7759
