1121, 1121, 1121, 1121, 1121, 1121, 1121, 1121, 1121, 1121, 1121, 1121, 1121, 1121, 1121, 1121, 1121, 1121, 1121, 1121, 1121, 1121, 1121, 1121, 1121, 1121, 1121, 1121, 1121, 1121, 1121, 1121, 1121, 1121, 1121, 1121, 1121, 1121, 1121, 1121, 1121, 1121, 1121, 1121, 1121, 1121, 1121, 1121, 1121, 1121, 1121, 1121, 1121, 1121, 1121, 1121, 1121, 1121, 1121, 1121, 1121, 1121, 1121, 1121, 1121, 1121, 1121, 1121, 1121, 1121, 1121, 1121, 1121, 1121, 1121, 1121, 1121, 1121, 1121, 1121
1121, 1121, 1121, 1121, 1121, 1121, 1121, 1121, 1121, 1121, 1121, 1121, 1121, 1121, 1121, 1121, 1121, 1121, 1121, 1121, 1121, 1121, 1121, 1121, 1121, 1121, 1121, 1121, 1121, 1121, 1121, 1121, 1121, 1121, 1121, 1121, 1121, 1121, 1121, 1121, 1121, 1121, 1121, 1121, 1121, 1121, 1121, 1121, 1121, 1121, 1121, 1121, 1121, 1121, 1121, 1121, 1121, 1121, 1121, 1121, 1121, 1121, 1121, 1121, 1121, 1121, 1121, 1121, 1121, 1121, 1121, 1121, 1121, 1121, 1121, 1121, 1121, 1121, 1121, 1121
1121, 1121, 1121, 1121, 1121, 1121, 1121, 1121, 1121, 1121, 1121, 1121, 1121, 1121, 1121, 1121, 1121, 1121, 1121, 1121, 1121, 1121, 1121, 1121, 1121, 1121, 1121, 1121, 1121, 1121, 1121, 1121, 1121, 1121, 1121, 1121, 1121, 1121, 1121, 1121, 1121, 1121, 1121, 1121, 1121, 1121, 1121, 1121, 1121, 1121, 1121, 1121, 1121, 1121, 1121, 1121, 1121, 1121, 1121, 1121, 1121, 1121, 1121, 1121, 1121, 1121, 1121, 1121, 1121, 1121, 1121, 1121, 1121, 1121, 1121, 1121, 1121, 1121, 1121, 1121
1121, 1121, 1121, 1121, 1121, 1121, 1121, 1121, 1121, 1121, 1121, 1121, 1121, 1121, 1121, 1121, 1121, 1121, 1121, 1121, 1121, 1121, 1121, 1121, 1121, 1121, 1121, 1121, 1121, 1121, 1121, 1121, 1121, 1121, 1121, 1121, 1121, 1121, 1121, 1121, 1121, 1121, 1121, 1121, 1121, 1121, 1121, 1121, 1121, 1121, 1121, 1121, 1121, 1121, 1121, 1121, 1121, 1121, 1121, 1121, 1121, 1121, 1121, 1121, 1121, 1121, 1121, 1121, 1121, 1121, 1121, 1121, 1121, 1121, 1121, 1121, 1121, 1121, 1121, 1121
1168, 1168, 1168, 1168, 1168, 1168, 1168, 1168, 1168, 1168, 1168, 1168, 1168, 1168, 1168, 1168, 1168, 1168, 1168, 1168, 1168, 1168, 1168, 1168, 1168, 1168, 1168, 1168, 1168, 1168, 1168, 1168, 1168, 1168, 1168, 1168, 1168, 1168, 1168, 1168, 1168, 1168, 1165, 1165, 1165, 1165, 1165, 1165, 1165, 1165, 1165, 1165, 1165, 1165, 1165, 1165, 1165, 1165, 1165, 1165, 1165, 1165, 1165, 1165, 1165, 1165, 1165, 1165, 1165, 1165, 1165, 1165, 1165, 1165, 1165, 1165, 1165, 1165, 1165, 1165
1168, 1168, 1168, 1168, 1168, 1168, 1168, 1168, 1168, 1168, 1168, 1168, 1168, 1168, 1168, 1168, 1168, 1168, 1168, 1168, 1168, 1168, 1168, 1168, 1168, 1168, 1168, 1168, 1168, 1168, 1168, 1168, 1168, 1168, 1168, 1168, 1168, 1168, 1168, 1168, 1168, 1168, 1165, 1165, 1165, 1165, 1165, 1165, 1165, 1165, 1165, 1165, 1165, 1165, 1165, 1165, 1165, 1165, 1165, 1165, 1165, 1165, 1165, 1165, 1165, 1165, 1165, 1165, 1165, 1165, 1165, 1165, 1165, 1165, 1165, 1165, 1165, 1165, 1165, 1165
1168, 1168, 1168, 1168, 1168, 1168, 1168, 1168, 1168, 1168, 1168, 1168, 1168, 1168, 1168, 1168, 1168, 1168, 1168, 1168, 1168, 1168, 1168, 1168, 1168, 1168, 1168, 1168, 1168, 1168, 1168, 1168, 1168, 1168, 1168, 1168, 1168, 1168, 1168, 1168, 1168, 1168, 1165, 1165, 1165, 1165, 1165, 1165, 1165, 1165, 1165, 1165, 1165, 1165, 1165, 1165, 1165, 1165, 1165, 1165, 1165, 1165, 1165, 1165, 1165, 1165, 1165, 1165, 1165, 1165, 1165, 1165, 1165, 1165, 1165, 1165, 1165, 1165, 1165, 1165
1168, 1168, 1168, 1168, 1168, 1168, 1168, 1168, 1168, 1168, 1168, 1168, 1168, 1168, 1168, 1168, 1168, 1168, 1168, 1168, 1168, 1168, 1168, 1168, 1168, 1168, 1168, 1168, 1168, 1168, 1168, 1168, 1168, 1168, 1168, 1168, 1168, 1168, 1168, 1168, 1168, 1168, 1165, 1165, 1165, 1165, 1165, 1165, 1165, 1165, 1165, 1165, 1165, 1165, 1165, 1165, 1165, 1165, 1165, 1165, 1165, 1165, 1165, 1165, 1165, 1139, 1165, 1165, 1165, 1165, 1165, 1165, 1165, 1165, 1165, 1165, 1165, 1165, 1165, 1165
1168, 1168, 1168, 1168, 1168, 1168, 1168, 1168, 1168, 1168, 1168, 1168, 1168, 1168, 1168, 1168, 1168, 1168, 1168, 1168, 1168, 1168, 1168, 1168, 1168, 1168, 1168, 1168, 1168, 1168, 1168, 1168, 1168, 1168, 1168, 1168, 1168, 1168, 1168, 1168, 1168, 1168, 1165, 1165, 1165, 1165, 1165, 1165, 1165, 1165, 1165, 1165, 1165, 1165, 1165, 1165, 1165, 1165, 1165, 1165, 1165, 1165, 1165, 1165, 1165, 1139, 1165, 1165, 1165, 1165, 1165, 1165, 1165, 1165, 1165, 1165, 1165, 1165, 1165, 1165
1168, 1168, 1168, 1168, 1168, 1168, 1168, 1168, 1168, 1168, 1168, 1168, 1168, 1168, 1168, 1168, 1168, 1168, 1168, 1168, 1089, 1093, 1093, 1093, 1093, 1093, 1093, 1093, 1093, 1093, 1093, 1093, 1093, 1093, 1093, 1093, 1093, 1093, 1093, 1093, 1093, 1093, 1094, 1095, 1096, 1093, 1094, 1095, 1096, 1093, 1094, 1095, 1096, 1093, 1094, 1095, 1096, 1093, 1094, 1095, 1096, 1093, 1094, 1095, 1096, 1100, 1165, 1165, 1165, 1165, 1165, 1165, 1165, 1165, 1165, 1165, 1165, 1165, 1165, 1165
1168, 1168, 1168, 1168, 1168, 1168, 1168, 1168, 1168, 1168, 1168, 1168, 1168, 1168, 1168, 1168, 1168, 1168, 1168, 1168, 1103, 110, 110, 102, 115, 116, 117, 118, 119, 265, 266, 267, 268, 269, 0, 64, 65, 66, 265, 266, 267, 268, 1052, 1052, 359, 360, 361, 1053, 1053, 269, 147, 148, 149, 150, 115, 115, 147, 148, 149, 150, 147, 148, 149, 150, 245, 1138, 1165, 1165, 1165, 1165, 1165, 1165, 1165, 1165, 1165, 1165, 1165, 1165, 1165, 1165
1168, 1168, 1168, 1168, 1168, 1168, 1168, 1168, 1168, 1168, 1168, 1168, 1168, 1168, 1168, 1168, 1168, 1168, 1168, 1168, 1135, 1053, 1053, 134, 147, 148, 149, 150, 151, 297, 298, 299, 300, 301, 0, 96, 97, 98, 297, 298, 299, 300, 301, 180, 391, 392, 393, 1053, 1053, 301, 179, 180, 181, 182, 168, 169, 179, 180, 181, 182, 179, 180, 181, 1053, 1053, 1074, 1165, 1165, 1165, 1165, 1165, 1165, 1165, 1165, 1165, 1165, 1165, 1165, 1165, 1165
1168, 1168, 1168, 1168, 1168, 1168, 1168, 1168, 1168, 1168, 1168, 1168, 1168, 1168, 1168, 1168, 1168, 1168, 1168, 1168, 1071, 1053, 1053, 166, 179, 180, 181, 182, 183, 329, 330, 331, 332, 333, 134, 128, 129, 130, 329, 330, 331, 332, 333, 212, 423, 424, 425, 426, 427, 333, 211, 212, 213, 214, 200, 201, 211, 212, 213, 214, 211, 212, 213, 1053, 1053, 1106, 1165, 1165, 1165, 1165, 1165, 1165, 1165, 1165, 1165, 1165, 1165, 1165, 1165, 1165
1168, 1168, 1168, 1168, 1168, 1168, 1168, 1168, 1168, 1168, 1168, 1168, 1168, 1168, 1168, 1168, 1168, 1168, 1168, 1168, 1103, 206, 206, 198, 211, 212, 213, 214, 215, 361, 362, 363, 364, 365, 166, 160, 161, 162, 361, 362, 363, 364, 365, 244, 455, 456, 457, 458, 459, 365, 243, 244, 245, 246, 232, 233, 243, 244, 245, 246, 243, 244, 245, 1053, 1053, 1138, 1165, 1165, 1165, 1165, 1165, 1165, 1165, 1165, 1165, 1165, 1165, 1165, 1165, 1165
1168, 1168, 1168, 1168, 1168, 1168, 1168, 1168, 1168, 1168, 1168, 1168, 1168, 1168, 1168, 1168, 1168, 1168, 1168, 1168, 1135, 238, 238, 230, 243, 244, 245, 246, 247, 393, 394, 395, 396, 397, 198, 192, 193, 194, 393, 394, 395, 396, 397, 171, 487, 488, 489, 490, 491, 397, 181, 182, 183, 264, 264, 265, 266, 267, 268, 269, 270, 271, 272, 1053, 1053, 1074, 1165, 1165, 1165, 1165, 1165, 1165, 1165, 1165, 1165, 1165, 1165, 1165, 1165, 1165
1168, 1168, 1168, 1168, 1168, 1168, 1168, 1168, 1168, 1168, 1168, 1168, 1168, 1168, 1168, 1168, 1168, 1168, 1168, 1168, 1071, 270, 270, 262, 263, 264, 265, 266, 267, 268, 269, 270, 271, 208, 230, 224, 225, 226, 227, 213, 200, 201, 202, 203, 204, 205, 206, 207, 208, 209, 235, 236, 237, 296, 296, 297, 298, 299, 300, 301, 302, 303, 304, 1053, 1053, 1106, 1165, 1165, 1165, 1165, 1165, 1165, 1165, 1165, 1165, 1165, 1165, 1165, 1165, 1165
1168, 1168, 1168, 1168, 1168, 1168, 1168, 1168, 1168, 1168, 1168, 1168, 1168, 1168, 1168, 1168, 1168, 1168, 1168, 1168, 1103, 110, 110, 294, 295, 296, 297, 298, 299, 300, 301, 302, 303, 240, 262, 256, 257, 258, 259, 267, 232, 233, 234, 235, 236, 237, 238, 239, 240, 241, 272, 273, 274, 328, 328, 329, 330, 331, 332, 333, 334, 335, 336, 1053, 1053, 1138, 1165, 1165, 1165, 1165, 1165, 1165, 1165, 1165, 1165, 1165, 1165, 1165, 1165, 1165
1168, 1168, 1168, 1168, 1168, 1168, 1168, 1168, 1168, 1168, 1168, 1168, 1168, 1168, 1168, 1168, 1168, 1168, 1168, 1168, 1135, 142, 142, 326, 327, 328, 329, 330, 331, 332, 333, 334, 335, 272, 294, 288, 289, 290, 291, 304, 264, 265, 266, 267, 268, 269, 270, 271, 272, 273, 309, 310, 311, 360, 360, 361, 362, 363, 364, 365, 265, 266, 267, 1053, 1053, 1074, 1165, 1165, 1165, 1165, 1165, 1165, 1165, 1165, 1165, 1165, 1165, 1165, 1165, 1165
1168, 1168, 1168, 1168, 1168, 1168, 1168, 1168, 1168, 1168, 1168, 1168, 1168, 1168, 1168, 1168, 1168, 1168, 1168, 1168, 1071, 174, 174, 358, 359, 360, 361, 362, 363, 364, 365, 366, 367, 304, 326, 320, 321, 322, 323, 341, 296, 297, 298, 299, 300, 301, 302, 303, 304, 305, 363, 364, 365, 392, 392, 393, 394, 395, 396, 397, 297, 298, 299, 1053, 1053, 1106, 1165, 1165, 1165, 1165, 1165, 1165, 1165, 1165, 1165, 1165, 1165, 1165, 1165, 1165
1168, 1168, 1168, 1168, 1168, 1168, 1168, 1168, 1168, 1168, 1168, 1168, 1168, 1168, 1168, 1168, 1168, 1168, 1168, 1168, 1103, 206, 206, 390, 391, 392, 393, 394, 395, 396, 397, 398, 399, 336, 358, 352, 353, 354, 355, 395, 328, 329, 330, 331, 332, 333, 334, 335, 336, 337, 400, 401, 402, 424, 424, 425, 426, 427, 428, 429, 329, 330, 331, 1053, 1053, 1074, 1165, 1165, 1165, 1165, 1165, 1165, 1165, 1165, 1165, 1165, 1165, 1165, 1165, 1165
1168, 1168, 1168, 1168, 1168, 1168, 1168, 1168, 1168, 1168, 1168, 1168, 1168, 1168, 1168, 1168, 1168, 1168, 1168, 1168, 1135, 238, 238, 422, 423, 424, 425, 426, 427, 428, 429, 430, 431, 368, 390, 384, 385, 386, 387, 432, 360, 361, 362, 363, 364, 365, 366, 367, 368, 369, 437, 438, 439, 456, 456, 457, 458, 459, 460, 461, 265, 266, 267, 1053, 1053, 1106, 1165, 1165, 1165, 1165, 1165, 1165, 1165, 1165, 1165, 1165, 1165, 1165, 1165, 1165
1168, 1168, 1168, 1168, 1168, 1168, 1168, 1168, 1168, 1168, 1168, 1168, 1168, 1168, 1168, 1168, 1168, 1168, 1168, 1168, 1071, 265, 266, 267, 268, 269, 457, 458, 459, 460, 461, 462, 463, 145, 422, 416, 417, 418, 419, 469, 392, 393, 394, 395, 396, 397, 398, 399, 400, 401, 11, 12, 13, 14, 15, 16, 17, 18, 19, 20, 297, 298, 299, 1053, 1053, 1138, 1165, 1165, 1165, 1165, 1165, 1165, 1165, 1165, 1165, 1165, 1165, 1165, 1165, 1165
1168, 1168, 1168, 1168, 1168, 1168, 1168, 1168, 1168, 1168, 1168, 1168, 1168, 1168, 1168, 1168, 1168, 1168, 1168, 1168, 1103, 297, 298, 299, 300, 301, 489, 490, 491, 492, 493, 494, 495, 177, 454, 448, 449, 450, 451, 43, 424, 425, 426, 427, 428, 429, 430, 431, 432, 433, 48, 49, 50, 51, 52, 53, 54, 55, 56, 57, 265, 266, 267, 1053, 1053, 1074, 1165, 1165, 1165, 1165, 1165, 1165, 1165, 1165, 1165, 1165, 1165, 1165, 1165, 1165
1168, 1168, 1168, 1168, 1168, 1168, 1168, 1168, 1168, 1168, 1168, 1168, 1168, 1168, 1168, 1168, 1168, 1168, 1168, 1168, 1135, 329, 330, 331, 332, 333, 41, 203, 204, 205, 206, 207, 208, 209, 486, 480, 481, 482, 483, 80, 456, 457, 458, 459, 460, 461, 462, 463, 464, 465, 85, 86, 87, 88, 89, 107, 108, 109, 110, 111, 297, 298, 299, 1053, 1053, 1106, 1165, 1165, 1165, 1165, 1165, 1165, 1165, 1165, 1165, 1165, 1165, 1165, 1165, 1165
1168, 1168, 1168, 1168, 1168, 1168, 1168, 1168, 1168, 1168, 1168, 1168, 1168, 1168, 1168, 1168, 1168, 1168, 1168, 1168, 1071, 1053, 1053, 363, 364, 365, 115, 116, 117, 118, 119, 116, 117, 118, 119, 115, 116, 117, 118, 119, 118, 119, 120, 121, 139, 117, 118, 119, 120, 121, 139, 140, 141, 142, 143, 144, 145, 146, 147, 148, 329, 330, 331, 1053, 1053, 1138, 1165, 1165, 1165, 1165, 1165, 1165, 1165, 1165, 1165, 1165, 1165, 1165, 1165, 1165
1168, 1168, 1168, 1168, 1168, 1168, 1168, 1168, 1168, 1168, 1168, 1168, 1168, 1168, 1168, 1168, 1168, 1168, 1168, 1168, 1103, 1053, 1053, 395, 396, 397, 147, 148, 149, 150, 151, 148, 149, 150, 151, 147, 148, 149, 150, 151, 172, 173, 174, 1053, 1053, 171, 172, 173, 174, 175, 176, 177, 178, 179, 180, 181, 182, 183, 184, 185, 361, 362, 363, 1053, 1053, 1074, 1165, 1165, 1165, 1165, 1165, 1165, 1165, 1165, 1165, 1165, 1165, 1165, 1165, 1165
1168, 1168, 1168, 1168, 1168, 1168, 1168, 1168, 1168, 1168, 1168, 1168, 1168, 1168, 1168, 1168, 1168, 1168, 1168, 1168, 1135, 1053, 1053, 181, 182, 183, 179, 180, 181, 182, 183, 180, 181, 182, 183, 179, 180, 181, 182, 183, 118, 119, 211, 1053, 1053, 208, 209, 210, 211, 212, 213, 214, 215, 216, 217, 235, 236, 237, 238, 239, 393, 394, 395, 1053, 1053, 1106, 1165, 1165, 1165, 1165, 1165, 1165, 1165, 1165, 1165, 1165, 1165, 1165, 1165, 1165
1168, 1168, 1168, 1168, 1168, 1168, 1168, 1168, 1168, 1168, 1168, 1168, 1168, 1168, 1168, 1168, 1168, 1168, 1168, 1168, 1071, 1053, 1053, 213, 214, 215, 211, 212, 213, 214, 215, 212, 213, 214, 215, 211, 212, 1053, 1053, 1053, 1053, 1053, 1053, 1053, 1053, 1053, 1053, 1053, 1053, 171, 172, 173, 174, 175, 176, 177, 174, 175, 176, 177, 119, 278, 279, 1053, 1053, 1138, 1165, 1165, 1165, 1165, 1165, 1165, 1165, 1165, 1165, 1165, 1165, 1165, 1165, 1165
1168, 1168, 1168, 1168, 1168, 1168, 1168, 1168, 1168, 1168, 1168, 1168, 1168, 1168, 1168, 1168, 1168, 1168, 1168, 1168, 1103, 110, 110, 245, 246, 247, 243, 168, 169, 170, 171, 172, 173, 168, 169, 1053, 1053, 1053, 1053, 1053, 1053, 1053, 1053, 1053, 1053, 1053, 1053, 1053, 1053, 203, 204, 205, 206, 207, 208, 209, 206, 207, 208, 209, 359, 360, 361, 1053, 1053, 1074, 1165, 1165, 1165, 1165, 1165, 1165, 1165, 1165, 1165, 1165, 1165, 1165, 1165, 1165
1168, 1168, 1168, 1168, 1168, 1168, 1168, 1168, 1168, 1168, 1168, 1168, 1168, 1168, 1168, 1168, 1168, 1168, 1168, 1168, 1135, 142, 142, 354, 355, 356, 357, 200, 201, 202, 203, 204, 205, 200, 201, 1053, 1053, 1053, 1053, 1053, 1053, 1053, 1053, 1053, 1053, 1053, 1053, 1053, 1053, 235, 236, 237, 238, 239, 240, 241, 238, 239, 240, 241, 391, 392, 393, 1053, 1053, 1106, 1165, 1165, 1165, 1165, 1165, 1165, 1165, 1165, 1165, 1165, 1165, 1165, 1165, 1165
1168, 1168, 1168, 1168, 1168, 1168, 1168, 1168, 1168, 1168, 1168, 1168, 1168, 1168, 1168, 1168, 1168, 1168, 1168, 1168, 1071, 110, 174, 396, 397, 398, 399, 232, 233, 234, 235, 236, 237, 232, 233, 234, 235, 1053, 1053, 1053, 1053, 1053, 1053, 1053, 1053, 1053, 1053, 1053, 1053, 267, 268, 269, 270, 271, 272, 273, 270, 271, 272, 273, 423, 424, 425, 1053, 1053, 1138, 1165, 1165, 1165, 1165, 1165, 1165, 1165, 1165, 1165, 1165, 1165, 1165, 1165, 1165
1168, 1168, 1168, 1168, 1168, 1168, 1168, 1168, 1168, 1168, 1168, 1168, 1168, 1168, 1168, 1168, 1168, 1168, 1168, 1168, 1103, 142, 206, 1053, 1053, 456, 457, 264, 265, 266, 267, 268, 269, 264, 265, 266, 267, 1053, 1053, 1053, 1053, 1053, 1053, 1053, 1053, 1053, 1053, 1053, 1053, 299, 300, 301, 302, 303, 304, 305, 302, 303, 304, 305, 455, 456, 457, 1053, 1053, 1074, 1165, 1165, 1165, 1165, 1165, 1165, 1165, 1165, 1165, 1165, 1165, 1165, 1165, 1165
1168, 1168, 1168, 1168, 1168, 1168, 1168, 1168, 1168, 1168, 1168, 1168, 1168, 1168, 1168, 1168, 1168, 1168, 1168, 1168, 1135, 174, 238, 1053, 1053, 2, 3, 296, 297, 298, 299, 300, 301, 296, 297, 298, 299, 1053, 1053, 1053, 1053, 1053, 1053, 1053, 1053, 1053, 1053, 1053, 1053, 331, 332, 333, 334, 335, 336, 337, 334, 335, 336, 337, 487, 488, 489, 1053, 1053, 1106, 1165, 1165, 1165, 1165, 1165, 1165, 1165, 1165, 1165, 1165, 1165, 1165, 1165, 1165
1168, 1168, 1168, 1168, 1168, 1168, 1168, 1168, 1168, 1168, 1168, 1168, 1168, 1168, 1168, 1168, 1168, 1168, 1168, 1168, 1071, 206, 270, 42, 43, 44, 45, 328, 329, 330, 331, 332, 333, 328, 329, 330, 331, 1053, 1053, 1053, 1053, 1053, 1053, 1053, 1053, 1053, 1053, 1053, 1053, 363, 364, 365, 366, 367, 368, 369, 366, 367, 368, 369, 115, 116, 117, 1053, 1053, 1138, 1165, 1165, 1165, 1165, 1165, 1165, 1165, 1165, 1165, 1165, 1165, 1165, 1165, 1165
1168, 1168, 1168, 1168, 1168, 1168, 1168, 1168, 1168, 1168, 1168, 1168, 1168, 1168, 1168, 1168, 1168, 1168, 1168, 1168, 1103, 140, 110, 100, 101, 102, 103, 360, 361, 362, 363, 364, 365, 360, 361, 362, 363, 1053, 1053, 1053, 1053, 1053, 1053, 1053, 1053, 1053, 1053, 1053, 1053, 395, 396, 397, 398, 399, 400, 401, 398, 399, 400, 401, 147, 148, 149, 1053, 1053, 1074, 1165, 1165, 1165, 1165, 1165, 1165, 1165, 1165, 1165, 1165, 1165, 1165, 1165, 1165
1168, 1168, 1168, 1168, 1168, 1168, 1168, 1168, 1168, 1168, 1168, 1168, 1168, 1168, 1168, 1168, 1168, 1168, 1168, 1168, 1135, 270, 141, 142, 143, 160, 161, 392, 393, 394, 395, 396, 397, 392, 393, 394, 395, 1053, 1053, 1053, 1053, 1053, 1053, 1053, 1053, 1053, 1053, 1053, 1053, 170, 171, 172, 173, 174, 175, 176, 177, 431, 432, 433, 179, 180, 181, 1053, 1053, 1106, 1165, 1165, 1165, 1165, 1165, 1165, 1165, 1165, 1165, 1165, 1165, 1165, 1165, 1165
1168, 1168, 1168, 1168, 1168, 1168, 1168, 1168, 1168, 1168, 1168, 1168, 1168, 1168, 1168, 1168, 1168, 1168, 1168, 1168, 1071, 359, 360, 361, 362, 363, 203, 424, 425, 426, 427, 428, 429, 424, 425, 426, 427, 1053, 1053, 1053, 1053, 1053, 1053, 1053, 1053, 1053, 1053, 1053, 1053, 202, 203, 204, 205, 206, 207, 208, 209, 463, 464, 465, 211, 212, 213, 1053, 1053, 1138, 1165, 1165, 1165, 1165, 1165, 1165, 1165, 1165, 1165, 1165, 1165, 1165, 1165, 1165
1168, 1168, 1168, 1168, 1168, 1168, 1168, 1168, 1168, 1168, 1168, 1168, 1168, 1168, 1168, 1168, 1168, 1168, 1168, 1168, 1103, 391, 392, 393, 394, 395, 261, 456, 457, 458, 459, 460, 461, 456, 457, 1053, 1053, 1053, 1053, 1053, 1053, 1053, 1053, 1053, 1053, 1053, 1053, 1053, 1053, 234, 235, 236, 237, 238, 239, 240, 241, 18, 19, 20, 243, 244, 245, 1053, 1053, 1074, 1165, 1165, 1165, 1165, 1165, 1165, 1165, 1165, 1165, 1165, 1165, 1165, 1165, 1165
1168, 1168, 1168, 1168, 1168, 1168, 1168, 1168, 1168, 1168, 1168, 1168, 1168, 1168, 1168, 1168, 1168, 1168, 1168, 1168, 1135, 423, 424, 425, 426, 427, 956, 957, 360, 204, 205, 206, 207, 224, 225, 1053, 1053, 1053, 1053, 1053, 1053, 1053, 1053, 1053, 1053, 1053, 1053, 1053, 1053, 266, 267, 268, 269, 270, 271, 272, 273, 55, 56, 57, 75, 76, 77, 1053, 1053, 1106, 1165, 1165, 1165, 1165, 1165, 1165, 1165, 1165, 1165, 1165, 1165, 1165, 1165, 1165
1168, 1168, 1168, 1168, 1168, 1168, 1168, 1168, 1168, 1168, 1168, 1168, 1168, 1168, 1168, 1168, 1168, 1168, 1168, 1168, 1071, 455, 456, 457, 458, 459, 988, 989, 142, 262, 263, 264, 265, 266, 267, 268, 1053, 1053, 271, 395, 396, 397, 398, 399, 264, 265, 266, 296, 297, 298, 299, 300, 301, 302, 303, 304, 305, 109, 110, 111, 112, 113, 114, 1053, 1053, 1138, 1165, 1165, 1165, 1165, 1165, 1165, 1165, 1165, 1165, 1165, 1165, 1165, 1165, 1165
1168, 1168, 1168, 1168, 1168, 1168, 1168, 1168, 1168, 1168, 1168, 1168, 1168, 1168, 1168, 1168, 1168, 1168, 1168, 1168, 1103, 487, 488, 489, 490, 491, 419, 177, 174, 320, 321, 322, 323, 324, 325, 326, 327, 327, 329, 432, 433, 434, 435, 436, 296, 297, 298, 328, 329, 330, 331, 332, 333, 334, 335, 336, 337, 146, 147, 148, 149, 150, 151, 1053, 1053, 1074, 1165, 1165, 1165, 1165, 1165, 1165, 1165, 1165, 1165, 1165, 1165, 1165, 1165, 1165
1168, 1168, 1168, 1168, 1168, 1168, 1168, 1168, 1168, 1168, 1168, 1168, 1168, 1168, 1168, 1168, 1168, 1168, 1168, 1168, 1135, 270, 457, 458, 459, 168, 169, 170, 171, 172, 173, 174, 175, 176, 177, 173, 327, 327, 176, 177, 470, 471, 472, 473, 328, 329, 330, 360, 361, 362, 363, 364, 365, 366, 367, 368, 369, 183, 184, 185, 203, 204, 205, 1053, 1053, 1106, 1165, 1165, 1165, 1165, 1165, 1165, 1165, 1165, 1165, 1165, 1165, 1165, 1165, 1165
1168, 1168, 1168, 1168, 1168, 1168, 1168, 1168, 1168, 1168, 1168, 1168, 1168, 1168, 1168, 1168, 1168, 1168, 1168, 1168, 1071, 110, 3, 4, 5, 200, 201, 202, 203, 204, 205, 206, 207, 208, 209, 205, 206, 207, 208, 209, 44, 45, 46, 47, 360, 361, 362, 392, 393, 394, 395, 396, 397, 398, 399, 400, 401, 237, 238, 239, 240, 241, 242, 1053, 1053, 1138, 1165, 1165, 1165, 1165, 1165, 1165, 1165, 1165, 1165, 1165, 1165, 1165, 1165, 1165
1168, 1168, 1168, 1168, 1168, 1168, 1168, 1168, 1168, 1168, 1168, 1168, 1168, 1168, 1168, 1168, 1168, 1168, 1168, 1168, 1103, 142, 45, 46, 47, 232, 233, 234, 235, 236, 237, 238, 239, 240, 241, 237, 238, 239, 240, 241, 12, 13, 14, 15, 392, 393, 394, 424, 425, 426, 427, 428, 429, 430, 431, 432, 433, 274, 275, 276, 277, 278, 279, 1053, 1053, 1074, 1165, 1165, 1165, 1165, 1165, 1165, 1165, 1165, 1165, 1165, 1165, 1165, 1165, 1165
1168, 1168, 1168, 1168, 1168, 1168, 1168, 1168, 1168, 1168, 1168, 1168, 1168, 1168, 1168, 1168, 1168, 1168, 1168, 1168, 1135, 174, 103, 104, 105, 264, 265, 266, 267, 268, 269, 270, 271, 272, 273, 269, 270, 271, 272, 273, 49, 50, 51, 52, 424, 425, 426, 456, 457, 458, 459, 460, 461, 462, 463, 464, 465, 311, 312, 313, 331, 332, 333, 1053, 1053, 1106, 1165, 1165, 1165, 1165, 1165, 1165, 1165, 1165, 1165, 1165, 1165, 1165, 1165, 1165
1168, 1168, 1168, 1168, 1168, 1168, 1168, 1168, 1168, 1168, 1168, 1168, 1168, 1168, 1168, 1168, 1168, 1168, 1168, 1168, 1071, 206, 161, 162, 163, 296, 297, 298, 299, 300, 1053, 1053, 1053, 304, 305, 301, 302, 303, 304, 305, 86, 87, 88, 89, 456, 457, 458, 459, 460, 461, 462, 463, 464, 465, 345, 363, 364, 365, 366, 367, 368, 369, 370, 1053, 1053, 1138, 1165, 1165, 1165, 1165, 1165, 1165, 1165, 1165, 1165, 1165, 1165, 1165, 1165, 1165
1168, 1168, 1168, 1168, 1168, 1168, 1168, 1168, 1168, 1168, 1168, 1168, 1168, 1168, 1168, 1168, 1168, 1168, 1168, 1168, 1103, 238, 203, 204, 205, 328, 329, 330, 331, 332, 1053, 1053, 1053, 336, 337, 333, 334, 335, 336, 337, 140, 141, 142, 143, 144, 139, 140, 141, 142, 143, 144, 145, 146, 147, 148, 149, 150, 151, 152, 153, 171, 172, 173, 1053, 1053, 1074, 1165, 1165, 1165, 1165, 1165, 1165, 1165, 1165, 1165, 1165, 1165, 1165, 1165, 1165
1168, 1168, 1168, 1168, 1168, 1168, 1168, 1168, 1168, 1168, 1168, 1168, 1168, 1168, 1168, 1168, 1168, 1168, 1168, 1168, 1135, 270, 261, 262, 263, 360, 361, 362, 363, 364, 365, 1053, 1053, 368, 369, 365, 366, 367, 368, 369, 177, 178, 179, 180, 181, 176, 177, 178, 179, 180, 181, 182, 183, 184, 185, 203, 204, 205, 206, 207, 208, 209, 210, 1053, 1053, 1106, 1165, 1165, 1165, 1165, 1165, 1165, 1165, 1165, 1165, 1165, 1165, 1165, 1165, 1165
1168, 1168, 1168, 1168, 1168, 1168, 1168, 1168, 1168, 1168, 1168, 1168, 1168, 1168, 1168, 1168, 1168, 1168, 1168, 1168, 1071, 1053, 1053, 320, 0, 392, 393, 394, 395, 396, 397, 398, 399, 400, 401, 397, 398, 399, 400, 401, 214, 215, 216, 217, 235, 213, 214, 215, 216, 217, 235, 236, 237, 238, 239, 240, 241, 242, 243, 244, 245, 246, 247, 1053, 1053, 1138, 1165, 1165, 1165, 1165, 1165, 1165, 1165, 1165, 1165, 1165, 1165, 1165, 1165, 1165
1168, 1168, 1168, 1168, 1168, 1168, 1168, 1168, 1168, 1168, 1168, 1168, 1168, 1168, 1168, 1168, 1168, 1168, 1168, 1168, 1071, 1053, 1053, 117, 118, 424, 425, 426, 427, 428, 429, 430, 431, 432, 433, 429, 430, 431, 432, 433, 268, 269, 270, 271, 272, 267, 268, 269, 270, 271, 272, 273, 274, 275, 276, 277, 278, 279, 280, 281, 299, 300, 301, 1053, 1053, 1074, 1165, 1165, 1165, 1165, 1165, 1165, 1165, 1165, 1165, 1165, 1165, 1165, 1165, 1165
1168, 1168, 1168, 1168, 1168, 1168, 1168, 1168, 1168, 1168, 1168, 1168, 1168, 1168, 1168, 1168, 1168, 1168, 1168, 1168, 1103, 174, 148, 149, 150, 456, 457, 458, 459, 460, 461, 462, 463, 464, 465, 461, 462, 463, 464, 465, 119, 306, 307, 308, 309, 304, 305, 306, 307, 308, 309, 310, 311, 312, 313, 331, 332, 333, 334, 335, 336, 337, 338, 1053, 1053, 1106, 1165, 1165, 1165, 1165, 1165, 1165, 1165, 1165, 1165, 1165, 1165, 1165, 1165, 1165
1168, 1168, 1168, 1168, 1168, 1168, 1168, 1168, 1168, 1168, 1168, 1168, 1168, 1168, 1168, 1168, 1168, 1168, 1168, 1168, 1135, 206, 180, 181, 182, 183, 180, 181, 182, 183, 179, 180, 181, 182, 183, 181, 182, 334, 334, 150, 151, 343, 344, 147, 148, 149, 150, 343, 344, 345, 363, 364, 365, 366, 367, 368, 369, 370, 371, 372, 373, 374, 375, 1053, 1053, 1138, 1165, 1165, 1165, 1165, 1165, 1165, 1165, 1165, 1165, 1165, 1165, 1165, 1165, 1165
1168, 1168, 1168, 1168, 1168, 1168, 1168, 1168, 1168, 1168, 1168, 1168, 1168, 1168, 1168, 1168, 1168, 1168, 1168, 1168, 1071, 238, 212, 213, 214, 215, 212, 213, 214, 215, 211, 212, 213, 214, 215, 213, 214, 334, 334, 334, 183, 397, 398, 179, 180, 181, 182, 1053, 1053, 1053, 1053, 401, 402, 403, 404, 405, 406, 407, 408, 409, 427, 428, 429, 1053, 1053, 1074, 1165, 1165, 1165, 1165, 1165, 1165, 1165, 1165, 1165, 1165, 1165, 1165, 1165, 1165
1168, 1168, 1168, 1168, 1168, 1168, 1168, 1168, 1168, 1168, 1168, 1168, 1168, 1168, 1168, 1168, 1168, 1168, 1168, 1168, 1103, 265, 266, 267, 268, 269, 244, 245, 246, 247, 243, 244, 245, 246, 247, 245, 359, 360, 334, 334, 363, 434, 435, 211, 212, 213, 214, 1053, 1053, 1053, 1053, 438, 439, 440, 441, 459, 460, 461, 462, 463, 464, 465, 466, 1053, 1053, 1106, 1165, 1165, 1165, 1165, 1165, 1165, 1165, 1165, 1165, 1165, 1165, 1165, 1165, 1165
1168, 1168, 1168, 1168, 1168, 1168, 1168, 1168, 1168, 1168, 1168, 1168, 1168, 1168, 1168, 1168, 1168, 1168, 1168, 1168, 1135, 265, 266, 267, 268, 269, 302, 303, 320, 321, 322, 323, 324, 325, 326, 327, 359, 360, 361, 362, 363, 471, 472, 243, 244, 245, 246, 203, 203, 203, 203, 12, 203, 203, 203, 16, 17, 369, 369, 20, 21, 22, 23, 1053, 1053, 1138, 1165, 1165, 1165, 1165, 1165, 1165, 1165, 1165, 1165, 1165, 1165, 1165, 1165, 1165
1168, 1168, 1168, 1168, 1168, 1168, 1168, 1168, 1168, 1168, 1168, 1168, 1168, 1168, 1168, 1168, 1168, 1168, 1168, 1168, 1071, 297, 298, 299, 300, 301, 360, 361, 362, 363, 364, 365, 366, 367, 384, 385, 391, 392, 393, 394, 395, 45, 46, 147, 148, 149, 150, 203, 203, 203, 203, 49, 203, 203, 203, 53, 54, 369, 369, 57, 75, 76, 77, 1053, 1053, 1074, 1165, 1165, 1165, 1165, 1165, 1165, 1165, 1165, 1165, 1165, 1165, 1165, 1165, 1165
1168, 1168, 1168, 1168, 1168, 1168, 1168, 1168, 1168, 1168, 1168, 1168, 1168, 1168, 1168, 1168, 1168, 1168, 1168, 1168, 1103, 329, 330, 331, 332, 333, 956, 957, 420, 956, 957, 956, 957, 956, 957, 427, 423, 424, 425, 426, 427, 82, 83, 179, 180, 181, 182, 82, 83, 84, 85, 86, 87, 88, 89, 107, 108, 109, 110, 111, 112, 113, 114, 1053, 1053, 1106, 1165, 1165, 1165, 1165, 1165, 1165, 1165, 1165, 1165, 1165, 1165, 1165, 1165, 1165
1168, 1168, 1168, 1168, 1168, 1168, 1168, 1168, 1168, 1168, 1168, 1168, 1168, 1168, 1168, 1168, 1168, 1168, 1168, 1168, 1135, 361, 362, 363, 364, 365, 988, 989, 462, 988, 989, 988, 989, 988, 989, 485, 455, 456, 457, 458, 459, 334, 334, 211, 212, 213, 214, 116, 117, 118, 119, 140, 141, 142, 143, 144, 145, 146, 147, 148, 149, 150, 151, 1053, 1053, 1138, 1165, 1165, 1165, 1165, 1165, 1165, 1165, 1165, 1165, 1165, 1165, 1165, 1165, 1165
1168, 1168, 1168, 1168, 1168, 1168, 1168, 1168, 1168, 1168, 1168, 1168, 1168, 1168, 1168, 1168, 1168, 1168, 1168, 1168, 1071, 393, 394, 395, 396, 397, 6, 7, 8, 9, 10, 11, 12, 13, 14, 15, 487, 488, 489, 490, 491, 334, 334, 243, 244, 245, 246, 116, 117, 118, 119, 177, 178, 179, 180, 181, 182, 183, 184, 185, 203, 204, 205, 206, 207, 1074, 1165, 1165, 1165, 1165, 1165, 1165, 1165, 1165, 1165, 1165, 1165, 1165, 1165, 1165
1168, 1168, 1168, 1168, 1168, 1168, 1168, 1168, 1168, 1168, 1168, 1168, 1168, 1168, 1168, 1168, 1168, 1168, 1168, 1168, 1057, 1061, 1061, 1061, 1061, 1061, 1061, 1061, 1061, 1061, 1061, 1061, 1061, 1061, 1061, 1061, 1061, 1061, 1061, 1061, 1061, 1061, 1061, 1061, 1061, 1061, 1061, 1061, 1061, 1061, 1061, 1061, 1061, 1061, 1061, 1061, 1061, 1061, 1061, 1061, 1061, 1061, 1061, 1061, 1061, 1068, 1165, 1165, 1165, 1165, 1165, 1165, 1165, 1165, 1165, 1165, 1165, 1165, 1165, 1165
