1362, 1363, 1364, 1365, 1366, 1367, 1368, 1362, 1363, 1364, 1365, 1366, 1367, 1368, 1369, 1367, 1368, 1369, 1362, 1363, 1364, 1365, 1366, 1367, 1368, 1369, 1366, 1367, 1368, 1369, 1367, 1368, 1369, 1364, 1365, 1366, 1367, 1368, 1369, 1362, 1363, 1364, 1365, 1362, 1363, 1364, 1365, 1366, 1367, 1368, 1369, 1365, 1366, 1367, 1368, 1369, 1363, 1364, 1365, 1366, 1367, 1368, 1369, 1363, 1364, 1365, 1366, 1367, 1362, 1363, 1364, 1365, 1366, 1367, 1362, 1363, 1364, 1365, 1366, 1367
1394, 1395, 1396, 1397, 1398, 1399, 1400, 1394, 1395, 1396, 1397, 1398, 1399, 1400, 1401, 1399, 1400, 1401, 1394, 1395, 1396, 1397, 1398, 1399, 1400, 1401, 1398, 1399, 1400, 1401, 1399, 1400, 1401, 1396, 1397, 1398, 1399, 1400, 1401, 1394, 1395, 1396, 1397, 1394, 1395, 1396, 1397, 1398, 1399, 1400, 1401, 1397, 1398, 1399, 1400, 1401, 1395, 1396, 1397, 1398, 1399, 1400, 1401, 1395, 1396, 1397, 1398, 1399, 1394, 1395, 1396, 1397, 1398, 1399, 1368, 1369, 1394, 1395, 1396, 1397
1426, 1427, 1428, 1429, 1430, 1431, 1432, 1426, 1427, 1428, 1429, 1430, 1431, 1432, 1433, 1431, 1432, 1433, 1426, 1427, 1428, 1429, 1430, 1431, 1432, 1433, 1430, 1431, 1432, 1433, 1431, 1432, 1433, 1428, 1429, 1430, 1431, 1432, 1433, 1426, 1427, 1428, 1429, 1426, 1427, 1428, 1429, 1430, 1431, 1432, 1433, 1429, 1430, 1431, 1432, 1433, 1427, 1428, 1429, 1430, 1431, 1432, 1433, 1427, 1428, 1429, 1430, 1431, 1426, 1427, 1428, 1429, 1430, 1431, 1398, 1399, 1400, 1401, 1426, 1427
1458, 1459, 1460, 1461, 1462, 1463, 1464, 1458, 1459, 1460, 1461, 1462, 1463, 1464, 1465, 1463, 1464, 1465, 1458, 1459, 1460, 1461, 1462, 1463, 1464, 1465, 1462, 1463, 1464, 1465, 1463, 1464, 1465, 1460, 1461, 1462, 1463, 1464, 1465, 1458, 1459, 1460, 1461, 1458, 1459, 1460, 1461, 1462, 1463, 1464, 1465, 1461, 1462, 1463, 1464, 1465, 1459, 1460, 1461, 1462, 1463, 1464, 1465, 1459, 1460, 1461, 1462, 1463, 1458, 1459, 1460, 1461, 1462, 1463, 1362, 1363, 1364, 1365, 1366, 1367
1490, 1491, 1492, 1493, 1494, 1495, 1496, 1490, 1491, 1492, 1493, 1494, 1495, 1496, 1497, 1495, 1496, 1497, 1394, 1395, 1396, 1397, 1398, 1399, 1400, 1394, 1395, 1396, 1397, 1398, 1399, 1400, 1401, 1394, 1395, 1396, 1397, 1398, 1399, 1400, 1401, 1394, 1395, 1396, 1397, 1398, 1399, 1400, 1401, 1394, 1395, 1396, 1397, 1398, 1399, 1394, 1395, 1396, 1397, 1398, 1399, 1400, 1401, 1491, 1492, 1493, 1494, 1495, 1490, 1362, 1363, 1364, 1365, 1366, 1367, 1368, 1369, 1395, 1396, 1397
1522, 1523, 1524, 1525, 1526, 1527, 1362, 1363, 1364, 1365, 1366, 1367, 1368, 1369, 1529, 1527, 1528, 1529, 1426, 1427, 1428, 1429, 1430, 1431, 1432, 1426, 1427, 1428, 1429, 1430, 1431, 1432, 1433, 1426, 1427, 1428, 1429, 1430, 1431, 1432, 1433, 1426, 1427, 1428, 1429, 1430, 1431, 1432, 1433, 1426, 1427, 1428, 1429, 1430, 1431, 1426, 1427, 1428, 1429, 1430, 1431, 1432, 1433, 1523, 1524, 1525, 1526, 1527, 1522, 1394, 1395, 1396, 1397, 1398, 1399, 1400, 1401, 1401, 1426, 1427
1554, 1555, 1556, 1557, 1558, 1559, 1394, 1395, 1396, 1397, 1398, 1399, 1400, 1401, 1561, 1559, 1560, 1561, 1458, 1459, 1460, 1461, 1462, 1463, 1464, 1458, 1459, 1460, 1461, 1462, 1463, 1464, 1465, 1458, 1459, 1460, 1461, 1462, 1463, 1464, 1465, 1458, 1459, 1460, 1461, 1462, 1463, 1464, 1465, 1458, 1459, 1460, 1461, 1462, 1463, 1458, 1459, 1460, 1461, 1462, 1463, 1464, 1465, 1555, 1556, 1557, 1558, 1362, 1363, 1364, 1365, 1366, 1367, 1368, 1369, 1432, 1433, 1431, 1432, 1433
1362, 1363, 1364, 1365, 1366, 1367, 1426, 1427, 1428, 1429, 1430, 1431, 1432, 1433, 1593, 1591, 1592, 1593, 896, 897, 898, 899, 900, 901, 902, 903, 904, 905, 906, 907, 908, 909, 910, 911, 903, 904, 905, 906, 907, 908, 909, 910, 911, 912, 913, 914, 912, 913, 914, 915, 916, 917, 918, 919, 920, 921, 922, 923, 924, 925, 926, 927, 1586, 1587, 1588, 1589, 1590, 1394, 1395, 1396, 1397, 1398, 1399, 1400, 1401, 1464, 1465, 1461, 1462, 1463
1394, 1395, 1396, 1397, 1398, 1399, 1458, 1459, 1460, 1461, 1462, 1463, 1464, 1465, 1558, 1559, 1560, 1561, 928, 929, 930, 931, 932, 933, 934, 935, 936, 937, 938, 939, 940, 941, 942, 943, 935, 936, 937, 938, 939, 940, 941, 942, 943, 944, 945, 946, 944, 945, 946, 947, 948, 949, 950, 951, 952, 953, 954, 955, 956, 957, 958, 959, 1490, 1491, 1492, 1493, 1362, 1363, 1364, 1365, 1366, 1367, 1368, 1369, 1433, 1496, 1497, 1491, 1492, 1493
1426, 1427, 1428, 1429, 1430, 1431, 1362, 1363, 1364, 1365, 1366, 1367, 1368, 1369, 1590, 1591, 1592, 1593, 960, 961, 962, 963, 964, 965, 966, 967, 968, 969, 970, 971, 972, 973, 974, 975, 967, 968, 969, 1104, 1104, 972, 973, 974, 975, 976, 977, 978, 976, 977, 978, 979, 980, 981, 982, 983, 984, 985, 986, 987, 988, 989, 990, 991, 1522, 1523, 1362, 1363, 1394, 1395, 1396, 1397, 1398, 1399, 1400, 1401, 1465, 1528, 1529, 1497, 1522, 1523
1458, 1459, 1460, 1461, 1462, 1463, 1394, 1395, 1396, 1397, 1398, 1399, 1400, 1401, 1462, 1463, 1464, 1465, 1088, 1089, 1090, 330, 331, 332, 333, 334, 335, 336, 337, 330, 331, 332, 333, 334, 335, 336, 337, 1103, 1103, 330, 331, 332, 333, 334, 330, 331, 332, 333, 334, 335, 336, 330, 331, 332, 333, 334, 335, 336, 337, 1091, 1092, 1093, 1554, 1555, 1394, 1395, 1426, 1427, 1428, 1429, 1430, 1431, 1432, 1433, 1497, 1560, 1561, 1527, 1528, 1529
1362, 1363, 1364, 1365, 1366, 1367, 1426, 1427, 1428, 1429, 1430, 1431, 1432, 1433, 1494, 1495, 1496, 1497, 1120, 1121, 1122, 362, 363, 364, 365, 366, 367, 368, 369, 362, 363, 364, 365, 366, 330, 331, 332, 333, 334, 362, 363, 364, 365, 366, 362, 363, 364, 365, 366, 367, 368, 362, 363, 364, 365, 366, 367, 368, 369, 1123, 1124, 1125, 1586, 1587, 1426, 1427, 1458, 1459, 1460, 1461, 1462, 1463, 1464, 1465, 1529, 1592, 1593, 1165, 1165, 1165
1394, 1395, 1396, 1397, 1398, 1399, 1458, 1459, 1460, 1461, 1462, 1463, 1464, 1465, 1526, 1527, 1528, 1529, 1152, 1153, 1154, 394, 395, 396, 397, 398, 399, 400, 401, 394, 395, 396, 397, 398, 362, 363, 364, 365, 366, 394, 395, 396, 397, 398, 394, 395, 396, 397, 398, 399, 362, 363, 364, 365, 366, 367, 368, 369, 401, 1155, 1156, 1157, 1362, 1363, 1364, 1365, 1490, 1491, 1492, 1493, 1494, 1495, 1496, 1497, 1368, 1369, 1165, 1165, 1165, 1165
1426, 1427, 1428, 1429, 1430, 1431, 1362, 1363, 1364, 1365, 1366, 1367, 1368, 1369, 1558, 1559, 1560, 1561, 1184, 1185, 1186, 426, 427, 428, 429, 430, 431, 432, 433, 426, 427, 428, 429, 430, 394, 395, 396, 397, 398, 426, 427, 428, 429, 430, 426, 427, 428, 429, 430, 431, 394, 395, 396, 397, 398, 399, 400, 401, 433, 1187, 1188, 1189, 1394, 1395, 1396, 1397, 1522, 1523, 1524, 1525, 1526, 1527, 1528, 1529, 1400, 1401, 1165, 1165, 1165, 1165
1362, 1363, 1364, 1365, 1366, 1367, 1394, 1395, 1396, 1397, 1398, 1399, 1400, 1401, 1590, 1591, 1592, 1593, 1216, 1217, 1218, 64, 65, 298, 299, 300, 301, 302, 303, 299, 300, 301, 302, 303, 426, 427, 428, 429, 430, 431, 432, 433, 299, 300, 301, 302, 303, 299, 300, 301, 426, 427, 428, 429, 430, 431, 432, 433, 35, 1219, 1220, 1221, 1426, 1427, 1428, 1429, 1554, 1555, 1556, 1557, 1558, 1559, 1560, 1561, 1432, 1433, 1165, 1165, 1165, 1165
1394, 1395, 1396, 1397, 1398, 1399, 1426, 1427, 1428, 1429, 1430, 1431, 1432, 1433, 1526, 1527, 1528, 1529, 1248, 1249, 1250, 96, 97, 330, 331, 332, 333, 334, 335, 331, 332, 333, 334, 362, 363, 364, 365, 366, 367, 368, 369, 330, 331, 332, 333, 334, 335, 331, 332, 333, 458, 459, 460, 461, 462, 463, 464, 465, 369, 1251, 1252, 1253, 1458, 1459, 1460, 1461, 1586, 1587, 1588, 1589, 1590, 1591, 1592, 1593, 1464, 1465, 1165, 1165, 1165, 1165
1362, 1363, 1364, 1365, 1366, 1367, 1362, 1363, 1364, 1365, 1366, 1367, 1368, 1369, 1558, 1559, 1560, 1561, 1280, 1281, 1282, 128, 129, 362, 363, 364, 365, 366, 367, 363, 364, 365, 366, 394, 395, 396, 397, 398, 399, 400, 401, 362, 363, 364, 365, 366, 367, 363, 364, 365, 490, 491, 492, 493, 494, 495, 496, 497, 401, 1283, 1284, 1285, 1362, 1363, 1364, 1365, 1366, 1367, 1368, 1369, 1492, 1493, 1494, 1495, 1496, 1497, 1165, 1165, 1165, 1165
1394, 1395, 1396, 1397, 1398, 1399, 1394, 1395, 1396, 1397, 1398, 1399, 1400, 1401, 1590, 1591, 1592, 1593, 1088, 1089, 1090, 160, 161, 162, 163, 164, 165, 85, 85, 168, 169, 360, 361, 426, 427, 428, 429, 430, 431, 432, 433, 370, 371, 372, 373, 374, 375, 335, 335, 234, 522, 523, 524, 525, 526, 527, 528, 529, 433, 1315, 1316, 1317, 1394, 1395, 1396, 1397, 1398, 1399, 1400, 1401, 1524, 1525, 1526, 1527, 1528, 1529, 1367, 1368, 1369, 1165
1426, 1427, 1428, 1429, 1430, 1431, 1426, 1427, 1428, 1429, 1430, 1431, 1432, 1433, 1462, 1463, 1464, 1465, 1120, 1121, 1122, 192, 193, 202, 203, 204, 205, 206, 207, 1104, 1104, 392, 393, 458, 459, 460, 461, 462, 463, 464, 465, 402, 403, 404, 405, 406, 407, 1104, 1104, 266, 554, 555, 556, 557, 558, 559, 560, 561, 465, 1091, 1092, 1093, 1426, 1427, 1428, 1429, 1430, 1431, 1432, 1433, 1556, 1557, 1558, 1559, 1560, 1561, 1399, 1400, 1401, 1165
1458, 1459, 1460, 1461, 1462, 1463, 1458, 1459, 1460, 1461, 1462, 1463, 1464, 1465, 1494, 1495, 1496, 1497, 1152, 1153, 1154, 224, 225, 234, 235, 236, 237, 238, 239, 1104, 1104, 424, 425, 490, 491, 492, 493, 494, 495, 496, 497, 434, 435, 436, 437, 438, 439, 1104, 1104, 298, 586, 587, 588, 589, 590, 591, 592, 593, 497, 1123, 1124, 1125, 1458, 1459, 1460, 1461, 1462, 1463, 1464, 1465, 1588, 1589, 1590, 1591, 1592, 1593, 1365, 1366, 1367, 1368
1490, 1491, 1492, 1493, 1494, 1495, 1490, 1491, 1492, 1493, 1494, 1495, 1496, 1497, 1526, 1527, 1528, 1529, 1184, 1185, 1186, 256, 257, 266, 267, 268, 269, 270, 271, 1104, 1104, 456, 457, 522, 523, 524, 525, 526, 527, 528, 529, 466, 467, 468, 469, 470, 471, 1104, 1104, 202, 458, 522, 523, 524, 525, 526, 527, 528, 529, 1155, 1156, 1157, 1490, 1491, 1492, 1493, 1494, 1495, 1496, 1497, 1557, 1558, 1559, 1560, 1561, 1395, 1396, 1397, 1398, 1399
1522, 1523, 1524, 1525, 1526, 1527, 1362, 1363, 1364, 1365, 1366, 1367, 1368, 1369, 1558, 1559, 1560, 1561, 1216, 1217, 1218, 288, 289, 298, 299, 300, 301, 302, 303, 1104, 1104, 298, 299, 554, 555, 556, 557, 558, 559, 560, 561, 292, 293, 294, 295, 296, 297, 1104, 1104, 234, 490, 554, 555, 556, 557, 558, 559, 560, 561, 1187, 1188, 1189, 1362, 1363, 1364, 1365, 1366, 1367, 1368, 1369, 1589, 1590, 1591, 1592, 1593, 1363, 1364, 1365, 1366, 1367
1554, 1555, 1556, 1557, 1558, 1559, 1394, 1395, 1396, 1397, 1398, 1399, 1400, 1401, 1590, 1591, 1592, 1593, 1248, 1249, 1250, 320, 321, 202, 203, 204, 205, 206, 207, 1104, 1104, 330, 331, 586, 587, 588, 589, 590, 591, 592, 593, 324, 325, 326, 327, 328, 329, 1104, 1104, 266, 522, 586, 587, 588, 589, 590, 591, 592, 593, 1219, 1220, 1221, 1394, 1395, 1396, 1397, 1398, 1399, 1400, 1401, 1494, 1495, 1496, 1497, 1465, 1368, 1369, 1395, 1396, 1397
1586, 1587, 1588, 1589, 1590, 1591, 1426, 1427, 1428, 1429, 1430, 1431, 1432, 1433, 1494, 1495, 1496, 1497, 1088, 1089, 1090, 352, 353, 234, 235, 236, 237, 238, 239, 1104, 1104, 362, 363, 364, 365, 366, 367, 352, 353, 354, 355, 356, 357, 358, 359, 360, 361, 1104, 1104, 298, 554, 555, 556, 557, 558, 559, 560, 561, 323, 1251, 1252, 1253, 1426, 1427, 1428, 1429, 1430, 1431, 1432, 1433, 1526, 1527, 1528, 1529, 1497, 1400, 1401, 1401, 1426, 1427
1426, 1427, 1428, 1429, 1430, 1431, 1458, 1459, 1460, 1461, 1462, 1463, 1464, 1465, 1526, 1527, 1528, 1529, 1120, 1121, 1122, 384, 385, 266, 267, 268, 269, 270, 202, 203, 204, 394, 395, 396, 397, 398, 399, 384, 385, 386, 387, 388, 389, 390, 391, 392, 393, 202, 203, 204, 362, 363, 364, 365, 366, 367, 368, 369, 355, 1283, 1284, 1285, 1458, 1459, 1460, 1461, 1462, 1463, 1464, 1465, 1558, 1559, 1560, 1561, 1529, 1432, 1433, 1431, 1432, 1433
1458, 1459, 1460, 1461, 1462, 1463, 1490, 1491, 1492, 1493, 1494, 1495, 1496, 1497, 1558, 1559, 1560, 1561, 1152, 1153, 1154, 416, 417, 298, 299, 300, 301, 302, 205, 202, 203, 204, 427, 428, 429, 430, 431, 416, 417, 418, 419, 420, 421, 422, 423, 424, 425, 205, 206, 207, 394, 395, 396, 397, 398, 399, 400, 401, 387, 1315, 1316, 1317, 1490, 1491, 1492, 1493, 1494, 1495, 1496, 1497, 1590, 1591, 1592, 1593, 1561, 1464, 1465, 1461, 1462, 1463
1490, 1491, 1492, 1493, 1494, 1495, 1522, 1523, 1524, 1525, 1526, 1527, 1528, 1529, 1590, 1591, 1592, 1593, 1184, 1185, 1186, 362, 363, 364, 365, 366, 367, 368, 369, 205, 206, 207, 459, 460, 461, 462, 463, 448, 449, 450, 451, 202, 203, 204, 205, 206, 207, 202, 203, 204, 426, 427, 428, 429, 430, 431, 432, 433, 419, 1091, 1092, 1093, 1362, 1363, 1364, 1365, 1366, 1367, 1368, 1369, 1589, 1590, 1591, 1592, 1593, 1496, 1497, 1365, 1366, 1367
1522, 1523, 1524, 1525, 1526, 1527, 1554, 1555, 1556, 1557, 1558, 1559, 1560, 1561, 1366, 1367, 1368, 1369, 1216, 1217, 1218, 394, 395, 396, 397, 398, 399, 400, 401, 234, 235, 236, 203, 204, 205, 206, 207, 480, 481, 482, 483, 234, 235, 236, 237, 238, 239, 205, 206, 207, 458, 459, 460, 461, 462, 463, 464, 465, 451, 1123, 1124, 1125, 1394, 1395, 1396, 1397, 1398, 1399, 1400, 1401, 1523, 1524, 1525, 1526, 1527, 1528, 1529, 1395, 1396, 1397
1554, 1555, 1556, 1557, 1558, 1559, 1586, 1587, 1588, 1589, 1590, 1591, 1592, 1593, 1398, 1399, 1400, 1401, 1248, 1249, 1250, 426, 427, 428, 429, 430, 431, 432, 433, 8, 9, 234, 235, 236, 237, 238, 239, 32, 33, 34, 35, 202, 203, 204, 205, 206, 207, 234, 235, 236, 490, 491, 492, 493, 494, 495, 496, 497, 483, 1155, 1156, 1157, 1426, 1427, 1428, 1429, 1430, 1431, 1432, 1433, 1555, 1556, 1557, 1558, 1559, 1560, 1561, 1401, 1426, 1427
1586, 1587, 1588, 1589, 1590, 1591, 1362, 1363, 1364, 1365, 1366, 1367, 1368, 1369, 1430, 1431, 1432, 1433, 1280, 1281, 1282, 458, 459, 460, 461, 462, 463, 464, 465, 66, 67, 266, 267, 268, 269, 270, 271, 394, 394, 76, 77, 234, 235, 236, 237, 238, 239, 335, 335, 362, 522, 523, 524, 525, 526, 527, 528, 529, 9, 1187, 1188, 1189, 1458, 1459, 1460, 1461, 1462, 1463, 1464, 1465, 1587, 1588, 1589, 1590, 1591, 1592, 1593, 1431, 1432, 1433
1554, 1555, 1556, 1557, 1558, 1559, 1394, 1395, 1396, 1397, 1398, 1399, 1400, 1401, 1462, 1463, 1464, 1465, 1088, 1089, 1090, 490, 491, 492, 493, 494, 495, 496, 497, 1104, 1104, 298, 299, 300, 301, 302, 303, 132, 133, 134, 202, 203, 204, 205, 206, 207, 271, 1104, 1104, 394, 554, 555, 556, 557, 558, 559, 560, 561, 67, 1219, 1220, 1221, 1362, 1363, 1364, 1365, 1366, 1367, 1368, 1362, 1363, 1364, 1365, 1366, 1367, 1368, 1369, 1461, 1462, 1463
1586, 1587, 1588, 1589, 1590, 1591, 1426, 1427, 1428, 1429, 1430, 1431, 1432, 1433, 1494, 1495, 1496, 1497, 1120, 1121, 1122, 522, 523, 524, 525, 526, 527, 528, 529, 1104, 1104, 330, 331, 332, 333, 334, 335, 174, 175, 192, 234, 235, 236, 237, 238, 239, 303, 1104, 1104, 426, 586, 587, 588, 589, 590, 591, 592, 593, 109, 1251, 1252, 1253, 1394, 1395, 1396, 1397, 1398, 1399, 1400, 1394, 1395, 1396, 1397, 1398, 1399, 1400, 1401, 1365, 1366, 1367
1458, 1459, 1460, 1461, 1462, 1463, 1458, 1459, 1460, 1461, 1462, 1463, 1464, 1465, 1526, 1527, 1528, 1529, 1152, 1153, 1154, 554, 555, 556, 557, 558, 559, 560, 561, 1104, 1104, 362, 363, 364, 365, 366, 367, 232, 233, 234, 266, 267, 268, 269, 270, 271, 335, 1104, 1104, 458, 459, 460, 461, 462, 463, 464, 465, 166, 167, 1283, 1284, 1285, 1426, 1427, 1428, 1429, 1430, 1431, 1432, 1426, 1427, 1428, 1429, 1430, 1431, 1432, 1433, 1395, 1396, 1397
1490, 1491, 1492, 1493, 1494, 1495, 1490, 1491, 1492, 1493, 1494, 1495, 1496, 1497, 1558, 1559, 1560, 1561, 1184, 1185, 1186, 586, 587, 588, 589, 590, 591, 592, 593, 1104, 1104, 266, 267, 268, 269, 270, 271, 290, 291, 292, 298, 202, 203, 204, 205, 206, 207, 1104, 1104, 490, 491, 492, 493, 494, 495, 496, 497, 224, 225, 1091, 1092, 1093, 1458, 1459, 1460, 1461, 1462, 1463, 1464, 1458, 1459, 1460, 1461, 1462, 1463, 1464, 1465, 1401, 1426, 1427
1522, 1523, 1524, 1525, 1526, 1527, 1362, 1363, 1364, 1365, 1366, 1367, 1368, 1369, 1590, 1591, 1592, 1593, 1216, 1217, 1218, 300, 301, 302, 303, 320, 321, 322, 323, 1104, 1104, 298, 299, 300, 301, 302, 303, 332, 333, 334, 330, 234, 235, 236, 237, 238, 239, 1104, 1104, 522, 362, 363, 364, 365, 366, 367, 368, 369, 267, 1123, 1124, 1125, 1362, 1363, 1364, 1365, 1366, 1367, 1368, 1490, 1491, 1492, 1493, 1494, 1495, 1496, 1497, 1431, 1432, 1433
1554, 1555, 1556, 1557, 1558, 1559, 1394, 1395, 1396, 1397, 1398, 1399, 1400, 1401, 1398, 1399, 1400, 1401, 1248, 1249, 1250, 358, 202, 203, 204, 205, 206, 207, 365, 1104, 1104, 330, 331, 332, 333, 334, 335, 390, 391, 392, 362, 266, 267, 268, 269, 270, 271, 1104, 1104, 554, 394, 395, 396, 397, 398, 399, 400, 401, 325, 1155, 1156, 1157, 1394, 1395, 1396, 1397, 1398, 1399, 1400, 1522, 1523, 1524, 1525, 1526, 1527, 1528, 1529, 1461, 1462, 1463
1586, 1587, 1588, 1589, 1590, 1591, 1426, 1427, 1428, 1429, 1430, 1431, 1432, 1433, 1430, 1431, 1432, 1433, 1088, 1089, 1090, 416, 234, 202, 203, 204, 205, 206, 207, 202, 203, 204, 363, 364, 365, 366, 367, 448, 449, 450, 451, 298, 299, 300, 301, 302, 303, 202, 203, 586, 426, 427, 428, 429, 430, 431, 432, 433, 367, 1187, 1188, 1189, 1426, 1427, 1428, 1429, 1430, 1431, 1432, 1554, 1555, 1556, 1557, 1558, 1559, 1560, 1561, 1491, 1492, 1493
1490, 1491, 1492, 1493, 1494, 1495, 1458, 1459, 1460, 1461, 1462, 1463, 1464, 1465, 1462, 1463, 1464, 1465, 1120, 1121, 1122, 458, 266, 234, 235, 236, 237, 238, 239, 205, 206, 207, 485, 486, 487, 488, 362, 363, 364, 365, 366, 367, 368, 369, 333, 334, 335, 205, 206, 207, 458, 459, 460, 461, 462, 463, 464, 465, 425, 1219, 1220, 1221, 1458, 1459, 1460, 1461, 1462, 1463, 1464, 1586, 1587, 1588, 1589, 1590, 1591, 1592, 1593, 1497, 1522, 1523
1522, 1523, 1524, 1525, 1526, 1527, 1362, 1363, 1364, 1365, 1366, 1367, 1368, 1369, 1494, 1495, 1496, 1497, 1152, 1153, 1154, 4, 298, 266, 267, 268, 269, 270, 271, 202, 203, 204, 15, 32, 33, 34, 394, 395, 396, 397, 398, 399, 400, 401, 365, 366, 367, 202, 203, 204, 490, 491, 492, 493, 494, 495, 496, 497, 483, 1251, 1252, 1253, 1490, 1491, 1492, 1493, 1494, 1495, 1496, 1522, 1523, 1524, 1525, 1526, 1527, 1528, 1529, 1527, 1528, 1529
1554, 1555, 1556, 1557, 1558, 1559, 1394, 1395, 1396, 1397, 1398, 1399, 1400, 1401, 1526, 1527, 1528, 1529, 1184, 1185, 1186, 46, 330, 298, 299, 300, 301, 302, 303, 205, 206, 207, 73, 74, 75, 76, 426, 427, 428, 429, 430, 431, 432, 433, 101, 102, 103, 205, 206, 207, 522, 523, 524, 525, 526, 527, 528, 529, 13, 1283, 1284, 1285, 1522, 1523, 1524, 1525, 1526, 1527, 1528, 1554, 1555, 1556, 1557, 1558, 1559, 1560, 1561, 1165, 1165, 1165
1586, 1587, 1588, 1589, 1590, 1591, 1426, 1427, 1428, 1429, 1430, 1431, 1432, 1433, 1558, 1559, 1560, 1561, 1216, 1217, 1218, 104, 362, 330, 331, 332, 333, 334, 335, 234, 235, 360, 361, 362, 363, 364, 458, 459, 460, 461, 462, 463, 464, 465, 373, 374, 375, 234, 235, 236, 554, 555, 556, 557, 558, 559, 560, 561, 71, 1315, 1316, 1317, 1362, 1363, 1364, 1365, 1366, 1367, 1368, 1586, 1587, 1588, 1589, 1590, 1591, 1592, 1593, 1165, 1165, 1165
1458, 1459, 1460, 1461, 1462, 1463, 1458, 1459, 1460, 1461, 1462, 1463, 1464, 1465, 1590, 1591, 1592, 1593, 1088, 1089, 1090, 162, 163, 362, 363, 364, 365, 366, 367, 170, 171, 392, 393, 394, 395, 396, 490, 491, 492, 493, 494, 495, 496, 497, 405, 406, 407, 295, 296, 298, 586, 587, 588, 589, 590, 591, 592, 593, 129, 1091, 1092, 1093, 1394, 1395, 1396, 1397, 1398, 1399, 1400, 1401, 1165, 1165, 1165, 1165, 1165, 1165, 1165, 1165, 1165, 1165
1490, 1491, 1492, 1493, 1494, 1495, 1490, 1491, 1492, 1493, 1494, 1495, 1496, 1497, 1398, 1399, 1400, 1401, 1120, 1121, 1122, 204, 202, 202, 203, 204, 205, 206, 207, 1104, 1104, 360, 361, 362, 363, 364, 522, 523, 524, 525, 526, 527, 528, 529, 373, 374, 375, 1104, 1104, 330, 331, 332, 333, 334, 335, 168, 169, 170, 171, 1123, 1124, 1125, 1426, 1427, 1428, 1429, 1430, 1431, 1432, 1433, 1165, 1165, 1165, 1165, 1165, 1165, 1165, 1165, 1165, 1165
1522, 1523, 1524, 1525, 1526, 1527, 1362, 1363, 1364, 1365, 1366, 1367, 1368, 1369, 1430, 1431, 1432, 1433, 1152, 1153, 1154, 262, 234, 234, 235, 236, 237, 238, 239, 1104, 1104, 362, 363, 364, 365, 366, 554, 555, 556, 557, 558, 559, 560, 561, 405, 406, 407, 1104, 1104, 362, 363, 362, 363, 364, 365, 366, 367, 368, 369, 1155, 1156, 1157, 1458, 1459, 1460, 1461, 1462, 1463, 1464, 1465, 1165, 1165, 1165, 1165, 1165, 1165, 1165, 1165, 1165, 1165
1554, 1555, 1556, 1557, 1558, 1559, 1394, 1395, 1396, 1397, 1398, 1399, 1400, 1401, 1462, 1463, 1464, 1465, 1184, 1185, 1186, 320, 266, 266, 267, 268, 269, 270, 271, 1104, 1104, 394, 395, 396, 397, 398, 586, 587, 588, 589, 590, 591, 592, 593, 437, 438, 439, 1104, 1104, 266, 267, 394, 395, 396, 397, 398, 399, 400, 401, 1187, 1188, 1189, 1490, 1491, 1492, 1493, 1494, 1495, 1496, 1497, 1165, 1165, 1165, 1165, 1165, 1165, 1165, 1165, 1165, 1165
1586, 1587, 1588, 1589, 1590, 1591, 1426, 1427, 1428, 1429, 1430, 1431, 1432, 1433, 1494, 1495, 1496, 1497, 1216, 1217, 1218, 362, 298, 298, 299, 300, 301, 302, 303, 1104, 1104, 426, 427, 428, 429, 430, 431, 432, 433, 464, 465, 466, 467, 468, 469, 470, 471, 1104, 1104, 298, 299, 426, 427, 428, 429, 430, 431, 432, 433, 1219, 1220, 1221, 1522, 1523, 1524, 1525, 1526, 1527, 1528, 1529, 1165, 1165, 1165, 1165, 1165, 1165, 1165, 1165, 1165, 1165
1522, 1523, 1524, 1525, 1526, 1362, 1363, 1364, 1365, 1366, 1367, 1368, 1369, 1465, 1526, 1527, 1528, 1529, 1088, 1089, 1090, 362, 363, 364, 365, 366, 367, 368, 369, 1104, 1104, 458, 459, 460, 461, 462, 463, 464, 465, 454, 455, 456, 457, 458, 459, 460, 461, 1104, 1104, 330, 331, 458, 459, 460, 461, 462, 463, 464, 465, 1091, 1092, 1093, 1554, 1555, 1556, 1557, 1558, 1559, 1560, 1561, 1165, 1165, 1165, 1165, 1165, 1165, 1165, 1165, 1165, 1165
1554, 1555, 1556, 1557, 1558, 1394, 1395, 1396, 1397, 1398, 1399, 1400, 1401, 1497, 1558, 1559, 1560, 1561, 1120, 1121, 1122, 394, 395, 396, 397, 398, 399, 400, 401, 1104, 1104, 490, 491, 492, 493, 494, 495, 496, 497, 205, 206, 202, 203, 204, 205, 206, 207, 1104, 1104, 362, 363, 490, 491, 492, 493, 494, 495, 496, 497, 1123, 1124, 1125, 1586, 1587, 1588, 1589, 1590, 1591, 1592, 1593, 1165, 1165, 1165, 1165, 1165, 1165, 1165, 1165, 1165, 1165
1586, 1587, 1588, 1589, 1590, 1426, 1427, 1428, 1429, 1430, 1431, 1432, 1433, 1529, 1590, 1591, 1592, 1593, 1152, 1153, 1154, 426, 427, 428, 429, 430, 431, 432, 433, 202, 203, 522, 523, 524, 525, 526, 527, 528, 529, 207, 238, 234, 235, 236, 237, 238, 202, 203, 204, 205, 206, 522, 523, 524, 525, 526, 527, 528, 529, 1155, 1156, 1157, 1165, 1165, 1165, 1165, 1165, 1165, 1165, 1165, 1165, 1165, 1165, 1165, 1165, 1165, 1165, 1165, 1165, 1165
1426, 1427, 1428, 1429, 1430, 1458, 1459, 1460, 1461, 1462, 1463, 1464, 1465, 1561, 1398, 1399, 1400, 1401, 1184, 1185, 1186, 458, 459, 460, 461, 462, 463, 464, 465, 234, 235, 554, 555, 556, 557, 558, 559, 560, 561, 239, 270, 266, 267, 268, 269, 270, 234, 235, 236, 237, 238, 554, 555, 556, 557, 558, 559, 560, 561, 1187, 1188, 1189, 1165, 1165, 1165, 1165, 1165, 1165, 1165, 1165, 1165, 1165, 1165, 1165, 1165, 1165, 1165, 1165, 1165, 1165
1458, 1459, 1460, 1461, 1462, 1490, 1491, 1492, 1493, 1494, 1495, 1496, 1497, 1593, 1430, 1431, 1432, 1433, 1216, 1217, 1218, 490, 491, 492, 493, 494, 495, 496, 497, 368, 369, 586, 587, 588, 589, 590, 591, 592, 593, 360, 361, 362, 363, 360, 361, 362, 363, 364, 365, 366, 367, 586, 587, 588, 589, 590, 591, 592, 593, 1219, 1220, 1221, 1165, 1165, 1165, 1165, 1165, 1165, 1165, 1165, 1165, 1165, 1165, 1165, 1165, 1165, 1165, 1165, 1165, 1165
1490, 1491, 1492, 1493, 1494, 1522, 1523, 1524, 1525, 1526, 1527, 1528, 1529, 1365, 1366, 1367, 1368, 1369, 1248, 1249, 1250, 522, 523, 524, 525, 526, 527, 528, 529, 400, 401, 402, 403, 404, 405, 406, 407, 398, 399, 392, 393, 394, 395, 392, 393, 394, 395, 396, 397, 398, 399, 400, 401, 402, 403, 404, 405, 406, 407, 1251, 1252, 1253, 1165, 1165, 1165, 1165, 1165, 1165, 1165, 1165, 1165, 1165, 1165, 1165, 1165, 1165, 1165, 1165, 1165, 1165
1522, 1523, 1524, 1525, 1526, 1554, 1555, 1556, 1557, 1558, 1559, 1560, 1561, 1369, 1398, 1399, 1400, 1401, 1280, 1281, 1282, 554, 555, 556, 557, 558, 559, 560, 561, 432, 433, 434, 435, 436, 437, 438, 439, 430, 431, 424, 425, 426, 427, 424, 425, 426, 427, 428, 429, 430, 431, 432, 433, 434, 435, 436, 437, 438, 439, 1283, 1284, 1285, 1165, 1165, 1165, 1165, 1165, 1165, 1165, 1165, 1165, 1165, 1165, 1165, 1165, 1165, 1165, 1165, 1165, 1165
1554, 1555, 1556, 1557, 1558, 1586, 1587, 1588, 1589, 1590, 1591, 1592, 1593, 1401, 1430, 1431, 1432, 1433, 1312, 1313, 1314, 586, 587, 588, 589, 590, 591, 592, 593, 464, 465, 466, 467, 468, 469, 470, 471, 462, 463, 456, 457, 458, 459, 456, 457, 458, 459, 460, 461, 462, 463, 464, 465, 466, 467, 468, 469, 470, 471, 1315, 1316, 1317, 1165, 1165, 1165, 1165, 1165, 1165, 1362, 1363, 1364, 1365, 1366, 1367, 1368, 1369, 1364, 1365, 1366, 1367
1586, 1587, 1588, 1589, 1590, 1591, 1592, 1593, 1431, 1432, 1433, 1431, 1432, 1433, 1462, 1463, 1464, 1465, 992, 993, 994, 995, 996, 997, 998, 999, 1000, 1001, 1002, 1003, 1004, 1005, 1006, 999, 1000, 1001, 1002, 1003, 1004, 1005, 1006, 1007, 1008, 1009, 1010, 1011, 1012, 1013, 1014, 1011, 1012, 1013, 1014, 1015, 1016, 1017, 1018, 1019, 1020, 1021, 1022, 1023, 1362, 1363, 1364, 1365, 1366, 1367, 1368, 1369, 1368, 1369, 1398, 1399, 1400, 1401, 1394, 1395, 1396, 1397
1458, 1459, 1460, 1461, 1462, 1463, 1464, 1465, 1463, 1464, 1465, 1463, 1464, 1465, 1494, 1495, 1496, 1497, 1024, 1025, 1026, 1027, 1028, 1029, 1030, 1031, 1032, 1033, 1034, 1035, 1036, 1037, 1038, 1031, 1032, 1033, 1034, 1035, 1036, 1037, 1038, 1039, 1040, 1041, 1042, 1043, 1044, 1045, 1046, 1043, 1044, 1045, 1046, 1047, 1048, 1049, 1050, 1051, 1052, 1053, 1054, 1055, 1394, 1395, 1396, 1397, 1398, 1399, 1400, 1401, 1400, 1401, 1430, 1431, 1432, 1433, 1400, 1401, 1426, 1427
1490, 1491, 1492, 1493, 1494, 1495, 1496, 1497, 1495, 1496, 1497, 1495, 1496, 1497, 1526, 1527, 1528, 1529, 1056, 1057, 1058, 1059, 1060, 1061, 1062, 1063, 1064, 1065, 1066, 1067, 1068, 1069, 1070, 1063, 1064, 1065, 1066, 1067, 1068, 1069, 1070, 1071, 1072, 1073, 1074, 1075, 1076, 1077, 1078, 1075, 1076, 1077, 1078, 1079, 1080, 1081, 1082, 1083, 1084, 1085, 1086, 1087, 1426, 1427, 1428, 1429, 1430, 1431, 1432, 1433, 1432, 1433, 1462, 1463, 1464, 1465, 1430, 1431, 1432, 1433
1522, 1523, 1524, 1525, 1526, 1527, 1528, 1529, 1527, 1528, 1529, 1527, 1528, 1529, 1558, 1559, 1560, 1561, 1363, 1364, 1365, 1366, 1367, 1368, 1369, 1364, 1365, 1366, 1367, 1368, 1369, 1362, 1363, 1364, 1365, 1366, 1367, 1368, 1369, 1362, 1363, 1364, 1365, 1366, 1367, 1368, 1369, 1362, 1363, 1364, 1365, 1366, 1367, 1368, 1369, 1362, 1363, 1364, 1365, 1366, 1367, 1368, 1369, 1459, 1460, 1461, 1462, 1463, 1464, 1465, 1464, 1465, 1494, 1495, 1496, 1497, 1460, 1461, 1462, 1463
1554, 1555, 1556, 1557, 1558, 1559, 1560, 1561, 1559, 1560, 1561, 1559, 1560, 1561, 1590, 1591, 1592, 1593, 1395, 1396, 1397, 1398, 1399, 1400, 1401, 1396, 1397, 1398, 1399, 1400, 1401, 1394, 1395, 1396, 1397, 1398, 1399, 1400, 1401, 1394, 1395, 1396, 1397, 1398, 1399, 1400, 1401, 1394, 1395, 1396, 1397, 1398, 1399, 1400, 1401, 1394, 1395, 1396, 1397, 1398, 1399, 1400, 1401, 1491, 1492, 1493, 1494, 1495, 1496, 1497, 1496, 1497, 1526, 1527, 1528, 1529, 1490, 1491, 1492, 1493
1586, 1587, 1588, 1589, 1590, 1591, 1592, 1593, 1591, 1592, 1593, 1591, 1592, 1593, 1431, 1432, 1433, 1426, 1427, 1428, 1429, 1430, 1431, 1432, 1433, 1428, 1429, 1430, 1431, 1432, 1433, 1426, 1427, 1428, 1429, 1430, 1431, 1432, 1433, 1426, 1427, 1428, 1429, 1430, 1431, 1432, 1433, 1426, 1427, 1428, 1429, 1430, 1431, 1432, 1433, 1426, 1427, 1428, 1429, 1430, 1431, 1432, 1433, 1523, 1524, 1525, 1526, 1527, 1528, 1529, 1528, 1529, 1558, 1559, 1560, 1561, 1496, 1497, 1522, 1523
