7759, 7759, 7759, 7759, 7759, 7759, 7759, 7759, 7759, 7759, 7759, 7759, 7759, 7759, 7759, 7759, 7759, 7759, 7759, 7759, 7759, 7759, 7759, 7759, 7759, 7759, 7759, 7759, 7759, 7759, 7759, 7759, 7759, 7759, 7759, 7759, 7759, 7759, 7759, 7759, 7759, 7759, 7759, 7759, 7759, 7759, 7759, 7759, 7759, 7759, 7759, 7759, 7759, 7759, 7759, 7759, 7759, 7759, 7759, 7759, 7759, 7759, 7759, 7759, 7759, 7759, 7759, 7759, 7759, 7759, 7759, 7759, 7759, 7759, 7759, 7759, 7759, 7759, 7759, 7759
7759, 7759, 7759, 7759, 7759, 7759, 7759, 7759, 7759, 7759, 7759, 7759, 7759, 7759, 7759, 7759, 7759, 7759, 7759, 7759, 7759, 7759, 7759, 7759, 7759, 7759, 7759, 7759, 7759, 7759, 7759, 7759, 7759, 7759, 7759, 7759, 7759, 7759, 7759, 7759, 7759, 7759, 7759, 7759, 7759, 7759, 7759, 7759, 7759, 7759, 7759, 7759, 7759, 7759, 7759, 7759, 7759, 7759, 7759, 7759, 7759, 7759, 7759, 7759, 7759, 7759, 7759, 7759, 7759, 7759, 7759, 7759, 7759, 7759, 7759, 7759, 7759, 7759, 7759, 7759
7759, 7759, 7759, 7759, 7759, 7759, 7759, 7759, 7759, 7759, 7759, 7759, 7759, 7759, 7759, 7759, 7759, 7759, 7759, 7759, 7759, 7759, 7759, 7759, 7759, 7759, 7759, 7759, 7759, 7759, 7759, 7759, 7759, 7759, 7759, 7759, 7759, 7759, 7759, 7759, 7759, 7759, 7759, 7759, 7759, 7759, 7759, 7759, 7759, 7759, 7759, 7759, 7759, 7759, 7759, 7759, 7759, 7759, 7759, 7759, 7759, 7759, 7759, 7759, 7759, 7759, 7759, 7759, 7759, 7759, 7759, 7759, 7759, 7759, 7759, 7759, 7759, 7759, 7759, 7759
7759, 7759, 7759, 7759, 7759, 7759, 7759, 7759, 7759, 7759, 7759, 7759, 7759, 7759, 7759, 7759, 7759, 7759, 7759, 7759, 7759, 7759, 7759, 7759, 7759, 7759, 7759, 7759, 7759, 7759, 7759, 7759, 7759, 7759, 7759, 7759, 7759, 7759, 7759, 7759, 7759, 7759, 7759, 7759, 7759, 7759, 7759, 7759, 7759, 7759, 7759, 7759, 7759, 7759, 7759, 7759, 7759, 7759, 7759, 7759, 7759, 7759, 7759, 7759, 7759, 7759, 7759, 7759, 7759, 7759, 7759, 7759, 7759, 7759, 7759, 7759, 7759, 7759, 7759, 7759
7759, 7759, 7759, 7759, 7759, 7759, 7759, 7759, 7759, 7759, 7759, 7759, 7759, 7759, 7759, 7759, 7759, 7759, 7759, 7759, 7759, 7759, 7759, 7759, 7759, 7759, 7759, 7759, 7759, 7759, 7759, 7759, 7759, 7759, 7759, 7759, 7759, 7759, 7759, 7759, 7759, 7759, 7759, 7759, 7759, 7759, 7759, 7759, 7759, 7759, 7759, 7759, 7759, 7759, 7759, 7759, 7759, 7759, 7759, 7759, 7759, 7759, 7759, 7759, 7759, 7759, 7759, 7759, 7759, 7759, 7759, 7759, 7759, 7759, 7759, 7759, 7759, 7759, 7759, 7759
7759, 7759, 7759, 7759, 7759, 7759, 7759, 7759, 7759, 7759, 7759, 7759, 7759, 7759, 7759, 7759, 7759, 7759, 7759, 7759, 7759, 7759, 7759, 7759, 7759, 7759, 7759, 7759, 7759, 7759, 7759, 7759, 7759, 7759, 7759, 7759, 7759, 7759, 7759, 7759, 7759, 7759, 7759, 7759, 7759, 7759, 7759, 7759, 7759, 7759, 7759, 7759, 7759, 7759, 7759, 7759, 7759, 7759, 7759, 7759, 7759, 7759, 7759, 7759, 7759, 7759, 7759, 7759, 7759, 7759, 7759, 7759, 7759, 7759, 7759, 7759, 7759, 7759, 7759, 7759
7759, 7759, 7759, 7759, 7759, 7759, 7759, 7759, 7759, 7759, 7759, 7759, 7759, 7759, 7759, 7759, 7759, 7759, 7759, 7759, 7759, 7759, 7759, 7759, 7759, 7759, 7759, 7759, 7759, 7759, 7759, 7759, 7759, 7759, 7759, 7759, 7759, 7759, 7759, 7759, 7759, 7759, 7759, 7759, 7759, 7759, 7759, 7759, 7759, 7759, 7759, 7759, 7759, 7759, 7759, 7759, 7759, 7759, 7759, 7759, 7759, 7759, 7759, 7759, 7759, 7759, 7759, 7759, 7759, 7759, 7759, 7759, 7759, 7759, 7759, 7759, 7759, 7759, 7759, 7759
7759, 7759, 7759, 7759, 7759, 7759, 7759, 7759, 7759, 7759, 7759, 7759, 7759, 7759, 7759, 7759, 7759, 7759, 7759, 7759, 7759, 7759, 7759, 7759, 7759, 7759, 7759, 7759, 7759, 7759, 7759, 7759, 7759, 7759, 7759, 7759, 7759, 7759, 7759, 7759, 7759, 7759, 7759, 7759, 7759, 7759, 7759, 7759, 7759, 7759, 7759, 7759, 7759, 7759, 7759, 7759, 7759, 7759, 7759, 7759, 7759, 7759, 7759, 7759, 7759, 7759, 7759, 7759, 7759, 7759, 7759, 7759, 7759, 7759, 7759, 7759, 7759, 7759, 7759, 7759
7759, 7759, 7759, 7759, 7759, 7759, 7759, 7759, 7759, 7759, 7759, 7759, 7759, 7759, 7759, 7759, 7759, 7759, 7759, 5684, 5685, 5365, 5366, 5367, 5368, 5369, 5370, 5371, 5372, 5364, 5365, 5366, 5367, 5368, 5369, 5370, 5371, 5372, 5373, 5374, 5375, 5376, 5377, 5378, 5379, 5380, 5381, 5382, 5383, 5384, 5385, 5386, 5387, 5388, 5389, 5390, 5391, 5392, 5393, 5686, 5687, 7759, 7759, 7759, 7759, 7759, 7759, 7759, 7759, 7759, 7759, 7759, 7759, 7759, 7759, 7759, 7759, 7759, 7759, 7759
7759, 7759, 7759, 7759, 7759, 7759, 7759, 7759, 7759, 7759, 7759, 7759, 7759, 7759, 7759, 7759, 7759, 7759, 7759, 5764, 5765, 5445, 5446, 5447, 5448, 5449, 5450, 5451, 5452, 5444, 5445, 5446, 5447, 5448, 5449, 5450, 5451, 5452, 5453, 5454, 5455, 5456, 5457, 5458, 5459, 5460, 5461, 5462, 5463, 5464, 5465, 5466, 5467, 5468, 5469, 5470, 5471, 5472, 5473, 5766, 5767, 7759, 7759, 7759, 7759, 7759, 7759, 7759, 7759, 7759, 7759, 7759, 7759, 7759, 7759, 7759, 7759, 7759, 7759, 7759
7759, 7759, 7759, 7759, 7759, 7759, 7759, 7759, 7759, 7759, 7759, 7759, 7759, 7759, 7759, 7759, 7759, 7759, 7759, 5520, 5521, 166, 167, 168, 169, 170, 171, 172, 173, 174, 175, 176, 0, 0, 0, 0, 0, 5040, 5040, 0, 0, 0, 0, 0, 0, 0, 0, 0, 0, 0, 0, 0, 0, 0, 0, 0, 0, 0, 0, 5522, 5523, 7759, 7759, 7759, 7759, 7759, 7759, 7759, 7759, 7759, 7759, 7759, 7759, 7759, 7759, 7759, 7759, 7759, 7759, 7759
7759, 7759, 7759, 7759, 7759, 7759, 7759, 7759, 7759, 7759, 7759, 7759, 7759, 7759, 7759, 7759, 7759, 7759, 7759, 5600, 5601, 246, 247, 248, 249, 250, 251, 252, 253, 254, 255, 256, 0, 0, 0, 0, 0, 0, 0, 0, 0, 0, 0, 0, 0, 0, 0, 0, 0, 0, 0, 0, 0, 0, 658, 659, 660, 661, 0, 5602, 5603, 7759, 7759, 7759, 7759, 7759, 7759, 7759, 7759, 7759, 7759, 7759, 7759, 7759, 7759, 7759, 7759, 7759, 7759, 7759
7759, 7759, 7759, 7759, 7759, 7759, 7759, 7759, 7759, 7759, 7759, 7759, 7759, 7759, 7759, 7759, 7759, 7759, 7759, 5680, 5681, 326, 327, 328, 329, 330, 331, 332, 333, 334, 335, 336, 1622, 1623, 1624, 1625, 1626, 1627, 1628, 1629, 1622, 1623, 1624, 1625, 1626, 1627, 1628, 1622, 1623, 1624, 1625, 1626, 1627, 1628, 1629, 691, 692, 693, 0, 5682, 5683, 7759, 7759, 7759, 7759, 7759, 7759, 7759, 7759, 7759, 7759, 7759, 7759, 7759, 7759, 7759, 7759, 7759, 7759, 7759
7759, 7759, 7759, 7759, 7759, 7759, 7759, 7759, 7759, 7759, 7759, 7759, 7759, 7759, 7759, 7759, 7759, 7759, 7759, 5760, 5761, 406, 407, 408, 409, 410, 411, 412, 413, 414, 415, 416, 1702, 1703, 1704, 1705, 1706, 1707, 1708, 1709, 1702, 1703, 1704, 1705, 1706, 1707, 1708, 1702, 1703, 1704, 1705, 1706, 1707, 1708, 1709, 723, 724, 725, 3, 5762, 5763, 7759, 7759, 7759, 7759, 7759, 7759, 7759, 7759, 7759, 7759, 7759, 7759, 7759, 7759, 7759, 7759, 7759, 7759, 7759
7759, 7759, 7759, 7759, 7759, 7759, 7759, 7759, 7759, 7759, 7759, 7759, 7759, 7759, 7759, 7759, 7759, 7759, 7759, 5840, 5841, 486, 487, 488, 489, 490, 491, 492, 493, 494, 495, 496, 1782, 1783, 1784, 1785, 1786, 1787, 1788, 1789, 1782, 1783, 1784, 1785, 1786, 1787, 1788, 1782, 1783, 1784, 1785, 1786, 1787, 1788, 1789, 755, 756, 757, 35, 5842, 5843, 7759, 7759, 7759, 7759, 7759, 7759, 7759, 7759, 7759, 7759, 7759, 7759, 7759, 7759, 7759, 7759, 7759, 7759, 7759
7759, 7759, 7759, 7759, 7759, 7759, 7759, 7759, 7759, 7759, 7759, 7759, 7759, 7759, 7759, 7759, 7759, 7759, 7759, 5920, 5921, 566, 567, 568, 569, 570, 571, 572, 573, 574, 575, 576, 1862, 1863, 1864, 1865, 1866, 1867, 1868, 1869, 1862, 1863, 1864, 1865, 1866, 1867, 1868, 1862, 1863, 1864, 1865, 1866, 1867, 1868, 1869, 64, 65, 66, 67, 5922, 5923, 7759, 7759, 7759, 7759, 7759, 7759, 7759, 7759, 7759, 7759, 7759, 7759, 7759, 7759, 7759, 7759, 7759, 7759, 7759
7759, 7759, 7759, 7759, 7759, 7759, 7759, 7759, 7759, 7759, 7759, 7759, 7759, 7759, 7759, 7759, 7759, 7759, 7759, 6000, 6001, 646, 647, 648, 649, 650, 651, 652, 653, 654, 655, 656, 1942, 1943, 1944, 1945, 1946, 1947, 1948, 1949, 1942, 1943, 1944, 1945, 1946, 1947, 1948, 1942, 1943, 1944, 1945, 1946, 1947, 1948, 1949, 7774, 7775, 7774, 7775, 6002, 6003, 7759, 7759, 7759, 7759, 7759, 7759, 7759, 7759, 7759, 7759, 7759, 7759, 7759, 7759, 7759, 7759, 7759, 7759, 7759
7759, 7759, 7759, 7759, 7759, 7759, 7759, 7759, 7759, 7759, 7759, 7759, 7759, 7759, 7759, 7759, 7759, 7759, 7759, 6080, 6081, 726, 727, 728, 729, 730, 731, 732, 733, 734, 735, 736, 2022, 2023, 2024, 2025, 2026, 2027, 2028, 2029, 2022, 2023, 2024, 2025, 2026, 2027, 2028, 2022, 2023, 2024, 2025, 2026, 2027, 2028, 2029, 7774, 7775, 7774, 7775, 6082, 6083, 7759, 7759, 7759, 7759, 7759, 7759, 7759, 7759, 7759, 7759, 7759, 7759, 7759, 7759, 7759, 7759, 7759, 7759, 7759
7759, 7759, 7759, 7759, 7759, 7759, 7759, 7759, 7759, 7759, 7759, 7759, 7759, 7759, 7759, 7759, 7759, 7759, 7759, 6160, 6161, 806, 807, 808, 809, 810, 811, 812, 813, 814, 815, 816, 2102, 2103, 2104, 2105, 2106, 2107, 2108, 2109, 2102, 2103, 2104, 2105, 2106, 2107, 2108, 2102, 2103, 2104, 2105, 2106, 2107, 2108, 2109, 7854, 7855, 7854, 7855, 6162, 6163, 7759, 7759, 7759, 7759, 7759, 7759, 7759, 7759, 7759, 7759, 7759, 7759, 7759, 7759, 7759, 7759, 7759, 7759, 7759
7759, 7759, 7759, 7759, 7759, 7759, 7759, 7759, 7759, 7759, 7759, 7759, 7759, 7759, 7759, 7759, 7759, 7759, 7759, 6240, 6241, 886, 887, 888, 889, 890, 891, 892, 893, 894, 895, 896, 2182, 2183, 2184, 2185, 2186, 2187, 2188, 2189, 2182, 2183, 2184, 2185, 2186, 2187, 2188, 2182, 2183, 2184, 2185, 1622, 1623, 1624, 1625, 1626, 1627, 1628, 1629, 6242, 6243, 7759, 7759, 7759, 7759, 7759, 7759, 7759, 7759, 7759, 7759, 7759, 7759, 7759, 7759, 7759, 7759, 7759, 7759, 7759
7759, 7759, 7759, 7759, 7759, 7759, 7759, 7759, 7759, 7759, 7759, 7759, 7759, 7759, 7759, 7759, 7759, 7759, 7759, 6320, 6321, 966, 967, 968, 969, 970, 971, 972, 973, 974, 975, 976, 267, 268, 269, 270, 271, 256, 257, 258, 259, 260, 261, 262, 263, 264, 265, 266, 267, 268, 269, 1702, 1703, 1704, 1705, 1706, 1707, 1708, 1709, 6322, 6323, 7759, 7759, 7759, 7759, 7759, 7759, 7759, 7759, 7759, 7759, 7759, 7759, 7759, 7759, 7759, 7759, 7759, 7759, 7759
7759, 7759, 7759, 7759, 7759, 7759, 7759, 7759, 7759, 7759, 7759, 7759, 7759, 7759, 7759, 7759, 7759, 7759, 7759, 6400, 6401, 1046, 1047, 1048, 1049, 1050, 1051, 1052, 1053, 1054, 1055, 1056, 299, 300, 5133, 5214, 5214, 5214, 5214, 5214, 5214, 5214, 5214, 5214, 5136, 5137, 504, 505, 504, 505, 301, 1782, 1783, 1784, 1785, 1786, 1787, 1788, 1789, 6402, 6403, 7759, 7759, 7759, 7759, 7759, 7759, 7759, 7759, 7759, 7759, 7759, 7759, 7759, 7759, 7759, 7759, 7759, 7759, 7759
7759, 7759, 7759, 7759, 7759, 7759, 7759, 7759, 7759, 7759, 7759, 7759, 7759, 7759, 7759, 7759, 7759, 7759, 7759, 6480, 6481, 1623, 1624, 1625, 1626, 1627, 1628, 1629, 1628, 1629, 329, 330, 331, 332, 5214, 5214, 5214, 5214, 5214, 5214, 5214, 5214, 5214, 5214, 5214, 5214, 584, 585, 584, 585, 333, 1862, 1863, 1864, 1865, 1866, 1867, 1868, 1869, 6482, 6483, 7759, 7759, 7759, 7759, 7759, 7759, 7759, 7759, 7759, 7759, 7759, 7759, 7759, 7759, 7759, 7759, 7759, 7759, 7759
7759, 7759, 7759, 7759, 7759, 7759, 7759, 7759, 7759, 7759, 7759, 7759, 7759, 7759, 7759, 7759, 7759, 7759, 7759, 6560, 6561, 1703, 1704, 1705, 1706, 1707, 1708, 1709, 1708, 1709, 361, 362, 363, 364, 5214, 5214, 5214, 5214, 5214, 5214, 5214, 5214, 5214, 5214, 5214, 5214, 361, 362, 363, 504, 505, 1942, 1943, 1944, 1945, 1946, 1947, 1948, 1949, 6562, 6563, 7759, 7759, 7759, 7759, 7759, 7759, 7759, 7759, 7759, 7759, 7759, 7759, 7759, 7759, 7759, 7759, 7759, 7759, 7759
7759, 7759, 7759, 7759, 7759, 7759, 7759, 7759, 7759, 7759, 7759, 7759, 7759, 7759, 7759, 7759, 7759, 7759, 7759, 6640, 6641, 1783, 1784, 1785, 1786, 1787, 1788, 1789, 1788, 1789, 393, 394, 5133, 5214, 5214, 5214, 5214, 5214, 5214, 5214, 5214, 5214, 5214, 5214, 5214, 5214, 5214, 5214, 5214, 584, 585, 2022, 2023, 2024, 2025, 2026, 2027, 2028, 2029, 6642, 6643, 7759, 7759, 7759, 7759, 7759, 7759, 7759, 7759, 7759, 7759, 7759, 7759, 7759, 7759, 7759, 7759, 7759, 7759, 7759
7759, 7759, 7759, 7759, 7759, 7759, 7759, 7759, 7759, 7759, 7759, 7759, 7759, 7759, 7759, 7759, 7759, 7759, 7759, 6720, 6721, 1863, 1864, 1865, 1866, 1867, 1868, 1869, 1868, 1869, 5133, 5214, 5214, 5214, 5214, 5214, 5214, 5214, 5214, 5214, 5214, 5214, 5214, 5214, 5214, 5214, 5214, 5214, 5214, 428, 429, 2102, 2103, 2104, 2105, 2106, 2107, 2108, 2109, 6722, 6723, 7759, 7759, 7759, 7759, 7759, 7759, 7759, 7759, 7759, 7759, 7759, 7759, 7759, 7759, 7759, 7759, 7759, 7759, 7759
7759, 7759, 7759, 7759, 7759, 7759, 7759, 7759, 7759, 7759, 7759, 7759, 7759, 7759, 7759, 7759, 7759, 7759, 7759, 5360, 5361, 1943, 1944, 1945, 1946, 1947, 1948, 1949, 1948, 1949, 5214, 5214, 5214, 5214, 5214, 5214, 5214, 5214, 5214, 5214, 5214, 5214, 5214, 5214, 5214, 5214, 5214, 5214, 5214, 5214, 5214, 2182, 2183, 2184, 2185, 2186, 2187, 2188, 2189, 5362, 5363, 7759, 7759, 7759, 7759, 7759, 7759, 7759, 7759, 7759, 7759, 7759, 7759, 7759, 7759, 7759, 7759, 7759, 7759, 7759
7759, 7759, 7759, 7759, 7759, 7759, 7759, 7759, 7759, 7759, 7759, 7759, 7759, 7759, 7759, 7759, 7759, 7759, 7759, 5440, 5441, 2023, 2024, 2025, 2026, 2027, 2028, 2029, 2028, 2029, 5214, 5214, 5214, 5214, 5214, 5214, 5214, 5214, 5214, 5214, 5214, 5214, 5214, 5214, 5214, 5214, 5214, 5214, 5214, 5214, 5214, 1622, 1623, 1624, 1625, 1626, 1627, 1628, 1629, 5442, 5443, 7759, 7759, 7759, 7759, 7759, 7759, 7759, 7759, 7759, 7759, 7759, 7759, 7759, 7759, 7759, 7759, 7759, 7759, 7759
7759, 7759, 7759, 7759, 7759, 7759, 7759, 7759, 7759, 7759, 7759, 7759, 7759, 7759, 7759, 7759, 7759, 7759, 7759, 5520, 5521, 2103, 2104, 2105, 2106, 2107, 2108, 2109, 2108, 2109, 5292, 5293, 5214, 5214, 5214, 5214, 5214, 5214, 5214, 5214, 5214, 5214, 5214, 5214, 5214, 5214, 5214, 5214, 5214, 5295, 5296, 1702, 1703, 1704, 1705, 1706, 1707, 1708, 1709, 5522, 5523, 7759, 7759, 7759, 7759, 7759, 7759, 7759, 7759, 7759, 7759, 7759, 7759, 7759, 7759, 7759, 7759, 7759, 7759, 7759
7759, 7759, 7759, 7759, 7759, 7759, 7759, 7759, 7759, 7759, 7759, 7759, 7759, 7759, 7759, 7759, 7759, 7759, 7759, 5600, 5601, 2183, 2184, 2185, 2186, 2187, 2188, 2189, 2188, 2189, 1376, 1377, 1377, 1376, 1377, 1376, 1377, 1376, 1377, 1376, 1377, 1376, 1377, 1376, 1377, 1376, 1377, 1376, 1377, 1376, 1377, 1782, 1783, 1784, 1785, 1786, 1787, 1788, 1789, 5602, 5603, 7759, 7759, 7759, 7759, 7759, 7759, 7759, 7759, 7759, 7759, 7759, 7759, 7759, 7759, 7759, 7759, 7759, 7759, 7759
7759, 7759, 7759, 7759, 7759, 7759, 7759, 7759, 7759, 7759, 7759, 7759, 7759, 7759, 7759, 7759, 7759, 7759, 7759, 5680, 5681, 1622, 1623, 1624, 1625, 1626, 1627, 1628, 1629, 108, 1456, 1457, 1457, 1456, 1457, 1456, 1457, 1456, 1457, 1456, 1457, 1456, 1457, 1456, 1457, 1456, 1457, 1456, 1457, 1456, 1457, 1862, 1863, 1864, 1865, 1866, 1867, 1868, 1869, 5682, 5683, 7759, 7759, 7759, 7759, 7759, 7759, 7759, 7759, 7759, 7759, 7759, 7759, 7759, 7759, 7759, 7759, 7759, 7759, 7759
7759, 7759, 7759, 7759, 7759, 7759, 7759, 7759, 7759, 7759, 7759, 7759, 7759, 7759, 7759, 7759, 7759, 7759, 7759, 5760, 5761, 1702, 1703, 1704, 1705, 1706, 1707, 1708, 1709, 1629, 1536, 1537, 1536, 1537, 1536, 1537, 1536, 1537, 1536, 1537, 1536, 1537, 1536, 1537, 1536, 1537, 1536, 1537, 1536, 1536, 1537, 1942, 1943, 1944, 1945, 1946, 1947, 1948, 1949, 5762, 5763, 7759, 7759, 7759, 7759, 7759, 7759, 7759, 7759, 7759, 7759, 7759, 7759, 7759, 7759, 7759, 7759, 7759, 7759, 7759
7759, 7759, 7759, 7759, 7759, 7759, 7759, 7759, 7759, 7759, 7759, 7759, 7759, 7759, 7759, 7759, 7759, 7759, 7759, 5840, 5841, 1782, 1783, 1784, 1785, 1786, 1787, 1788, 1789, 1709, 1616, 1617, 1616, 1617, 1616, 1617, 1616, 1617, 1616, 1617, 1616, 1617, 1616, 1617, 1616, 1617, 1616, 1617, 1616, 1616, 1617, 2022, 2023, 2024, 2025, 2026, 2027, 2028, 2029, 5842, 5843, 7759, 7759, 7759, 7759, 7759, 7759, 7759, 7759, 7759, 7759, 7759, 7759, 7759, 7759, 7759, 7759, 7759, 7759, 7759
7759, 7759, 7759, 7759, 7759, 7759, 7759, 7759, 7759, 7759, 7759, 7759, 7759, 7759, 7759, 7759, 7759, 7759, 7759, 5920, 5921, 1862, 1863, 1864, 1865, 1866, 1867, 1868, 1869, 1789, 5133, 5214, 5214, 5214, 5214, 5214, 5214, 5214, 5214, 5214, 5214, 5214, 5214, 5214, 5214, 5214, 5214, 5214, 5214, 5136, 5137, 2102, 2103, 2104, 2105, 2106, 2107, 2108, 2109, 5922, 5923, 7759, 7759, 7759, 7759, 7759, 7759, 7759, 7759, 7759, 7759, 7759, 7759, 7759, 7759, 7759, 7759, 7759, 7759, 7759
7759, 7759, 7759, 7759, 7759, 7759, 7759, 7759, 7759, 7759, 7759, 7759, 7759, 7759, 7759, 7759, 7759, 7759, 7759, 6000, 6001, 1942, 1943, 1944, 1945, 1946, 1947, 1948, 1949, 1869, 5214, 5214, 5214, 5214, 5214, 5214, 5214, 5214, 5214, 5214, 5214, 5214, 5214, 5214, 5214, 5214, 5214, 5214, 5214, 5214, 5214, 2182, 2183, 2184, 2185, 2186, 2187, 2188, 2189, 6002, 6003, 7759, 7759, 7759, 7759, 7759, 7759, 7759, 7759, 7759, 7759, 7759, 7759, 7759, 7759, 7759, 7759, 7759, 7759, 7759
7759, 7759, 7759, 7759, 7759, 7759, 7759, 7759, 7759, 7759, 7759, 7759, 7759, 7759, 7759, 7759, 7759, 7759, 7759, 6080, 6081, 2022, 2023, 2024, 2025, 2026, 2027, 2028, 2029, 1949, 5214, 5214, 5214, 5214, 5214, 5214, 5214, 5214, 5214, 5214, 5214, 5214, 5214, 5214, 5214, 5214, 5214, 5214, 5214, 5214, 5214, 1622, 1623, 1624, 1625, 1626, 1627, 1628, 1629, 6082, 6083, 7759, 7759, 7759, 7759, 7759, 7759, 7759, 7759, 7759, 7759, 7759, 7759, 7759, 7759, 7759, 7759, 7759, 7759, 7759
7759, 7759, 7759, 7759, 7759, 7759, 7759, 7759, 7759, 7759, 7759, 7759, 7759, 7759, 7759, 7759, 7759, 7759, 7759, 6160, 6161, 2102, 2103, 2104, 2105, 2106, 2107, 2108, 2109, 2029, 5292, 5293, 5214, 5214, 5214, 5214, 5214, 5214, 5214, 5214, 5214, 5214, 5214, 5214, 5214, 5214, 5214, 5214, 5214, 5214, 5214, 1702, 1703, 1704, 1705, 1706, 1707, 1708, 1709, 6162, 6163, 7759, 7759, 7759, 7759, 7759, 7759, 7759, 7759, 7759, 7759, 7759, 7759, 7759, 7759, 7759, 7759, 7759, 7759, 7759
7759, 7759, 7759, 7759, 7759, 7759, 7759, 7759, 7759, 7759, 7759, 7759, 7759, 7759, 7759, 7759, 7759, 7759, 7759, 6240, 6241, 2182, 2183, 2184, 2185, 2186, 2187, 2188, 2189, 2109, 483, 484, 5214, 5214, 5214, 5214, 5214, 5214, 5214, 5214, 5214, 5214, 5214, 5214, 5214, 5214, 5214, 5214, 5214, 5296, 5297, 1782, 1783, 1784, 1785, 1786, 1787, 1788, 1789, 6242, 6243, 7759, 7759, 7759, 7759, 7759, 7759, 7759, 7759, 7759, 7759, 7759, 7759, 7759, 7759, 7759, 7759, 7759, 7759, 7759
7759, 7759, 7759, 7759, 7759, 7759, 7759, 7759, 7759, 7759, 7759, 7759, 7759, 7759, 7759, 7759, 7759, 7759, 7759, 6320, 6321, 4, 2182, 2183, 2184, 2185, 2186, 2187, 2188, 2189, 13, 14, 5292, 5293, 5214, 5214, 5214, 5214, 5214, 5214, 5214, 5214, 5214, 5214, 5214, 5214, 5214, 5214, 5296, 458, 459, 1862, 1863, 1864, 1865, 1866, 1867, 1868, 1869, 6322, 6323, 7759, 7759, 7759, 7759, 7759, 7759, 7759, 7759, 7759, 7759, 7759, 7759, 7759, 7759, 7759, 7759, 7759, 7759, 7759
7759, 7759, 7759, 7759, 7759, 7759, 7759, 7759, 7759, 7759, 7759, 7759, 7759, 7759, 7759, 7759, 7759, 7759, 7759, 6400, 6401, 46, 47, 64, 65, 66, 67, 1622, 1623, 1624, 1625, 1626, 1627, 1628, 1629, 5214, 5214, 5214, 5214, 5214, 5214, 5214, 5214, 5214, 5214, 5214, 5214, 231, 232, 4, 5, 1942, 1943, 1944, 1945, 1946, 1947, 1948, 1949, 6402, 6403, 7759, 7759, 7759, 7759, 7759, 7759, 7759, 7759, 7759, 7759, 7759, 7759, 7759, 7759, 7759, 7759, 7759, 7759, 7759
7759, 7759, 7759, 7759, 7759, 7759, 7759, 7759, 7759, 7759, 7759, 7759, 7759, 7759, 7759, 7759, 7759, 7759, 7759, 6480, 6481, 104, 105, 106, 107, 108, 109, 1702, 1703, 1704, 1705, 1706, 1707, 1708, 1709, 5292, 5293, 5214, 5214, 5214, 5214, 5214, 5214, 5214, 5295, 5296, 5297, 263, 264, 46, 47, 2022, 2023, 2024, 2025, 2026, 2027, 2028, 2029, 6482, 6483, 7759, 7759, 7759, 7759, 7759, 7759, 7759, 7759, 7759, 7759, 7759, 7759, 7759, 7759, 7759, 7759, 7759, 7759, 7759
7759, 7759, 7759, 7759, 7759, 7759, 7759, 7759, 7759, 7759, 7759, 7759, 7759, 7759, 7759, 7759, 7759, 7759, 7759, 6560, 6561, 162, 163, 164, 165, 166, 167, 1782, 1783, 1784, 1785, 1786, 1787, 1788, 1789, 192, 193, 194, 195, 196, 197, 198, 199, 200, 201, 202, 203, 295, 296, 104, 105, 2102, 2103, 2104, 2105, 2106, 2107, 2108, 2109, 6562, 6563, 7759, 7759, 7759, 7759, 7759, 7759, 7759, 7759, 7759, 7759, 7759, 7759, 7759, 7759, 7759, 7759, 7759, 7759, 7759
7759, 7759, 7759, 7759, 7759, 7759, 7759, 7759, 7759, 7759, 7759, 7759, 7759, 7759, 7759, 7759, 7759, 7759, 7759, 6640, 6641, 204, 205, 206, 207, 165, 166, 1862, 1863, 1864, 1865, 1866, 1867, 1868, 1869, 175, 176, 251, 252, 253, 251, 252, 253, 254, 255, 256, 257, 165, 166, 167, 168, 2182, 2183, 2184, 2185, 2186, 2187, 2188, 2189, 6642, 6643, 7759, 7759, 7759, 7759, 7759, 7759, 7759, 7759, 7759, 7759, 7759, 7759, 7759, 7759, 7759, 7759, 7759, 7759, 7759
7759, 7759, 7759, 7759, 7759, 7759, 7759, 7759, 7759, 7759, 7759, 7759, 7759, 7759, 7759, 7759, 7759, 7759, 7759, 6720, 6721, 262, 263, 264, 265, 245, 246, 1942, 1943, 1944, 1945, 1946, 1947, 1948, 1949, 255, 256, 331, 332, 333, 331, 332, 333, 334, 335, 336, 337, 245, 246, 247, 248, 249, 250, 251, 252, 253, 254, 255, 256, 6722, 6723, 7759, 7759, 7759, 7759, 7759, 7759, 7759, 7759, 7759, 7759, 7759, 7759, 7759, 7759, 7759, 7759, 7759, 7759, 7759
7759, 7759, 7759, 7759, 7759, 7759, 7759, 7759, 7759, 7759, 7759, 7759, 7759, 7759, 7759, 7759, 7759, 7759, 7759, 6800, 6801, 320, 321, 322, 323, 325, 326, 2022, 2023, 2024, 2025, 2026, 2027, 2028, 2029, 335, 336, 411, 412, 413, 411, 412, 413, 414, 415, 416, 417, 325, 326, 327, 328, 329, 330, 331, 332, 333, 334, 335, 336, 6802, 6803, 7759, 7759, 7759, 7759, 7759, 7759, 7759, 7759, 7759, 7759, 7759, 7759, 7759, 7759, 7759, 7759, 7759, 7759, 7759
7759, 7759, 7759, 7759, 7759, 7759, 7759, 7759, 7759, 7759, 7759, 7759, 7759, 7759, 7759, 7759, 7759, 7759, 7759, 6880, 6881, 7774, 7775, 7774, 7775, 405, 406, 2102, 2103, 2104, 2105, 2106, 2107, 2108, 2109, 415, 416, 491, 492, 493, 491, 492, 493, 494, 495, 496, 497, 405, 406, 407, 408, 409, 410, 411, 412, 413, 414, 415, 416, 6882, 6883, 7759, 7759, 7759, 7759, 7759, 7759, 7759, 7759, 7759, 7759, 7759, 7759, 7759, 7759, 7759, 7759, 7759, 7759, 7759
7759, 7759, 7759, 7759, 7759, 7759, 7759, 7759, 7759, 7759, 7759, 7759, 7759, 7759, 7759, 7759, 7759, 7759, 7759, 6960, 6961, 7854, 7855, 7854, 7855, 485, 486, 2182, 2183, 2184, 2185, 2186, 2187, 2188, 2189, 495, 496, 571, 572, 573, 571, 572, 573, 574, 575, 576, 577, 485, 486, 487, 488, 489, 490, 491, 492, 493, 494, 495, 496, 6962, 6963, 7759, 7759, 7759, 7759, 7759, 7759, 7759, 7759, 7759, 7759, 7759, 7759, 7759, 7759, 7759, 7759, 7759, 7759, 7759
7759, 7759, 7759, 7759, 7759, 7759, 7759, 7759, 7759, 7759, 7759, 7759, 7759, 7759, 7759, 7759, 7759, 7759, 7759, 7040, 7041, 462, 463, 480, 481, 565, 566, 567, 568, 569, 570, 571, 572, 573, 574, 575, 576, 251, 252, 253, 251, 252, 253, 254, 255, 251, 252, 253, 254, 255, 256, 257, 570, 571, 572, 573, 574, 575, 576, 7042, 7043, 7759, 7759, 7759, 7759, 7759, 7759, 7759, 7759, 7759, 7759, 7759, 7759, 7759, 7759, 7759, 7759, 7759, 7759, 7759
7759, 7759, 7759, 7759, 7759, 7759, 7759, 7759, 7759, 7759, 7759, 7759, 7759, 7759, 7759, 7759, 7759, 7759, 7759, 7120, 7121, 8, 9, 10, 11, 645, 646, 647, 648, 649, 650, 651, 652, 653, 654, 655, 656, 331, 332, 333, 331, 332, 333, 334, 335, 331, 332, 333, 334, 335, 336, 337, 650, 651, 652, 653, 654, 655, 656, 7122, 7123, 7759, 7759, 7759, 7759, 7759, 7759, 7759, 7759, 7759, 7759, 7759, 7759, 7759, 7759, 7759, 7759, 7759, 7759, 7759
7759, 7759, 7759, 7759, 7759, 7759, 7759, 7759, 7759, 7759, 7759, 7759, 7759, 7759, 7759, 7759, 7759, 7759, 7759, 7200, 7201, 66, 658, 659, 660, 725, 726, 727, 728, 729, 730, 731, 732, 733, 734, 735, 736, 411, 412, 413, 411, 412, 413, 414, 415, 411, 412, 413, 414, 415, 416, 417, 730, 731, 732, 733, 734, 735, 736, 7202, 7203, 7759, 7759, 7759, 7759, 7759, 7759, 7759, 7759, 7759, 7759, 7759, 7759, 7759, 7759, 7759, 7759, 7759, 7759, 7759
7759, 7759, 7759, 7759, 7759, 7759, 7759, 7759, 7759, 7759, 7759, 7759, 7759, 7759, 7759, 7759, 7759, 7759, 7759, 7280, 7281, 108, 690, 691, 692, 805, 806, 807, 808, 809, 810, 811, 812, 813, 814, 815, 816, 491, 492, 493, 491, 492, 493, 494, 495, 491, 492, 493, 494, 495, 496, 497, 810, 811, 812, 813, 814, 815, 816, 7282, 7283, 7759, 7759, 7759, 7759, 7759, 7759, 7759, 7759, 7759, 7759, 7759, 7759, 7759, 7759, 7759, 7759, 7759, 7759, 7759
7759, 7759, 7759, 7759, 7759, 7759, 7759, 7759, 7759, 7759, 7759, 7759, 7759, 7759, 7759, 7759, 7759, 7759, 7759, 7360, 7361, 166, 722, 723, 724, 885, 886, 887, 888, 889, 890, 891, 892, 893, 894, 895, 896, 571, 572, 573, 571, 572, 573, 574, 575, 571, 572, 573, 574, 575, 576, 577, 890, 891, 892, 893, 894, 895, 896, 7362, 7363, 7759, 7759, 7759, 7759, 7759, 7759, 7759, 7759, 7759, 7759, 7759, 7759, 7759, 7759, 7759, 7759, 7759, 7759, 7759
7759, 7759, 7759, 7759, 7759, 7759, 7759, 7759, 7759, 7759, 7759, 7759, 7759, 7759, 7759, 7759, 7759, 7759, 7759, 7440, 7441, 224, 754, 755, 756, 965, 966, 967, 968, 969, 970, 971, 972, 973, 974, 975, 976, 651, 652, 653, 651, 652, 653, 654, 655, 651, 652, 653, 654, 655, 656, 657, 970, 971, 972, 973, 974, 975, 976, 7442, 7443, 7759, 7759, 7759, 7759, 7759, 7759, 7759, 7759, 7759, 7759, 7759, 7759, 7759, 7759, 7759, 7759, 7759, 7759, 7759
7759, 7759, 7759, 7759, 7759, 7759, 7759, 7759, 7759, 7759, 7759, 7759, 7759, 7759, 7759, 7759, 7759, 7759, 7759, 7520, 5844, 5845, 267, 268, 269, 1045, 1046, 1047, 1048, 1049, 1050, 1051, 1052, 1053, 1054, 1055, 1056, 731, 732, 733, 731, 732, 733, 734, 735, 731, 732, 733, 734, 735, 736, 737, 1050, 1051, 1052, 1053, 1054, 1055, 1056, 5846, 5847, 7759, 7759, 7759, 7759, 7759, 7759, 7759, 7759, 7759, 7759, 7759, 7759, 7759, 7759, 7759, 7759, 7759, 7759, 7759
7759, 7759, 7759, 7759, 7759, 7759, 7759, 7759, 7759, 7759, 7759, 7759, 7759, 7759, 7759, 7759, 7759, 7759, 7759, 5844, 5845, 5925, 5526, 5527, 5528, 5529, 5530, 5531, 5532, 5524, 5525, 5526, 5527, 5528, 5529, 5530, 5531, 5532, 5533, 5534, 5535, 5536, 5537, 5538, 5539, 5540, 5541, 5542, 5543, 5544, 5545, 5546, 5547, 5548, 5549, 5550, 5551, 5552, 5553, 5926, 5927, 7759, 7759, 7759, 7759, 7759, 7759, 7759, 7759, 7759, 7759, 7759, 7759, 7759, 7759, 7759, 7759, 7759, 7759, 7759
7759, 7759, 7759, 7759, 7759, 7759, 7759, 7759, 7759, 7759, 7759, 7759, 7759, 7759, 7759, 7759, 7759, 7759, 7759, 5924, 5925, 5605, 5606, 5607, 5608, 5609, 5610, 5611, 5612, 5604, 5605, 5606, 5607, 5608, 5609, 5610, 5611, 5612, 5613, 5614, 5615, 5616, 5617, 5618, 5619, 5620, 5621, 5622, 5623, 5624, 5625, 5626, 5627, 5628, 5629, 5630, 5631, 5632, 5633, 5926, 5927, 7759, 7759, 7759, 7759, 7759, 7759, 7759, 7759, 7759, 7759, 7759, 7759, 7759, 7759, 7759, 7759, 7759, 7759, 7759
7759, 7759, 7759, 7759, 7759, 7759, 7759, 7759, 7759, 7759, 7759, 7759, 7759, 7759, 7759, 7759, 7759, 7759, 7759, 7759, 7759, 7759, 7759, 7759, 7759, 7759, 7759, 7759, 7759, 7759, 7759, 7759, 7759, 7759, 7759, 7759, 7759, 7759, 7759, 7759, 7759, 7759, 7759, 7759, 7759, 7759, 7759, 7759, 7759, 7759, 7759, 7759, 7759, 7759, 7759, 7759, 7759, 7759, 7759, 7759, 7759, 7759, 7759, 7759, 7759, 7759, 7759, 7759, 7759, 7759, 7759, 7759, 7759, 7759, 7759, 7759, 7759, 7759, 7759, 7759
7759, 7759, 7759, 7759, 7759, 7759, 7759, 7759, 7759, 7759, 7759, 7759, 7759, 7759, 7759, 7759, 7759, 7759, 7759, 7759, 7759, 7759, 7759, 7759, 7759, 7759, 7759, 7759, 7759, 7759, 7759, 7759, 7759, 7759, 7759, 7759, 7759, 7759, 7759, 7759, 7759, 7759, 7759, 7759, 7759, 7759, 7759, 7759, 7759, 7759, 7759, 7759, 7759, 7759, 7759, 7759, 7759, 7759, 7759, 7759, 7759, 7759, 7759, 7759, 7759, 7759, 7759, 7759, 7759, 7759, 7759, 7759, 7759, 7759, 7759, 7759, 7759, 7759, 7759, 7759
7759, 7759, 7759, 7759, 7759, 7759, 7759, 7759, 7759, 7759, 7759, 7759, 7759, 7759, 7759, 7759, 7759, 7759, 7759, 7759, 7759, 7759, 7759, 7759, 7759, 7759, 7759, 7759, 7759, 7759, 7759, 7759, 7759, 7759, 7759, 7759, 7759, 7759, 7759, 7759, 7759, 7759, 7759, 7759, 7759, 7759, 7759, 7759, 7759, 7759, 7759, 7759, 7759, 7759, 7759, 7759, 7759, 7759, 7759, 7759, 7759, 7759, 7759, 7759, 7759, 7759, 7759, 7759, 7759, 7759, 7759, 7759, 7759, 7759, 7759, 7759, 7759, 7759, 7759, 7759
7759, 7759, 7759, 7759, 7759, 7759, 7759, 7759, 7759, 7759, 7759, 7759, 7759, 7759, 7759, 7759, 7759, 7759, 7759, 7759, 7759, 7759, 7759, 7759, 7759, 7759, 7759, 7759, 7759, 7759, 7759, 7759, 7759, 7759, 7759, 7759, 7759, 7759, 7759, 7759, 7759, 7759, 7759, 7759, 7759, 7759, 7759, 7759, 7759, 7759, 7759, 7759, 7759, 7759, 7759, 7759, 7759, 7759, 7759, 7759, 7759, 7759, 7759, 7759, 7759, 7759, 7759, 7759, 7759, 7759, 7759, 7759, 7759, 7759, 7759, 7759, 7759, 7759, 7759, 7759
