7759, 7759, 7759, 7759, 7759, 7759, 7759, 7759, 7759, 7759, 7759, 7759, 7759, 7759, 7759, 7759, 7759, 7759, 7759, 7759, 7759, 7759, 7759, 7759, 7759, 7759, 7759, 7759, 7759, 7759, 7759, 7759, 7759, 7759, 7759, 7759, 7759, 7759, 7759, 7759, 7759, 7759, 7759, 7759, 7759, 7759, 7759, 7759, 7759, 7759, 7759, 7759, 7759, 7759, 7759, 7759, 7759, 7759, 7759, 7759, 7759, 7759, 7759, 7759, 7759, 7759, 7759, 7759, 7759, 7759, 7759, 7759, 7759, 7759, 7759, 7759, 7759, 7759, 7759, 7759
7759, 7759, 7759, 7759, 7759, 7759, 7759, 7759, 7759, 7759, 7759, 7759, 7759, 7759, 7759, 7759, 7759, 7759, 7759, 7759, 7759, 7759, 7759, 7759, 7759, 7759, 7759, 7759, 7759, 7759, 7759, 7759, 7759, 7759, 7759, 7759, 7759, 7759, 7759, 7759, 7759, 7759, 7759, 7759, 7759, 7759, 7759, 7759, 7759, 7759, 7759, 7759, 7759, 7759, 7759, 7759, 7759, 7759, 7759, 7759, 7759, 7759, 7759, 7759, 7759, 7759, 7759, 7759, 7759, 7759, 7759, 7759, 7759, 7759, 7759, 7759, 7759, 7759, 7759, 7759
7759, 7759, 7759, 7759, 7759, 7759, 7759, 7759, 7759, 7759, 7759, 7759, 7759, 7759, 7759, 7759, 7759, 7759, 7759, 7759, 7759, 7759, 7759, 7759, 7759, 7759, 7759, 7759, 7759, 7759, 7759, 7759, 7759, 7759, 7759, 7759, 7759, 7759, 7759, 7759, 7759, 7759, 7759, 7759, 7759, 7759, 7759, 7759, 7759, 7759, 7759, 7759, 7759, 7759, 7759, 7759, 7759, 7759, 7759, 7759, 7759, 7759, 7759, 7759, 7759, 7759, 7759, 7759, 7759, 7759, 7759, 7759, 7759, 7759, 7759, 7759, 7759, 7759, 7759, 7759
7759, 7759, 7759, 7759, 7759, 7759, 7759, 7759, 7759, 7759, 7759, 7759, 7759, 7759, 7759, 7759, 7759, 7759, 7759, 7759, 7759, 7759, 7759, 7759, 7759, 7759, 7759, 7759, 7759, 7759, 7759, 7759, 7759, 7759, 7759, 7759, 7759, 7759, 7759, 7759, 7759, 7759, 7759, 7759, 7759, 7759, 7759, 7759, 7759, 7759, 7759, 7759, 7759, 7759, 7759, 7759, 7759, 7759, 7759, 7759, 7759, 7759, 7759, 7759, 7759, 7759, 7759, 7759, 7759, 7759, 7759, 7759, 7759, 7759, 7759, 7759, 7759, 7759, 7759, 7759
7759, 7759, 7759, 7759, 7759, 7759, 7759, 7759, 7759, 7759, 7759, 7759, 7759, 7759, 7759, 7759, 7759, 7759, 7759, 7759, 7759, 7759, 7759, 7759, 7759, 7759, 7759, 7759, 7759, 7759, 7759, 7759, 7759, 7759, 7759, 7759, 7759, 7759, 7759, 7759, 7759, 7759, 7759, 7759, 7759, 7759, 7759, 7759, 7759, 7759, 7759, 7759, 7759, 7759, 7759, 7759, 7759, 7759, 7759, 7759, 7759, 7759, 7759, 7759, 7759, 7759, 7759, 7759, 7759, 7759, 7759, 7759, 7759, 7759, 7759, 7759, 7759, 7759, 7759, 7759
7759, 7759, 7759, 7759, 7759, 7759, 7759, 7759, 7759, 7759, 7759, 7759, 7759, 7759, 7759, 7759, 7759, 7759, 7759, 7759, 7759, 7759, 7759, 7759, 7759, 7759, 7759, 7759, 7759, 7759, 7759, 7759, 7759, 7759, 7759, 7759, 7759, 7759, 7759, 7759, 7759, 7759, 7759, 7759, 7759, 7759, 7759, 7759, 7759, 7759, 7759, 7759, 7759, 7759, 7759, 7759, 7759, 7759, 7759, 7759, 7759, 7759, 7759, 7759, 7759, 7759, 7759, 7759, 7759, 7759, 7759, 7759, 7759, 7759, 7759, 7759, 7759, 7759, 7759, 7759
7759, 7759, 7759, 7759, 7759, 7759, 7759, 7759, 7759, 7759, 7759, 7759, 7759, 7759, 7759, 7759, 7759, 7759, 7759, 7759, 7759, 7759, 7759, 7759, 7759, 7759, 7759, 7759, 7759, 7759, 7759, 7759, 7759, 7759, 7759, 7759, 7759, 7759, 7759, 7759, 7759, 7759, 7759, 7759, 7759, 7759, 7759, 7759, 7759, 7759, 7759, 7759, 7759, 7759, 7759, 7759, 7759, 7759, 7759, 7759, 7759, 7759, 7759, 7759, 7759, 7759, 7759, 7759, 7759, 7759, 7759, 7759, 7759, 7759, 7759, 7759, 7759, 7759, 7759, 7759
7759, 7759, 7759, 7759, 7759, 7759, 7759, 7759, 7759, 7759, 7759, 7759, 7759, 7759, 7759, 7759, 7759, 7759, 5684, 5685, 5364, 5365, 5366, 5367, 5368, 5369, 5370, 5371, 5372, 5373, 5374, 5375, 5376, 5377, 5378, 5379, 5380, 5381, 5382, 5383, 5384, 5385, 5386, 5387, 5388, 5389, 5390, 5391, 5392, 5393, 5394, 5395, 5396, 5397, 5398, 5399, 5400, 5401, 5402, 5403, 5686, 5687, 7759, 7759, 7759, 7759, 7759, 7759, 7759, 7759, 7759, 7759, 7759, 7759, 7759, 7759, 7759, 7759, 7759, 7759
7759, 7759, 7759, 7759, 7759, 7759, 7759, 7759, 7759, 7759, 7759, 7759, 7759, 7759, 7759, 7759, 7759, 7759, 5764, 5765, 5444, 5445, 5446, 5447, 5448, 5449, 5450, 5451, 5452, 5453, 5454, 5455, 5456, 5457, 5458, 5459, 5460, 5461, 5462, 5463, 5464, 5465, 5466, 5467, 5468, 5469, 5470, 5471, 5472, 5473, 5474, 5475, 5476, 5477, 5478, 5479, 5480, 5481, 5482, 5483, 5766, 5767, 7759, 7759, 7759, 7759, 7759, 7759, 7759, 7759, 7759, 7759, 7759, 7759, 7759, 7759, 7759, 7759, 7759, 7759
7759, 7759, 7759, 7759, 7759, 7759, 7759, 7759, 7759, 7759, 7759, 7759, 7759, 7759, 7759, 7759, 7759, 7759, 5360, 5361, 0, 1, 2, 3, 4, 5, 6, 7, 8, 9, 10, 11, 12, 13, 14, 15, 16, 17, 18, 19, 20, 21, 22, 23, 24, 25, 26, 27, 28, 29, 30, 31, 32, 33, 34, 35, 36, 37, 38, 39, 5442, 5443, 7759, 7759, 7759, 7759, 7759, 7759, 7759, 7759, 7759, 7759, 7759, 7759, 7759, 7759, 7759, 7759, 7759, 7759
7759, 7759, 7759, 7759, 7759, 7759, 7759, 7759, 7759, 7759, 7759, 7759, 7759, 7759, 7759, 7759, 7759, 7759, 5440, 5441, 80, 81, 82, 83, 84, 85, 86, 87, 88, 89, 90, 91, 92, 93, 94, 95, 96, 97, 98, 99, 100, 101, 102, 103, 104, 105, 106, 107, 108, 109, 110, 111, 112, 113, 114, 115, 116, 117, 118, 119, 5522, 5523, 7759, 7759, 7759, 7759, 7759, 7759, 7759, 7759, 7759, 7759, 7759, 7759, 7759, 7759, 7759, 7759, 7759, 7759
7759, 7759, 7759, 7759, 7759, 7759, 7759, 7759, 7759, 7759, 7759, 7759, 7759, 7759, 7759, 7759, 7759, 7759, 5520, 5521, 160, 161, 162, 163, 164, 165, 166, 167, 168, 169, 170, 171, 172, 173, 174, 175, 176, 177, 178, 179, 180, 181, 182, 183, 184, 185, 186, 187, 188, 189, 190, 191, 192, 193, 194, 195, 196, 197, 198, 199, 5602, 5603, 7759, 7759, 7759, 7759, 7759, 7759, 7759, 7759, 7759, 7759, 7759, 7759, 7759, 7759, 7759, 7759, 7759, 7759
7759, 7759, 7759, 7759, 7759, 7759, 7759, 7759, 7759, 7759, 7759, 7759, 7759, 7759, 7759, 7759, 7759, 7759, 5600, 5601, 240, 241, 242, 243, 244, 245, 246, 247, 248, 249, 250, 251, 252, 253, 254, 255, 256, 257, 258, 259, 260, 261, 262, 263, 264, 265, 266, 267, 268, 269, 270, 271, 272, 273, 274, 275, 276, 277, 278, 279, 5682, 5683, 7759, 7759, 7759, 7759, 7759, 7759, 7759, 7759, 7759, 7759, 7759, 7759, 7759, 7759, 7759, 7759, 7759, 7759
7759, 7759, 7759, 7759, 7759, 7759, 7759, 7759, 7759, 7759, 7759, 7759, 7759, 7759, 7759, 7759, 7759, 7759, 5680, 5681, 320, 321, 322, 323, 324, 325, 326, 327, 328, 329, 330, 331, 332, 333, 334, 335, 336, 337, 338, 339, 340, 341, 342, 343, 344, 345, 346, 347, 348, 349, 350, 351, 352, 353, 354, 355, 356, 357, 358, 359, 5762, 5763, 7759, 7759, 7759, 7759, 7759, 7759, 7759, 7759, 7759, 7759, 7759, 7759, 7759, 7759, 7759, 7759, 7759, 7759
7759, 7759, 7759, 7759, 7759, 7759, 7759, 7759, 7759, 7759, 7759, 7759, 7759, 7759, 7759, 7759, 7759, 7759, 5760, 5761, 400, 401, 402, 403, 404, 405, 406, 407, 408, 409, 410, 411, 412, 413, 414, 415, 416, 417, 418, 419, 420, 421, 422, 423, 424, 425, 426, 427, 428, 429, 430, 431, 432, 433, 434, 435, 436, 437, 438, 439, 5842, 5843, 7759, 7759, 7759, 7759, 7759, 7759, 7759, 7759, 7759, 7759, 7759, 7759, 7759, 7759, 7759, 7759, 7759, 7759
7759, 7759, 7759, 7759, 7759, 7759, 7759, 7759, 7759, 7759, 7759, 7759, 7759, 7759, 7759, 7759, 7759, 7759, 5840, 5841, 480, 481, 482, 483, 484, 485, 486, 487, 488, 489, 490, 491, 492, 493, 494, 495, 496, 497, 498, 499, 500, 501, 502, 503, 504, 505, 506, 507, 508, 509, 510, 511, 512, 513, 514, 515, 516, 517, 518, 519, 5922, 5923, 7759, 7759, 7759, 7759, 7759, 7759, 7759, 7759, 7759, 7759, 7759, 7759, 7759, 7759, 7759, 7759, 7759, 7759
7759, 7759, 7759, 7759, 7759, 7759, 7759, 7759, 7759, 7759, 7759, 7759, 7759, 7759, 7759, 7759, 7759, 7759, 5920, 5921, 560, 561, 562, 563, 564, 565, 566, 567, 568, 569, 570, 571, 572, 573, 574, 575, 576, 577, 578, 579, 580, 581, 582, 583, 584, 585, 586, 587, 588, 589, 590, 591, 592, 593, 594, 595, 596, 597, 598, 599, 6002, 6003, 7759, 7759, 7759, 7759, 7759, 7759, 7759, 7759, 7759, 7759, 7759, 7759, 7759, 7759, 7759, 7759, 7759, 7759
7759, 7759, 7759, 7759, 7759, 7759, 7759, 7759, 7759, 7759, 7759, 7759, 7759, 7759, 7759, 7759, 7759, 7759, 6000, 6001, 640, 641, 642, 643, 644, 645, 646, 647, 648, 7322, 7323, 651, 652, 653, 654, 655, 656, 657, 658, 659, 660, 661, 662, 663, 664, 665, 666, 7322, 7323, 669, 670, 671, 672, 673, 674, 675, 676, 677, 678, 679, 6082, 6083, 7759, 7759, 7759, 7759, 7759, 7759, 7759, 7759, 7759, 7759, 7759, 7759, 7759, 7759, 7759, 7759, 7759, 7759
7759, 7759, 7759, 7759, 7759, 7759, 7759, 7759, 7759, 7759, 7759, 7759, 7759, 7759, 7759, 7759, 7759, 7759, 6080, 6081, 720, 721, 722, 723, 724, 725, 726, 727, 728, 7402, 7403, 731, 732, 733, 734, 735, 736, 737, 738, 739, 740, 741, 742, 743, 744, 745, 746, 7402, 7403, 749, 750, 751, 752, 753, 754, 755, 756, 757, 758, 759, 6162, 6163, 7759, 7759, 7759, 7759, 7759, 7759, 7759, 7759, 7759, 7759, 7759, 7759, 7759, 7759, 7759, 7759, 7759, 7759
7759, 7759, 7759, 7759, 7759, 7759, 7759, 7759, 7759, 7759, 7759, 7759, 7759, 7759, 7759, 7759, 7759, 7759, 6160, 6161, 800, 801, 802, 803, 804, 805, 806, 807, 808, 7322, 7323, 811, 812, 813, 814, 815, 816, 817, 818, 819, 820, 821, 822, 823, 824, 825, 826, 7322, 7323, 829, 830, 831, 832, 833, 834, 835, 836, 837, 838, 839, 6242, 6243, 7759, 7759, 7759, 7759, 7759, 7759, 7759, 7759, 7759, 7759, 7759, 7759, 7759, 7759, 7759, 7759, 7759, 7759
7759, 7759, 7759, 7759, 7759, 7759, 7759, 7759, 7759, 7759, 7759, 7759, 7759, 7759, 7759, 7759, 7759, 7759, 6240, 6241, 880, 881, 882, 883, 884, 885, 886, 887, 888, 7402, 7403, 891, 892, 893, 894, 895, 896, 897, 898, 899, 900, 901, 902, 903, 904, 905, 906, 7402, 7403, 909, 910, 911, 912, 913, 914, 915, 916, 917, 918, 919, 6322, 6323, 7759, 7759, 7759, 7759, 7759, 7759, 7759, 7759, 7759, 7759, 7759, 7759, 7759, 7759, 7759, 7759, 7759, 7759
7759, 7759, 7759, 7759, 7759, 7759, 7759, 7759, 7759, 7759, 7759, 7759, 7759, 7759, 7759, 7759, 7759, 7759, 6320, 6321, 960, 961, 962, 963, 964, 965, 966, 967, 968, 7322, 7323, 971, 972, 973, 974, 975, 976, 977, 978, 979, 980, 981, 982, 983, 984, 985, 986, 7322, 7323, 989, 990, 991, 992, 993, 994, 995, 996, 997, 998, 999, 6402, 6403, 7759, 7759, 7759, 7759, 7759, 7759, 7759, 7759, 7759, 7759, 7759, 7759, 7759, 7759, 7759, 7759, 7759, 7759
7759, 7759, 7759, 7759, 7759, 7759, 7759, 7759, 7759, 7759, 7759, 7759, 7759, 7759, 7759, 7759, 7759, 7759, 6400, 6401, 1040, 1041, 1042, 1043, 1044, 1045, 1046, 1047, 1048, 7402, 7403, 1051, 1052, 1053, 1054, 1055, 1056, 1057, 1058, 1059, 1060, 1061, 1062, 1063, 1064, 1065, 1066, 7402, 7403, 1069, 1070, 1071, 1072, 1073, 1074, 1075, 1076, 1077, 415, 416, 6482, 6483, 7759, 7759, 7759, 7759, 7759, 7759, 7759, 7759, 7759, 7759, 7759, 7759, 7759, 7759, 7759, 7759, 7759, 7759
7759, 7759, 7759, 7759, 7759, 7759, 7759, 7759, 7759, 7759, 7759, 7759, 7759, 7759, 7759, 7759, 7759, 7759, 6480, 6481, 1120, 1121, 1122, 1123, 1124, 1125, 1126, 1127, 1128, 7774, 7775, 1131, 1132, 1133, 1134, 1135, 1136, 1137, 1138, 1139, 1140, 1141, 1142, 1143, 1144, 1145, 1146, 7774, 7775, 1149, 1150, 1151, 1152, 1153, 1154, 1155, 1156, 1157, 495, 496, 6562, 6563, 7759, 7759, 7759, 7759, 7759, 7759, 7759, 7759, 7759, 7759, 7759, 7759, 7759, 7759, 7759, 7759, 7759, 7759
7759, 7759, 7759, 7759, 7759, 7759, 7759, 7759, 7759, 7759, 7759, 7759, 7759, 7759, 7759, 7759, 7759, 7759, 5360, 5361, 1200, 1201, 1202, 1203, 1204, 1205, 1206, 1207, 1208, 1209, 1210, 1211, 1212, 1213, 1214, 1215, 1216, 1217, 1218, 1219, 1220, 1221, 1222, 1223, 1224, 1225, 1226, 1227, 1228, 1229, 1230, 1231, 1232, 1233, 1234, 1235, 1236, 1237, 1238, 1239, 5362, 5363, 7759, 7759, 7759, 7759, 7759, 7759, 7759, 7759, 7759, 7759, 7759, 7759, 7759, 7759, 7759, 7759, 7759, 7759
7759, 7759, 7759, 7759, 7759, 7759, 7759, 7759, 7759, 7759, 7759, 7759, 7759, 7759, 7759, 7759, 7759, 7759, 5440, 5441, 1280, 1281, 1282, 1283, 1284, 1285, 1286, 1287, 1288, 1289, 1290, 1291, 1292, 1293, 1294, 1295, 1296, 1297, 1298, 1299, 1300, 1301, 1302, 1303, 1304, 1305, 1306, 1307, 1308, 1309, 1310, 1311, 1312, 1313, 1314, 1315, 1316, 1317, 1318, 1319, 5442, 5443, 7759, 7759, 7759, 7759, 7759, 7759, 7759, 7759, 7759, 7759, 7759, 7759, 7759, 7759, 7759, 7759, 7759, 7759
7759, 7759, 7759, 7759, 7759, 7759, 7759, 7759, 7759, 7759, 7759, 7759, 7759, 7759, 7759, 7759, 7759, 7759, 5520, 5521, 1360, 1361, 1362, 1363, 1364, 1365, 1366, 1367, 1368, 1369, 1370, 1371, 1372, 1373, 1374, 1375, 1376, 1377, 1378, 1379, 1380, 1381, 1382, 1383, 1384, 1385, 1386, 1387, 1388, 1389, 1390, 1391, 1392, 1393, 1394, 1395, 1396, 1397, 1398, 1399, 5522, 5523, 7759, 7759, 7759, 7759, 7759, 7759, 7759, 7759, 7759, 7759, 7759, 7759, 7759, 7759, 7759, 7759, 7759, 7759
7759, 7759, 7759, 7759, 7759, 7759, 7759, 7759, 7759, 7759, 7759, 7759, 7759, 7759, 7759, 7759, 7759, 7759, 5600, 5601, 1440, 1441, 1442, 1443, 1444, 1445, 1446, 7780, 7781, 1449, 1450, 1451, 1452, 1453, 1454, 1455, 1456, 1457, 1458, 1459, 1460, 1461, 1462, 1463, 1464, 1465, 1466, 1467, 1468, 7780, 7781, 1471, 1472, 1473, 1474, 1475, 1476, 1477, 1478, 1479, 5602, 5603, 7759, 7759, 7759, 7759, 7759, 7759, 7759, 7759, 7759, 7759, 7759, 7759, 7759, 7759, 7759, 7759, 7759, 7759
7759, 7759, 7759, 7759, 7759, 7759, 7759, 7759, 7759, 7759, 7759, 7759, 7759, 7759, 7759, 7759, 7759, 7759, 5680, 5681, 1520, 1521, 1522, 1523, 1524, 1525, 1526, 7860, 7861, 1529, 1530, 1531, 1532, 1533, 1534, 1535, 1536, 1537, 1538, 1539, 1540, 1541, 1542, 1543, 1544, 1545, 1546, 1547, 1548, 7860, 7861, 1551, 1552, 1553, 1554, 1555, 1556, 1557, 1558, 1559, 5682, 5683, 7759, 7759, 7759, 7759, 7759, 7759, 7759, 7759, 7759, 7759, 7759, 7759, 7759, 7759, 7759, 7759, 7759, 7759
7759, 7759, 7759, 7759, 7759, 7759, 7759, 7759, 7759, 7759, 7759, 7759, 7759, 7759, 7759, 7759, 7759, 7759, 5760, 5761, 1600, 1601, 1602, 1603, 1604, 1605, 1606, 7780, 7781, 1609, 1610, 1611, 1612, 1613, 1614, 1615, 1616, 1617, 1618, 1619, 1620, 1621, 1622, 1623, 1624, 1625, 1626, 1627, 1628, 7780, 7781, 1631, 1632, 1633, 1634, 1635, 1636, 1637, 1638, 1639, 5762, 5763, 7759, 7759, 7759, 7759, 7759, 7759, 7759, 7759, 7759, 7759, 7759, 7759, 7759, 7759, 7759, 7759, 7759, 7759
7759, 7759, 7759, 7759, 7759, 7759, 7759, 7759, 7759, 7759, 7759, 7759, 7759, 7759, 7759, 7759, 7759, 7759, 5840, 5841, 1680, 1681, 1682, 1683, 1684, 1685, 1686, 7860, 7861, 1689, 1690, 1691, 1692, 1693, 1694, 1695, 1696, 1697, 1698, 1699, 1700, 1701, 1702, 1703, 1704, 1705, 1706, 1707, 1708, 7860, 7861, 1711, 1712, 1713, 1714, 1715, 1716, 1717, 1718, 1719, 5842, 5843, 7759, 7759, 7759, 7759, 7759, 7759, 7759, 7759, 7759, 7759, 7759, 7759, 7759, 7759, 7759, 7759, 7759, 7759
7759, 7759, 7759, 7759, 7759, 7759, 7759, 7759, 7759, 7759, 7759, 7759, 7759, 7759, 7759, 7759, 7759, 7759, 5920, 5921, 1760, 1761, 1762, 1763, 1764, 1765, 1766, 7780, 7781, 1769, 1770, 1771, 1772, 1773, 1774, 1775, 1776, 1777, 1778, 1779, 1780, 1781, 1782, 1783, 1784, 1785, 1786, 1787, 1788, 7780, 7781, 1791, 1792, 1793, 1794, 1795, 1796, 1797, 1798, 1799, 5922, 5923, 7759, 7759, 7759, 7759, 7759, 7759, 7759, 7759, 7759, 7759, 7759, 7759, 7759, 7759, 7759, 7759, 7759, 7759
7759, 7759, 7759, 7759, 7759, 7759, 7759, 7759, 7759, 7759, 7759, 7759, 7759, 7759, 7759, 7759, 7759, 7759, 6000, 6001, 1840, 1841, 1842, 1843, 1844, 1845, 1846, 7860, 7861, 1849, 1850, 1851, 1852, 1853, 1854, 1855, 1856, 1857, 1858, 1859, 1860, 1861, 1862, 1863, 1864, 1865, 1866, 1867, 1868, 7860, 7861, 1871, 1872, 1873, 1874, 1875, 1876, 1877, 1878, 1879, 6002, 6003, 7759, 7759, 7759, 7759, 7759, 7759, 7759, 7759, 7759, 7759, 7759, 7759, 7759, 7759, 7759, 7759, 7759, 7759
7759, 7759, 7759, 7759, 7759, 7759, 7759, 7759, 7759, 7759, 7759, 7759, 7759, 7759, 7759, 7759, 7759, 7759, 6080, 6081, 1920, 1921, 1922, 1923, 1924, 1925, 1926, 7780, 7781, 1929, 1930, 1931, 1932, 1933, 1934, 1935, 1936, 1937, 1938, 1939, 1940, 1941, 1942, 1943, 1944, 1945, 1946, 1947, 1948, 7780, 7781, 1951, 1952, 1953, 1954, 1955, 1956, 1957, 1958, 1959, 6082, 6083, 7759, 7759, 7759, 7759, 7759, 7759, 7759, 7759, 7759, 7759, 7759, 7759, 7759, 7759, 7759, 7759, 7759, 7759
7759, 7759, 7759, 7759, 7759, 7759, 7759, 7759, 7759, 7759, 7759, 7759, 7759, 7759, 7759, 7759, 7759, 7759, 6160, 6161, 2000, 2001, 2002, 2003, 2004, 2005, 2006, 7860, 7861, 2009, 2010, 2011, 2012, 2013, 2014, 2015, 2016, 2017, 2018, 2019, 2020, 2021, 2022, 2023, 2024, 2025, 2026, 2027, 2028, 7860, 7861, 2031, 2032, 2033, 2034, 2035, 2036, 2037, 2038, 2039, 6162, 6163, 7759, 7759, 7759, 7759, 7759, 7759, 7759, 7759, 7759, 7759, 7759, 7759, 7759, 7759, 7759, 7759, 7759, 7759
7759, 7759, 7759, 7759, 7759, 7759, 7759, 7759, 7759, 7759, 7759, 7759, 7759, 7759, 7759, 7759, 7759, 7759, 6240, 6241, 2080, 2081, 2082, 2083, 2084, 2085, 2086, 7780, 7781, 2089, 2090, 2091, 2092, 2093, 2094, 2095, 2096, 2097, 2098, 2099, 2100, 2101, 2102, 2103, 2104, 2105, 2106, 2107, 2108, 7780, 7781, 2111, 2112, 2113, 2114, 2115, 2116, 2117, 2118, 2119, 6242, 6243, 7759, 7759, 7759, 7759, 7759, 7759, 7759, 7759, 7759, 7759, 7759, 7759, 7759, 7759, 7759, 7759, 7759, 7759
7759, 7759, 7759, 7759, 7759, 7759, 7759, 7759, 7759, 7759, 7759, 7759, 7759, 7759, 7759, 7759, 7759, 7759, 6320, 6321, 2160, 2161, 2162, 2163, 2164, 2165, 2166, 7860, 7861, 2169, 2170, 2171, 2172, 2173, 2174, 2175, 2176, 2177, 2178, 2179, 2180, 2181, 2182, 2183, 2184, 2185, 2186, 2187, 2188, 7860, 7861, 2191, 2192, 2193, 2194, 2195, 2196, 2197, 2198, 2199, 6322, 6323, 7759, 7759, 7759, 7759, 7759, 7759, 7759, 7759, 7759, 7759, 7759, 7759, 7759, 7759, 7759, 7759, 7759, 7759
7759, 7759, 7759, 7759, 7759, 7759, 7759, 7759, 7759, 7759, 7759, 7759, 7759, 7759, 7759, 7759, 7759, 7759, 6400, 6401, 2240, 2241, 2242, 2243, 2244, 2245, 2246, 2247, 2248, 2249, 2250, 2251, 2252, 2253, 2254, 2255, 2256, 2257, 2258, 2259, 2260, 2261, 2262, 2263, 2264, 2265, 2266, 2267, 2268, 2269, 2270, 2271, 2272, 2273, 2274, 2275, 2276, 2277, 2278, 2279, 6402, 6403, 7759, 7759, 7759, 7759, 7759, 7759, 7759, 7759, 7759, 7759, 7759, 7759, 7759, 7759, 7759, 7759, 7759, 7759
7759, 7759, 7759, 7759, 7759, 7759, 7759, 7759, 7759, 7759, 7759, 7759, 7759, 7759, 7759, 7759, 7759, 7759, 6480, 6481, 2320, 2321, 2322, 2323, 2324, 2325, 2326, 2327, 2328, 2329, 2330, 2331, 2332, 2333, 2334, 2335, 2336, 2337, 2338, 2339, 2340, 2341, 2342, 2343, 2344, 2345, 2346, 2347, 2348, 2349, 2350, 2351, 2352, 2353, 2354, 2355, 2356, 2357, 2358, 2359, 6482, 6483, 7759, 7759, 7759, 7759, 7759, 7759, 7759, 7759, 7759, 7759, 7759, 7759, 7759, 7759, 7759, 7759, 7759, 7759
7759, 7759, 7759, 7759, 7759, 7759, 7759, 7759, 7759, 7759, 7759, 7759, 7759, 7759, 7759, 7759, 7759, 7759, 6560, 6561, 2400, 2401, 2402, 2403, 2404, 2405, 2406, 2407, 2408, 2409, 2410, 2411, 2412, 2413, 2414, 2415, 2416, 2417, 2418, 2419, 2420, 2421, 2422, 2423, 2424, 2425, 2426, 2427, 2428, 2429, 2430, 2431, 2432, 2433, 2434, 2435, 2436, 2437, 2438, 2439, 6562, 6563, 7759, 7759, 7759, 7759, 7759, 7759, 7759, 7759, 7759, 7759, 7759, 7759, 7759, 7759, 7759, 7759, 7759, 7759
7759, 7759, 7759, 7759, 7759, 7759, 7759, 7759, 7759, 7759, 7759, 7759, 7759, 7759, 7759, 7759, 7759, 7759, 6640, 6641, 2480, 2481, 2482, 2483, 2484, 2485, 2486, 2487, 2488, 7322, 7323, 2491, 2492, 2493, 2494, 2495, 2496, 2497, 2498, 2499, 2500, 2501, 2502, 2503, 2504, 2505, 2506, 7322, 7323, 2509, 2510, 2511, 2512, 2513, 2514, 2515, 2516, 2517, 2518, 2519, 6642, 6643, 7759, 7759, 7759, 7759, 7759, 7759, 7759, 7759, 7759, 7759, 7759, 7759, 7759, 7759, 7759, 7759, 7759, 7759
7759, 7759, 7759, 7759, 7759, 7759, 7759, 7759, 7759, 7759, 7759, 7759, 7759, 7759, 7759, 7759, 7759, 7759, 6720, 6721, 2560, 2561, 2562, 2563, 2564, 2565, 2566, 2567, 2568, 7402, 7403, 2571, 2572, 2573, 2574, 2575, 2576, 2577, 2578, 2579, 2580, 2581, 2582, 2583, 2584, 2585, 2586, 7402, 7403, 2589, 2590, 2591, 2592, 2593, 2594, 2595, 2596, 2597, 2598, 2599, 6722, 6723, 7759, 7759, 7759, 7759, 7759, 7759, 7759, 7759, 7759, 7759, 7759, 7759, 7759, 7759, 7759, 7759, 7759, 7759
7759, 7759, 7759, 7759, 7759, 7759, 7759, 7759, 7759, 7759, 7759, 7759, 7759, 7759, 7759, 7759, 7759, 7759, 6800, 6801, 2640, 2641, 2642, 2643, 2644, 2645, 2646, 2647, 2648, 7322, 7323, 2651, 2652, 2653, 2654, 2655, 2656, 2657, 2658, 2659, 2660, 2661, 2662, 2663, 2664, 2665, 2666, 7322, 7323, 2669, 2670, 2671, 2672, 2673, 2674, 2675, 2676, 2677, 2678, 2679, 6802, 6803, 7759, 7759, 7759, 7759, 7759, 7759, 7759, 7759, 7759, 7759, 7759, 7759, 7759, 7759, 7759, 7759, 7759, 7759
7759, 7759, 7759, 7759, 7759, 7759, 7759, 7759, 7759, 7759, 7759, 7759, 7759, 7759, 7759, 7759, 7759, 7759, 6880, 6881, 2720, 2721, 2722, 2723, 2724, 2725, 2726, 2727, 2728, 7402, 7403, 2731, 2732, 2733, 2734, 2735, 2736, 2737, 2738, 2739, 2740, 2741, 2742, 2743, 2744, 2745, 2746, 7402, 7403, 2749, 2750, 2751, 2752, 2753, 2754, 2755, 2756, 2757, 2758, 2759, 6882, 6883, 7759, 7759, 7759, 7759, 7759, 7759, 7759, 7759, 7759, 7759, 7759, 7759, 7759, 7759, 7759, 7759, 7759, 7759
7759, 7759, 7759, 7759, 7759, 7759, 7759, 7759, 7759, 7759, 7759, 7759, 7759, 7759, 7759, 7759, 7759, 7759, 6960, 6961, 2800, 2801, 2802, 2803, 2804, 2805, 2806, 2807, 2808, 7322, 7323, 2811, 2812, 2813, 2814, 2815, 2816, 2817, 2818, 2819, 2820, 2821, 2822, 2823, 2824, 2825, 2826, 7322, 7323, 2829, 2830, 2831, 2832, 2833, 2834, 2835, 2836, 2837, 2838, 2839, 6962, 6963, 7759, 7759, 7759, 7759, 7759, 7759, 7759, 7759, 7759, 7759, 7759, 7759, 7759, 7759, 7759, 7759, 7759, 7759
7759, 7759, 7759, 7759, 7759, 7759, 7759, 7759, 7759, 7759, 7759, 7759, 7759, 7759, 7759, 7759, 7759, 7759, 7040, 7041, 2880, 2881, 2882, 2883, 2884, 2885, 2886, 2887, 2888, 7402, 7403, 2891, 2892, 2893, 2894, 2895, 2896, 2897, 2898, 2899, 2900, 2901, 2902, 2903, 2904, 2905, 2906, 7402, 7403, 2909, 2910, 2911, 2912, 2913, 2914, 2915, 2916, 2917, 2918, 2919, 7042, 7043, 7759, 7759, 7759, 7759, 7759, 7759, 7759, 7759, 7759, 7759, 7759, 7759, 7759, 7759, 7759, 7759, 7759, 7759
7759, 7759, 7759, 7759, 7759, 7759, 7759, 7759, 7759, 7759, 7759, 7759, 7759, 7759, 7759, 7759, 7759, 7759, 7120, 7121, 2960, 2961, 2962, 2963, 2964, 2965, 2966, 2967, 2968, 7322, 7323, 2971, 2972, 2973, 2974, 2975, 2976, 2977, 2978, 2979, 2980, 2981, 2982, 2983, 2984, 2985, 2986, 7322, 7323, 2989, 2990, 2991, 2992, 2993, 2994, 2995, 2996, 2997, 2998, 2999, 7122, 7123, 7759, 7759, 7759, 7759, 7759, 7759, 7759, 7759, 7759, 7759, 7759, 7759, 7759, 7759, 7759, 7759, 7759, 7759
7759, 7759, 7759, 7759, 7759, 7759, 7759, 7759, 7759, 7759, 7759, 7759, 7759, 7759, 7759, 7759, 7759, 7759, 7200, 7201, 3040, 3041, 3042, 3043, 3044, 3045, 3046, 3047, 3048, 7402, 7403, 3051, 3052, 3053, 3054, 3055, 3056, 3057, 3058, 3059, 3060, 3061, 3062, 3063, 3064, 3065, 3066, 7402, 7403, 3069, 3070, 3071, 3072, 3073, 3074, 3075, 3076, 3077, 3078, 3079, 7202, 7203, 7759, 7759, 7759, 7759, 7759, 7759, 7759, 7759, 7759, 7759, 7759, 7759, 7759, 7759, 7759, 7759, 7759, 7759
7759, 7759, 7759, 7759, 7759, 7759, 7759, 7759, 7759, 7759, 7759, 7759, 7759, 7759, 7759, 7759, 7759, 7759, 7280, 7281, 3120, 3121, 3122, 3123, 3124, 3125, 3126, 3127, 3128, 3129, 3130, 3131, 3132, 3133, 3134, 3135, 3136, 3137, 3138, 3139, 3140, 3141, 3142, 3143, 3144, 3145, 3146, 3147, 3148, 3149, 3150, 3151, 3152, 3153, 3154, 3155, 3156, 3157, 3158, 3159, 7282, 7283, 7759, 7759, 7759, 7759, 7759, 7759, 7759, 7759, 7759, 7759, 7759, 7759, 7759, 7759, 7759, 7759, 7759, 7759
7759, 7759, 7759, 7759, 7759, 7759, 7759, 7759, 7759, 7759, 7759, 7759, 7759, 7759, 7759, 7759, 7759, 7759, 7360, 7361, 3200, 3201, 3202, 3203, 3204, 3205, 3206, 3207, 3208, 3209, 3210, 3211, 3212, 3213, 3214, 3215, 3216, 3217, 3218, 3219, 3220, 3221, 3222, 3223, 3224, 3225, 3226, 3227, 3228, 3229, 3230, 3231, 3232, 3233, 3234, 3235, 3236, 3237, 3238, 3239, 7362, 7363, 7759, 7759, 7759, 7759, 7759, 7759, 7759, 7759, 7759, 7759, 7759, 7759, 7759, 7759, 7759, 7759, 7759, 7759
7759, 7759, 7759, 7759, 7759, 7759, 7759, 7759, 7759, 7759, 7759, 7759, 7759, 7759, 7759, 7759, 7759, 7759, 7440, 7441, 3280, 3281, 3282, 3283, 3284, 3285, 3286, 3287, 3288, 3289, 3290, 3291, 3292, 3293, 3294, 3295, 3296, 3297, 3298, 3299, 3300, 3301, 3302, 3303, 3304, 3305, 3306, 3307, 3308, 3309, 3310, 3311, 3312, 3313, 3314, 3315, 3316, 3317, 3318, 3319, 7442, 7443, 7759, 7759, 7759, 7759, 7759, 7759, 7759, 7759, 7759, 7759, 7759, 7759, 7759, 7759, 7759, 7759, 7759, 7759
7759, 7759, 7759, 7759, 7759, 7759, 7759, 7759, 7759, 7759, 7759, 7759, 7759, 7759, 7759, 7759, 7759, 7759, 7520, 7521, 3360, 3361, 3362, 3363, 3364, 3365, 3366, 3367, 3368, 3369, 3370, 3371, 3372, 3373, 3374, 3375, 3376, 3377, 3378, 3379, 3380, 3381, 3382, 3383, 3384, 3385, 3386, 3387, 3388, 3389, 3390, 3391, 3392, 3393, 3394, 3395, 3396, 3397, 3398, 3399, 7522, 7523, 7759, 7759, 7759, 7759, 7759, 7759, 7759, 7759, 7759, 7759, 7759, 7759, 7759, 7759, 7759, 7759, 7759, 7759
7759, 7759, 7759, 7759, 7759, 7759, 7759, 7759, 7759, 7759, 7759, 7759, 7759, 7759, 7759, 7759, 7759, 7759, 7600, 7601, 3440, 3441, 3442, 3443, 3444, 3445, 3446, 3447, 3448, 3449, 3450, 3451, 3452, 3453, 3454, 3455, 3456, 3457, 3458, 3459, 3460, 3461, 3462, 3463, 3464, 3465, 3466, 3467, 3468, 3469, 3470, 3471, 3472, 3473, 3474, 3475, 3476, 3477, 3478, 3479, 7602, 7603, 7759, 7759, 7759, 7759, 7759, 7759, 7759, 7759, 7759, 7759, 7759, 7759, 7759, 7759, 7759, 7759, 7759, 7759
7759, 7759, 7759, 7759, 7759, 7759, 7759, 7759, 7759, 7759, 7759, 7759, 7759, 7759, 7759, 7759, 7759, 7759, 5844, 5845, 3520, 3521, 3522, 3523, 3524, 3525, 3526, 3527, 3528, 3529, 3530, 3531, 3532, 3533, 3534, 3535, 3536, 3537, 3538, 3539, 3540, 3541, 3542, 3543, 3544, 3545, 3546, 3547, 3548, 3549, 3550, 3551, 3552, 3553, 3554, 3555, 3556, 3557, 3558, 3559, 5846, 5847, 7759, 7759, 7759, 7759, 7759, 7759, 7759, 7759, 7759, 7759, 7759, 7759, 7759, 7759, 7759, 7759, 7759, 7759
7759, 7759, 7759, 7759, 7759, 7759, 7759, 7759, 7759, 7759, 7759, 7759, 7759, 7759, 7759, 7759, 7759, 7759, 5924, 5925, 5524, 5525, 5526, 5527, 5528, 5529, 5530, 5531, 5532, 5533, 5534, 5535, 5536, 5537, 5538, 5539, 5540, 5541, 5542, 5543, 5544, 5545, 5546, 5547, 5548, 5549, 5550, 5551, 5552, 5553, 5554, 5555, 5556, 5557, 5558, 5559, 5560, 5561, 5562, 5563, 5926, 5927, 7759, 7759, 7759, 7759, 7759, 7759, 7759, 7759, 7759, 7759, 7759, 7759, 7759, 7759, 7759, 7759, 7759, 7759
7759, 7759, 7759, 7759, 7759, 7759, 7759, 7759, 7759, 7759, 7759, 7759, 7759, 7759, 7759, 7759, 7759, 7759, 5924, 5604, 5604, 5605, 5606, 5607, 5608, 5609, 5610, 5611, 5612, 5613, 5614, 5615, 5616, 5617, 5618, 5619, 5620, 5621, 5622, 5623, 5624, 5625, 5626, 5627, 5628, 5629, 5630, 5631, 5632, 5633, 5634, 5635, 5636, 5637, 5638, 5639, 5640, 5641, 5642, 5643, 5604, 5927, 7759, 7759, 7759, 7759, 7759, 7759, 7759, 7759, 7759, 7759, 7759, 7759, 7759, 7759, 7759, 7759, 7759, 7759
7759, 7759, 7759, 7759, 7759, 7759, 7759, 7759, 7759, 7759, 7759, 7759, 7759, 7759, 7759, 7759, 7759, 7759, 7759, 7759, 7759, 7759, 7759, 7759, 7759, 7759, 7759, 7759, 7759, 7759, 7759, 7759, 7759, 7759, 7759, 7759, 7759, 7759, 7759, 7759, 7759, 7759, 7759, 7759, 7759, 7759, 7759, 7759, 7759, 7759, 7759, 7759, 7759, 7759, 7759, 7759, 7759, 7759, 7759, 7759, 7759, 7759, 7759, 7759, 7759, 7759, 7759, 7759, 7759, 7759, 7759, 7759, 7759, 7759, 7759, 7759, 7759, 7759, 7759, 7759
7759, 7759, 7759, 7759, 7759, 7759, 7759, 7759, 7759, 7759, 7759, 7759, 7759, 7759, 7759, 7759, 7759, 7759, 7759, 7759, 7759, 7759, 7759, 7759, 7759, 7759, 7759, 7759, 7759, 7759, 7759, 7759, 7759, 7759, 7759, 7759, 7759, 7759, 7759, 7759, 7759, 7759, 7759, 7759, 7759, 7759, 7759, 7759, 7759, 7759, 7759, 7759, 7759, 7759, 7759, 7759, 7759, 7759, 7759, 7759, 7759, 7759, 7759, 7759, 7759, 7759, 7759, 7759, 7759, 7759, 7759, 7759, 7759, 7759, 7759, 7759, 7759, 7759, 7759, 7759
7759, 7759, 7759, 7759, 7759, 7759, 7759, 7759, 7759, 7759, 7759, 7759, 7759, 7759, 7759, 7759, 7759, 7759, 7759, 7759, 7759, 7759, 7759, 7759, 7759, 7759, 7759, 7759, 7759, 7759, 7759, 7759, 7759, 7759, 7759, 7759, 7759, 7759, 7759, 7759, 7759, 7759, 7759, 7759, 7759, 7759, 7759, 7759, 7759, 7759, 7759, 7759, 7759, 7759, 7759, 7759, 7759, 7759, 7759, 7759, 7759, 7759, 7759, 7759, 7759, 7759, 7759, 7759, 7759, 7759, 7759, 7759, 7759, 7759, 7759, 7759, 7759, 7759, 7759, 7759
7759, 7759, 7759, 7759, 7759, 7759, 7759, 7759, 7759, 7759, 7759, 7759, 7759, 7759, 7759, 7759, 7759, 7759, 7759, 7759, 7759, 7759, 7759, 7759, 7759, 7759, 7759, 7759, 7759, 7759, 7759, 7759, 7759, 7759, 7759, 7759, 7759, 7759, 7759, 7759, 7759, 7759, 7759, 7759, 7759, 7759, 7759, 7759, 7759, 7759, 7759, 7759, 7759, 7759, 7759, 7759, 7759, 7759, 7759, 7759, 7759, 7759, 7759, 7759, 7759, 7759, 7759, 7759, 7759, 7759, 7759, 7759, 7759, 7759, 7759, 7759, 7759, 7759, 7759, 7759
