2559, 2559, 2559, 2559, 2559, 2559, 2559, 2559, 2559, 2559, 2559, 2559, 2047, 2047, 2047, 2047, 2047, 2047, 2047, 2047, 2047, 2047, 2047, 2047, 2047, 2047, 2047, 2047, 2047, 2047, 2047, 2047, 2047, 2047, 2047, 2047, 2047, 2047, 2047, 2047, 2047, 2047, 2047, 2047, 2047, 2047, 2047, 2047, 2047, 2047, 2047, 2047, 2047, 2047, 2047, 2047, 2047, 2047, 2047, 2047, 2047, 2047, 2047, 2047, 2047, 2047, 2047, 2047, 2559, 2559, 2559, 2559, 2559, 2559, 2559, 2559, 2559, 2559, 2559, 2047
2559, 2559, 2559, 2559, 2559, 2559, 2559, 2559, 2559, 2559, 2559, 2559, 2559, 2559, 2559, 2559, 2559, 2559, 2559, 2559, 2559, 2559, 2559, 2559, 2559, 2559, 2559, 2559, 2559, 2559, 2559, 2559, 2559, 2559, 2559, 2559, 2559, 2559, 2559, 2559, 2559, 2559, 2559, 2559, 2559, 2559, 2559, 2559, 2559, 2559, 2559, 2559, 2559, 2559, 2559, 2559, 2559, 2559, 2559, 2559, 2559, 2559, 2559, 2559, 2559, 2559, 2559, 2559, 2559, 2559, 2559, 2559, 2559, 2559, 2559, 2559, 2559, 2559, 2559, 2047
2559, 2559, 2559, 2559, 2559, 2559, 2559, 2559, 2559, 2559, 2559, 2559, 2559, 2559, 2559, 2559, 2559, 2559, 2559, 2559, 2559, 2559, 2559, 2559, 2559, 2559, 2559, 2559, 2559, 2559, 2559, 2559, 2559, 2559, 2559, 2559, 2559, 2559, 2559, 2559, 2559, 2559, 2559, 2559, 2559, 2559, 2559, 2559, 2559, 2559, 2559, 2559, 2559, 2559, 2559, 2559, 2559, 2559, 2559, 2559, 2559, 2559, 2559, 2559, 2559, 2559, 2559, 2559, 2559, 2559, 2559, 2559, 2559, 2559, 2559, 2559, 2559, 2559, 2559, 2047
2559, 2559, 2559, 2559, 2559, 2559, 2559, 2559, 2559, 2559, 2559, 2559, 2559, 2559, 2559, 2559, 2559, 2559, 2559, 2559, 2559, 2559, 2559, 2559, 2559, 2559, 2559, 2559, 2559, 2559, 2559, 2559, 2559, 2559, 2559, 2559, 2559, 2559, 2559, 2559, 2559, 2559, 2559, 2559, 2559, 2559, 2559, 2559, 2559, 2559, 2559, 2559, 2559, 2559, 2559, 2559, 2559, 2559, 2559, 2559, 2559, 2559, 2559, 2559, 2559, 2559, 2559, 2559, 2559, 2559, 2559, 2559, 2559, 2559, 2559, 2559, 2559, 2559, 2559, 2047
2559, 1356, 1357, 1358, 1359, 1360, 1361, 2559, 2559, 2559, 2559, 2559, 2559, 2559, 2559, 2559, 2559, 2559, 2559, 2559, 2559, 2559, 2559, 2559, 2559, 2559, 2559, 2559, 2559, 2559, 2559, 2559, 2559, 2559, 2559, 2559, 2559, 2559, 2559, 2559, 2559, 2559, 2559, 2559, 2559, 2559, 2559, 2559, 2559, 2559, 2559, 2559, 2559, 2559, 2559, 2559, 2559, 2559, 2559, 2559, 2559, 2559, 2559, 2559, 2559, 2559, 2559, 2559, 2559, 2559, 2559, 2559, 2559, 2559, 2559, 2559, 2559, 2559, 2559, 2047
2559, 1388, 1389, 1390, 1391, 1392, 1393, 2559, 2559, 2559, 2559, 2559, 2559, 2559, 2559, 2559, 2559, 2559, 2559, 2559, 2559, 2559, 2559, 2559, 2559, 2559, 2559, 2559, 2559, 2559, 2559, 2559, 2559, 2559, 2559, 2559, 2559, 2559, 2559, 2559, 2559, 2559, 2559, 2559, 2559, 2559, 2559, 2559, 2559, 2559, 2559, 2559, 2559, 2559, 2559, 2559, 2559, 2559, 2559, 2559, 2559, 2559, 2559, 2559, 2559, 2559, 2559, 2559, 2559, 2559, 2559, 2559, 2559, 2559, 2559, 2559, 2559, 2559, 2559, 2047
2559, 1420, 1421, 1422, 1423, 1424, 1425, 2559, 2559, 2559, 2559, 2559, 2559, 2559, 2559, 2559, 2559, 2559, 2559, 2559, 2559, 2559, 2559, 2559, 2559, 2559, 2559, 2559, 2559, 2559, 2559, 2559, 2559, 2559, 2559, 2559, 2559, 2559, 2559, 2559, 2559, 2559, 2559, 2559, 2559, 2559, 2559, 2559, 2559, 2559, 2559, 2559, 2559, 2559, 2559, 2559, 2559, 2559, 2559, 2559, 2559, 2559, 2559, 2559, 2559, 2559, 2559, 2559, 2559, 2559, 2559, 2559, 2559, 2559, 2559, 2559, 2559, 2559, 2559, 2047
2559, 1452, 1453, 1454, 1455, 1456, 1457, 2559, 2559, 2559, 2559, 2559, 2559, 2559, 2559, 2559, 2559, 2047, 896, 897, 898, 899, 900, 901, 902, 903, 904, 905, 906, 907, 908, 909, 910, 911, 903, 904, 905, 906, 907, 908, 909, 910, 911, 912, 913, 914, 912, 913, 914, 915, 916, 917, 918, 919, 920, 921, 922, 923, 924, 925, 926, 927, 2559, 2559, 2559, 2559, 2559, 2559, 2559, 2559, 2559, 2559, 2559, 2559, 2559, 2559, 2559, 2559, 2559, 2047
2559, 1484, 1485, 1486, 1487, 1488, 1489, 2559, 2559, 2559, 2559, 2559, 2559, 2559, 2559, 2559, 2559, 2047, 928, 929, 930, 931, 932, 933, 934, 935, 936, 937, 938, 939, 940, 941, 942, 943, 935, 936, 937, 938, 939, 940, 941, 942, 943, 944, 945, 946, 944, 945, 946, 947, 948, 949, 950, 951, 952, 953, 954, 955, 956, 957, 958, 959, 2559, 2559, 2559, 2559, 2559, 2559, 2559, 2559, 2559, 2559, 2559, 2559, 2559, 2559, 2559, 2559, 2559, 2047
2559, 1516, 1517, 1518, 1519, 1520, 1521, 2559, 2559, 2559, 2559, 2559, 2559, 2559, 2559, 2559, 2559, 2047, 960, 961, 962, 963, 964, 965, 966, 967, 968, 969, 970, 971, 972, 973, 974, 975, 967, 968, 969, 1104, 1104, 972, 973, 974, 975, 976, 977, 978, 976, 977, 978, 979, 980, 981, 982, 983, 984, 985, 986, 987, 988, 989, 990, 991, 2559, 2559, 2559, 2559, 2559, 2559, 2559, 2559, 2559, 2559, 2559, 2559, 2559, 2559, 2559, 2559, 2559, 2047
2559, 1548, 1549, 1550, 1551, 1552, 1553, 2559, 2559, 2559, 2559, 2559, 2559, 2559, 2559, 2559, 2559, 2047, 1088, 1089, 1090, 330, 331, 332, 333, 334, 335, 336, 337, 330, 331, 332, 333, 334, 335, 336, 337, 1103, 1103, 330, 331, 332, 333, 334, 330, 331, 332, 333, 334, 335, 336, 330, 331, 332, 333, 334, 335, 336, 337, 1091, 1092, 1093, 2559, 2559, 2559, 2559, 2559, 2559, 2559, 2559, 2559, 2559, 2559, 2559, 2559, 2559, 2559, 2559, 2559, 2047
2559, 2559, 2559, 2559, 2559, 2559, 2559, 2559, 2559, 2559, 2559, 2559, 2559, 2559, 2559, 2559, 2559, 2559, 1120, 1121, 1122, 362, 363, 364, 365, 366, 367, 368, 369, 362, 363, 364, 365, 366, 330, 331, 332, 333, 334, 362, 363, 364, 365, 366, 362, 363, 364, 365, 366, 367, 368, 362, 363, 364, 365, 366, 367, 368, 369, 1123, 1124, 1125, 2559, 2559, 2559, 2559, 2559, 2559, 2559, 2559, 2559, 2559, 2559, 2559, 2559, 2559, 2559, 2559, 2559, 2047
2559, 2559, 2559, 2559, 2559, 2559, 2559, 2559, 2559, 2559, 2559, 2559, 2559, 2559, 2559, 2559, 2559, 2559, 1152, 1153, 1154, 394, 395, 396, 397, 398, 399, 400, 401, 394, 395, 396, 397, 398, 362, 363, 364, 365, 366, 394, 395, 396, 397, 398, 394, 395, 396, 397, 398, 399, 362, 363, 364, 365, 366, 367, 368, 369, 401, 1155, 1156, 1157, 2559, 2559, 2559, 2559, 2559, 2559, 2559, 2559, 2559, 2559, 2559, 2559, 2559, 2559, 2559, 2559, 2559, 2047
2559, 2559, 2559, 2559, 2559, 2559, 2559, 2559, 2559, 2559, 2559, 2559, 2559, 2559, 2559, 2559, 2559, 2559, 1184, 1185, 1186, 426, 427, 428, 429, 430, 431, 432, 433, 426, 427, 428, 429, 430, 394, 395, 396, 397, 398, 426, 427, 428, 429, 430, 426, 427, 428, 429, 430, 431, 394, 395, 396, 397, 398, 399, 400, 401, 433, 1187, 1188, 1189, 2559, 2559, 2559, 2559, 2559, 2559, 2559, 2559, 2559, 2559, 2559, 2559, 2559, 2559, 2559, 2559, 2559, 2559
2559, 2559, 2559, 2559, 2559, 2559, 2559, 2559, 2559, 2559, 2559, 2559, 2559, 2559, 2559, 2559, 2559, 2559, 1216, 1217, 1218, 64, 65, 298, 299, 300, 301, 302, 303, 299, 300, 301, 302, 303, 426, 427, 428, 429, 430, 431, 432, 433, 299, 300, 301, 302, 303, 299, 300, 301, 426, 427, 428, 429, 430, 431, 432, 433, 35, 1219, 1220, 1221, 2559, 2559, 2559, 2559, 2559, 2559, 2559, 1350, 1351, 1352, 1353, 1354, 1355, 2559, 2559, 2559, 2559, 2559
1362, 1363, 1364, 2559, 2559, 2559, 2559, 2559, 2559, 2559, 2559, 2559, 2559, 2559, 2559, 2559, 2559, 2559, 1248, 1249, 1250, 96, 97, 330, 331, 332, 333, 334, 335, 331, 332, 333, 334, 362, 363, 364, 365, 366, 367, 368, 369, 330, 331, 332, 333, 334, 335, 331, 332, 333, 458, 459, 460, 461, 462, 463, 464, 465, 369, 1251, 1252, 1253, 2559, 2559, 2559, 2559, 2559, 2559, 2559, 1382, 1383, 1384, 1385, 1386, 1387, 2559, 2559, 2559, 2559, 2559
1394, 1395, 1396, 2047, 2047, 2047, 2047, 2047, 2047, 2559, 2559, 2559, 2559, 2559, 2559, 2559, 2559, 2559, 1280, 1281, 1282, 128, 129, 362, 363, 364, 365, 366, 367, 363, 364, 365, 366, 394, 395, 396, 397, 398, 399, 400, 401, 362, 363, 364, 365, 366, 367, 363, 364, 365, 490, 491, 492, 493, 494, 495, 496, 497, 401, 1283, 1284, 1285, 2559, 2559, 2559, 2559, 2559, 2559, 2559, 1414, 1415, 1416, 1417, 1418, 1419, 2559, 2559, 2559, 2559, 2559
1426, 1427, 1428, 2047, 2047, 2047, 2047, 2047, 2047, 2047, 2559, 2559, 1461, 1462, 1463, 1464, 2559, 2559, 1088, 1089, 1090, 160, 161, 162, 163, 164, 165, 85, 85, 168, 169, 360, 361, 426, 427, 428, 429, 430, 431, 432, 433, 370, 371, 372, 373, 374, 375, 335, 335, 234, 522, 523, 524, 525, 526, 527, 528, 529, 433, 1315, 1316, 1317, 2559, 2559, 2559, 2559, 2559, 2559, 2559, 1446, 1447, 1448, 1449, 1450, 1451, 2559, 2559, 2559, 2559, 2559
2047, 2047, 2047, 2047, 2047, 2047, 2047, 2047, 2047, 2047, 2559, 2559, 1493, 1494, 1495, 1496, 2559, 2559, 1120, 1121, 1122, 192, 193, 202, 203, 204, 205, 206, 207, 1747, 1748, 392, 393, 458, 459, 460, 461, 462, 463, 464, 465, 402, 403, 404, 405, 406, 407, 1747, 1748, 266, 554, 555, 556, 557, 558, 559, 560, 561, 465, 1091, 1092, 1093, 2559, 2559, 2559, 2559, 2559, 2559, 2559, 1478, 1479, 1480, 1481, 1482, 1483, 2559, 2559, 2559, 2559, 2559
2047, 2047, 2047, 2047, 2047, 2047, 2047, 2047, 2047, 2047, 2559, 2559, 1525, 1526, 1527, 1528, 2559, 2559, 1152, 1153, 1154, 224, 225, 234, 235, 236, 237, 238, 239, 1779, 1780, 424, 425, 490, 491, 492, 493, 494, 495, 496, 497, 434, 435, 436, 437, 438, 439, 1779, 1780, 298, 586, 587, 588, 589, 590, 591, 592, 593, 497, 1123, 1124, 1125, 2559, 2559, 2559, 2559, 2559, 2559, 2559, 1510, 1511, 1512, 1513, 1514, 1515, 2559, 2559, 2559, 2559, 2559
2047, 2047, 2047, 2047, 2047, 2559, 2559, 2559, 2559, 2559, 2559, 2559, 2559, 2559, 2559, 2559, 2559, 2559, 1184, 1185, 1186, 256, 257, 266, 267, 268, 269, 270, 271, 1747, 1748, 456, 457, 522, 523, 524, 525, 526, 527, 528, 529, 466, 467, 468, 469, 470, 471, 1747, 1748, 202, 458, 522, 523, 524, 525, 526, 527, 528, 529, 1155, 1156, 1157, 2559, 2559, 1344, 1345, 1346, 1347, 1348, 1542, 1543, 1544, 1545, 1546, 1547, 2559, 2559, 2559, 2559, 2559
2047, 2047, 2559, 2559, 1344, 1345, 1346, 1347, 1348, 1349, 2559, 2559, 2559, 2559, 2559, 2559, 2559, 2559, 1216, 1217, 1218, 288, 289, 298, 299, 300, 301, 302, 303, 1779, 1780, 298, 299, 554, 555, 556, 557, 558, 559, 560, 561, 292, 293, 294, 295, 296, 297, 1779, 1780, 234, 490, 554, 555, 556, 557, 558, 559, 560, 561, 1187, 1188, 1189, 2559, 2559, 1376, 1377, 1378, 1379, 1380, 1381, 2559, 2047, 2047, 2559, 2559, 2559, 2559, 2559, 2559, 2559
2047, 2047, 2559, 2559, 1376, 1377, 1378, 1379, 1380, 1381, 2559, 2559, 2559, 2559, 2559, 2559, 2559, 2559, 1248, 1249, 1250, 320, 321, 202, 203, 204, 205, 206, 207, 1747, 1748, 330, 331, 586, 587, 588, 589, 590, 591, 592, 593, 324, 325, 326, 327, 328, 329, 1747, 1748, 266, 522, 586, 587, 588, 589, 590, 591, 592, 593, 1219, 1220, 1221, 2559, 2559, 1408, 1409, 1410, 1411, 1412, 1413, 2559, 2047, 2047, 2559, 2559, 2559, 2559, 2559, 2559, 2559
2047, 2047, 2559, 2559, 1408, 1409, 1410, 1411, 1412, 1413, 2559, 2559, 2559, 2559, 2559, 2559, 2559, 2559, 1088, 1089, 1090, 352, 353, 234, 235, 236, 237, 238, 239, 1779, 1780, 362, 363, 364, 365, 366, 367, 352, 353, 354, 355, 356, 357, 358, 359, 360, 361, 1779, 1780, 298, 554, 555, 556, 557, 558, 559, 560, 561, 323, 1251, 1252, 1253, 2559, 2559, 1440, 1441, 1442, 1443, 1444, 1445, 2559, 2047, 2047, 2559, 2559, 2559, 2559, 2559, 2559, 2559
2047, 2047, 2559, 2559, 1440, 1441, 1442, 1443, 1444, 1445, 2559, 2559, 2559, 2559, 2559, 2559, 2559, 2559, 1120, 1121, 1122, 384, 385, 266, 267, 268, 269, 270, 202, 203, 204, 394, 395, 396, 397, 398, 399, 384, 385, 386, 387, 388, 389, 390, 391, 392, 393, 202, 203, 204, 362, 363, 364, 365, 366, 367, 368, 369, 355, 1283, 1284, 1285, 2559, 2559, 1472, 1473, 1474, 1475, 1476, 1477, 2559, 2559, 2559, 2559, 2559, 2559, 2559, 2559, 2559, 2559
2047, 2047, 2559, 2559, 1472, 1473, 1474, 1475, 1476, 1477, 2559, 2559, 2559, 2559, 2559, 2559, 2559, 2559, 1152, 1153, 1154, 416, 417, 298, 299, 300, 301, 302, 205, 202, 203, 204, 427, 428, 429, 430, 431, 416, 417, 418, 419, 420, 421, 422, 423, 424, 425, 205, 206, 207, 394, 395, 396, 397, 398, 399, 400, 401, 387, 1315, 1316, 1317, 2559, 2559, 1504, 1505, 1506, 1507, 1508, 1509, 2559, 2559, 2559, 2559, 2559, 2559, 2559, 2559, 2559, 2559
2047, 2047, 2559, 2559, 1504, 1505, 1506, 1507, 1508, 1509, 2559, 2559, 2559, 2559, 2559, 2559, 2559, 2559, 1184, 1185, 1186, 362, 363, 364, 365, 366, 367, 368, 369, 205, 206, 207, 459, 460, 461, 462, 463, 448, 449, 450, 451, 202, 203, 204, 205, 206, 207, 202, 203, 204, 426, 427, 428, 429, 430, 431, 432, 433, 419, 1091, 1092, 1093, 2559, 2559, 1536, 1537, 1538, 1539, 1540, 1541, 2559, 2559, 2559, 2559, 2559, 2559, 2559, 2559, 2559, 2559
2047, 2047, 2559, 2559, 1536, 1537, 1538, 1539, 1540, 1541, 2559, 2559, 2559, 2559, 2559, 2559, 2559, 2559, 1216, 1217, 1218, 394, 395, 396, 397, 398, 399, 400, 401, 234, 235, 236, 203, 204, 205, 206, 207, 480, 481, 482, 483, 234, 235, 236, 237, 238, 239, 205, 206, 207, 458, 459, 460, 461, 462, 463, 464, 465, 451, 1123, 1124, 1125, 2559, 2559, 2559, 2559, 2559, 2559, 2559, 2559, 2559, 2559, 2559, 2559, 2559, 2559, 2559, 2559, 2559, 2559
2047, 2047, 2559, 2559, 2559, 2559, 2559, 2559, 2559, 2559, 2559, 2559, 2559, 2559, 2559, 2559, 2559, 2559, 1248, 1249, 1250, 426, 427, 428, 429, 430, 431, 432, 433, 8, 9, 234, 235, 236, 237, 238, 239, 32, 33, 34, 35, 202, 203, 204, 205, 206, 207, 234, 235, 236, 490, 491, 492, 493, 494, 495, 496, 497, 483, 1155, 1156, 1157, 2559, 2559, 2559, 2559, 2559, 2559, 2559, 2559, 2559, 2559, 2559, 2559, 2559, 2559, 2559, 2559, 1574, 1575
2047, 2047, 2559, 2559, 2559, 2559, 2559, 2559, 2559, 2559, 2559, 2559, 2559, 2559, 2559, 2559, 2559, 2559, 1280, 1281, 1282, 458, 459, 460, 461, 462, 463, 464, 465, 66, 67, 266, 267, 268, 269, 270, 271, 394, 394, 76, 77, 234, 235, 236, 237, 238, 239, 335, 335, 362, 522, 523, 524, 525, 526, 527, 528, 529, 9, 1187, 1188, 1189, 2559, 2559, 2559, 2559, 2559, 2559, 2559, 2559, 1362, 1363, 1364, 2559, 2559, 2559, 2559, 2559, 1606, 1607
2047, 2047, 2559, 2559, 2559, 2559, 2559, 2559, 2559, 2559, 2559, 2559, 2559, 2559, 2559, 2559, 2559, 2559, 1088, 1089, 1090, 490, 491, 492, 493, 494, 495, 496, 497, 1747, 1748, 298, 299, 300, 301, 302, 303, 132, 133, 134, 202, 203, 204, 205, 206, 207, 271, 1747, 1748, 394, 554, 555, 556, 557, 558, 559, 560, 561, 67, 1219, 1220, 1221, 2559, 2559, 2559, 2559, 2559, 2559, 2559, 2559, 1394, 1395, 1396, 2559, 2559, 2559, 1574, 1575, 1574, 1575
2047, 2047, 2559, 2559, 2559, 2559, 2559, 2559, 2559, 2559, 2559, 2559, 2559, 2559, 2559, 2559, 2559, 2559, 1120, 1121, 1122, 522, 523, 524, 525, 526, 527, 528, 529, 1779, 1780, 330, 331, 332, 333, 334, 335, 174, 175, 192, 234, 235, 236, 237, 238, 239, 303, 1779, 1780, 426, 586, 587, 588, 589, 590, 591, 592, 593, 109, 1251, 1252, 1253, 2559, 2559, 2559, 2559, 2559, 2559, 2559, 2559, 1426, 1427, 1428, 2559, 2559, 2559, 1606, 1607, 1606, 1607
2047, 2047, 2559, 2559, 2559, 2559, 2559, 2559, 2559, 2559, 2559, 2559, 2559, 2559, 2559, 2559, 2559, 2559, 1152, 1153, 1154, 554, 555, 556, 557, 558, 559, 560, 561, 1747, 1748, 362, 363, 364, 365, 366, 367, 232, 233, 234, 266, 267, 268, 269, 270, 271, 335, 1747, 1748, 458, 459, 460, 461, 462, 463, 464, 465, 166, 167, 1283, 1284, 1285, 2559, 2559, 2559, 2559, 2559, 2559, 2559, 2559, 2559, 2559, 2559, 2559, 2559, 2559, 2559, 2559, 2559, 2559
2047, 2047, 2559, 2559, 2559, 2559, 2559, 2559, 2559, 2559, 2559, 2559, 2559, 2559, 2559, 2559, 2559, 2559, 1184, 1185, 1186, 586, 587, 588, 589, 590, 591, 592, 593, 1779, 1780, 266, 267, 268, 269, 270, 271, 290, 291, 292, 298, 202, 203, 204, 205, 206, 207, 1779, 1780, 490, 491, 492, 493, 494, 495, 496, 497, 224, 225, 1091, 1092, 1093, 2559, 2559, 2559, 2559, 2559, 2559, 2559, 2559, 2559, 2559, 2559, 2559, 2559, 2559, 2559, 2559, 2559, 2559
2047, 2047, 2559, 2559, 2559, 2559, 2559, 1458, 1459, 1460, 2559, 2559, 2559, 2559, 2559, 2559, 2559, 2559, 1216, 1217, 1218, 300, 301, 302, 303, 320, 321, 322, 323, 1747, 1748, 298, 299, 300, 301, 302, 303, 332, 333, 334, 330, 234, 235, 236, 237, 238, 239, 1747, 1748, 522, 362, 363, 364, 365, 366, 367, 368, 369, 267, 1123, 1124, 1125, 2559, 2559, 2559, 2559, 2559, 2559, 2559, 2559, 2559, 2559, 2559, 2559, 2559, 2559, 2559, 2559, 2559, 2559
2047, 2047, 2559, 2559, 2559, 1574, 1575, 1490, 1491, 1492, 1356, 1357, 1358, 1359, 1360, 1361, 2559, 2559, 1248, 1249, 1250, 358, 202, 203, 204, 205, 206, 207, 365, 1779, 1780, 330, 331, 332, 333, 334, 335, 390, 391, 392, 362, 266, 267, 268, 269, 270, 271, 1779, 1780, 554, 394, 395, 396, 397, 398, 399, 400, 401, 325, 1155, 1156, 1157, 2559, 2559, 2559, 2559, 2559, 2559, 2559, 2559, 2559, 2559, 2559, 2559, 2559, 2559, 2559, 2559, 2559, 2559
2047, 2047, 2559, 2559, 2559, 1606, 1607, 1522, 1523, 1524, 1388, 1389, 1390, 1391, 1392, 1393, 2047, 2047, 1088, 1089, 1090, 416, 234, 202, 203, 204, 205, 206, 207, 202, 203, 204, 363, 364, 365, 366, 367, 448, 449, 450, 451, 298, 299, 300, 301, 302, 303, 202, 203, 586, 426, 427, 428, 429, 430, 431, 432, 433, 367, 1187, 1188, 1189, 2559, 2559, 2559, 2559, 2559, 2559, 2559, 2559, 2559, 2559, 2559, 2559, 2559, 2559, 2559, 2559, 2559, 2559
2047, 2047, 2047, 2047, 2047, 2047, 2047, 2047, 2047, 2047, 1420, 1421, 1422, 1423, 1424, 1425, 2047, 2047, 1120, 1121, 1122, 458, 266, 234, 235, 236, 237, 238, 239, 205, 206, 207, 485, 486, 487, 488, 362, 363, 364, 365, 366, 367, 368, 369, 333, 334, 335, 205, 206, 207, 458, 459, 460, 461, 462, 463, 464, 465, 425, 1219, 1220, 1221, 2559, 2559, 2559, 2559, 2559, 2559, 2559, 2559, 2559, 2559, 2559, 2559, 2559, 2559, 2559, 2559, 2559, 2559
2047, 2559, 2559, 2559, 2559, 2559, 2559, 2559, 2559, 2559, 1452, 1453, 1454, 1455, 1456, 1457, 2047, 2047, 1152, 1153, 1154, 4, 298, 266, 267, 268, 269, 270, 271, 202, 203, 204, 15, 32, 33, 34, 394, 395, 396, 397, 398, 399, 400, 401, 365, 366, 367, 202, 203, 204, 490, 491, 492, 493, 494, 495, 496, 497, 483, 1251, 1252, 1253, 2559, 2559, 2559, 2559, 2559, 2559, 2559, 2559, 2559, 2559, 2559, 2559, 2559, 2559, 2559, 2559, 2559, 2559
2047, 2559, 2559, 2559, 2559, 2559, 2559, 2559, 2559, 2559, 1484, 1485, 1486, 1487, 1488, 1489, 2559, 2559, 1184, 1185, 1186, 46, 330, 298, 299, 300, 301, 302, 303, 205, 206, 207, 73, 74, 75, 76, 426, 427, 428, 429, 430, 431, 432, 433, 101, 102, 103, 205, 206, 207, 522, 523, 524, 525, 526, 527, 528, 529, 13, 1283, 1284, 1285, 2559, 2559, 2559, 2559, 2559, 2559, 2559, 2559, 2559, 2559, 2559, 2559, 2559, 2559, 2559, 2559, 2559, 2559
2047, 2559, 2559, 2559, 2559, 2559, 2559, 2559, 2559, 2559, 1516, 1517, 1518, 1519, 1520, 1521, 2559, 2559, 1216, 1217, 1218, 104, 362, 330, 331, 332, 333, 334, 335, 234, 235, 360, 361, 362, 363, 364, 458, 459, 460, 461, 462, 463, 464, 465, 373, 374, 375, 234, 235, 236, 554, 555, 556, 557, 558, 559, 560, 561, 71, 1315, 1316, 1317, 2559, 2559, 2559, 2559, 2559, 2559, 2559, 2559, 2559, 2559, 2559, 2559, 2559, 2559, 2559, 2559, 2559, 2559
2493, 2559, 2559, 2559, 2559, 2559, 2559, 2559, 2559, 2559, 1548, 1549, 1550, 1551, 1552, 1553, 2559, 2559, 1088, 1089, 1090, 162, 163, 362, 363, 364, 365, 366, 367, 170, 171, 392, 393, 394, 395, 396, 490, 491, 492, 493, 494, 495, 496, 497, 405, 406, 407, 295, 296, 298, 586, 587, 588, 589, 590, 591, 592, 593, 129, 1091, 1092, 1093, 2559, 2559, 2559, 2559, 2559, 2559, 2559, 2559, 2559, 2559, 2559, 2559, 2559, 2559, 2559, 2559, 2559, 2559
2493, 2559, 2559, 2559, 2559, 2559, 2559, 2559, 2559, 2559, 2559, 2559, 2559, 2559, 2559, 2559, 2559, 2559, 1120, 1121, 1122, 204, 202, 202, 203, 204, 205, 206, 207, 1747, 1748, 360, 361, 362, 363, 364, 522, 523, 524, 525, 526, 527, 528, 529, 373, 374, 375, 1747, 1748, 330, 331, 332, 333, 334, 335, 168, 169, 170, 171, 1123, 1124, 1125, 2559, 2559, 2559, 2559, 2559, 2559, 2559, 2559, 2559, 2559, 2559, 2559, 2559, 2559, 2559, 2559, 2559, 2559
1433, 1434, 1435, 1436, 1437, 1438, 2559, 2559, 2559, 2559, 2559, 2559, 2559, 2559, 2559, 2559, 2559, 2559, 1152, 1153, 1154, 262, 234, 234, 235, 236, 237, 238, 239, 1779, 1780, 362, 363, 364, 365, 366, 554, 555, 556, 557, 558, 559, 560, 561, 405, 406, 407, 1779, 1780, 362, 363, 362, 363, 364, 365, 366, 367, 368, 369, 1155, 1156, 1157, 2559, 2559, 2559, 2559, 2559, 2559, 2559, 2559, 2559, 2559, 2559, 2559, 2559, 2559, 2559, 2559, 2559, 2559
1465, 1466, 1467, 1468, 1469, 1470, 2559, 2559, 2559, 2559, 2559, 2559, 2559, 2559, 2559, 2559, 2559, 2559, 1184, 1185, 1186, 320, 266, 266, 267, 268, 269, 270, 271, 1747, 1748, 394, 395, 396, 397, 398, 586, 587, 588, 589, 590, 591, 592, 593, 437, 438, 439, 1747, 1748, 266, 267, 394, 395, 396, 397, 398, 399, 400, 401, 1187, 1188, 1189, 2559, 2559, 2559, 2559, 2559, 2559, 2559, 2559, 2559, 2559, 2559, 2559, 2559, 2559, 2559, 2559, 2559, 2559
2493, 2559, 2559, 2559, 2559, 2559, 2559, 2559, 2559, 2559, 2559, 2559, 2559, 2559, 2559, 2559, 2559, 2559, 1216, 1217, 1218, 362, 298, 298, 299, 300, 301, 302, 303, 1779, 1780, 426, 427, 428, 429, 430, 431, 432, 433, 464, 465, 466, 467, 468, 469, 470, 471, 1779, 1780, 298, 299, 426, 427, 428, 429, 430, 431, 432, 433, 1219, 1220, 1221, 2559, 2559, 2559, 2559, 2559, 2559, 2559, 2559, 2559, 1574, 1575, 1568, 1569, 1570, 1571, 1572, 1573, 2559
2047, 2559, 2559, 2559, 2559, 2559, 2559, 2559, 2559, 2559, 2559, 2559, 2559, 2559, 2559, 2559, 2559, 2559, 1088, 1089, 1090, 362, 363, 364, 365, 366, 367, 368, 369, 1747, 1748, 458, 459, 460, 461, 462, 463, 464, 465, 454, 455, 456, 457, 458, 459, 460, 461, 1747, 1748, 330, 331, 458, 459, 460, 461, 462, 463, 464, 465, 1091, 1092, 1093, 2559, 2559, 2559, 2559, 2559, 2559, 2559, 2559, 2559, 1606, 1607, 1600, 1601, 1602, 1603, 1604, 1605, 2047
2047, 2559, 2559, 2559, 2559, 2559, 2559, 2559, 2559, 2559, 2559, 2559, 2559, 2559, 2559, 2559, 2559, 2559, 1120, 1121, 1122, 394, 395, 396, 397, 398, 399, 400, 401, 1779, 1780, 490, 491, 492, 493, 494, 495, 496, 497, 205, 206, 202, 203, 204, 205, 206, 207, 1779, 1780, 362, 363, 490, 491, 492, 493, 494, 495, 496, 497, 1123, 1124, 1125, 2559, 2559, 2559, 2559, 2559, 2559, 2559, 2559, 2559, 2559, 2559, 2559, 2559, 2559, 2559, 2559, 2559, 2047
1344, 1345, 1346, 1347, 1348, 1349, 2559, 2559, 2559, 2559, 2559, 2559, 2559, 2559, 2559, 2559, 2559, 2559, 1152, 1153, 1154, 426, 427, 428, 429, 430, 431, 432, 433, 202, 203, 522, 523, 524, 525, 526, 527, 528, 529, 207, 238, 234, 235, 236, 237, 238, 202, 203, 204, 205, 206, 522, 523, 524, 525, 526, 527, 528, 529, 1155, 1156, 1157, 2559, 2559, 2559, 2559, 2559, 2559, 2559, 2559, 2559, 2559, 1356, 1357, 1358, 1359, 1360, 1361, 2559, 2047
1376, 1377, 1378, 1379, 1380, 1381, 2559, 2559, 2559, 2559, 2559, 2559, 2559, 2559, 2559, 2559, 2559, 2559, 1184, 1185, 1186, 458, 459, 460, 461, 462, 463, 464, 465, 234, 235, 554, 555, 556, 557, 558, 559, 560, 561, 239, 270, 266, 267, 268, 269, 270, 234, 235, 236, 237, 238, 554, 555, 556, 557, 558, 559, 560, 561, 1187, 1188, 1189, 2559, 2559, 2559, 2559, 2559, 2559, 2559, 2559, 2559, 2559, 1388, 1389, 1390, 1391, 1392, 1393, 2559, 2047
1408, 1409, 1410, 1411, 1412, 1413, 2559, 2559, 2559, 1362, 1363, 1364, 2559, 2559, 2559, 2559, 2559, 2559, 1216, 1217, 1218, 490, 491, 492, 493, 494, 495, 496, 497, 368, 369, 586, 587, 588, 589, 590, 591, 592, 593, 360, 361, 362, 363, 360, 361, 362, 363, 364, 365, 366, 367, 586, 587, 588, 589, 590, 591, 592, 593, 1219, 1220, 1221, 2559, 2559, 2559, 2559, 2559, 1461, 1462, 1463, 1464, 1574, 1575, 1421, 1422, 1423, 1424, 1425, 2559, 2047
1440, 1441, 1442, 1443, 1444, 1445, 2559, 2559, 2559, 1394, 1395, 1396, 2559, 2559, 2559, 2559, 2559, 2559, 1248, 1249, 1250, 522, 523, 524, 525, 526, 527, 528, 529, 400, 401, 402, 403, 404, 405, 406, 407, 398, 399, 392, 393, 394, 395, 392, 393, 394, 395, 396, 397, 398, 399, 400, 401, 402, 403, 404, 405, 406, 407, 1251, 1252, 1253, 2559, 2559, 2559, 2559, 2559, 1493, 1494, 1495, 1496, 1606, 1607, 1453, 1454, 1455, 1456, 1457, 2559, 2047
1472, 1473, 1474, 1475, 1476, 1477, 2559, 2559, 2559, 1426, 1427, 1428, 2559, 2559, 2559, 2559, 2559, 2559, 1280, 1281, 1282, 554, 555, 556, 557, 558, 559, 560, 561, 432, 433, 434, 435, 436, 437, 438, 439, 430, 431, 424, 425, 426, 427, 424, 425, 426, 427, 428, 429, 430, 431, 432, 433, 434, 435, 436, 437, 438, 439, 1283, 1284, 1285, 2559, 2559, 2559, 2559, 2559, 1525, 1526, 1527, 1528, 2559, 1484, 1485, 1486, 1487, 1488, 1489, 2559, 2047
1504, 1505, 1506, 1507, 1508, 1509, 2559, 2559, 2559, 2559, 2559, 2559, 2559, 2559, 2559, 2559, 2559, 2559, 1312, 1313, 1314, 586, 587, 588, 589, 590, 591, 592, 593, 464, 465, 466, 467, 468, 469, 470, 471, 462, 463, 456, 457, 458, 459, 456, 457, 458, 459, 460, 461, 462, 463, 464, 465, 466, 467, 468, 469, 470, 471, 1315, 1316, 1317, 2559, 2559, 2559, 2559, 2559, 2559, 2559, 2559, 2559, 2559, 1516, 1517, 1518, 1519, 1520, 1521, 2559, 2047
1536, 1537, 1538, 1539, 1540, 1541, 2559, 2559, 2559, 2559, 2559, 2559, 2559, 2559, 2559, 2559, 2559, 2559, 992, 993, 994, 995, 996, 997, 998, 999, 1000, 1001, 1002, 1003, 1004, 1005, 1006, 999, 1000, 1001, 1002, 1003, 1004, 1005, 1006, 1007, 1008, 1009, 1010, 1011, 1012, 1013, 1014, 1011, 1012, 1013, 1014, 1015, 1016, 1017, 1018, 1019, 1020, 1021, 1022, 1023, 2559, 2559, 2559, 2559, 2559, 2559, 2559, 2559, 2559, 2559, 1548, 1549, 1550, 1551, 1552, 1553, 2559, 2047
2047, 2047, 2047, 2047, 2559, 2559, 2559, 2559, 2559, 2559, 2559, 2559, 2559, 2559, 2559, 2559, 2047, 2047, 1024, 1025, 1026, 1027, 1028, 1029, 1030, 1031, 1032, 1033, 1034, 1035, 1036, 1037, 1038, 1031, 1032, 1033, 1034, 1035, 1036, 1037, 1038, 1039, 1040, 1041, 1042, 1043, 1044, 1045, 1046, 1043, 1044, 1045, 1046, 1047, 1048, 1049, 1050, 1051, 1052, 1053, 1054, 1055, 2559, 2559, 2559, 2559, 2559, 2559, 2559, 2559, 2559, 2559, 2559, 2559, 2559, 2559, 2559, 2559, 2559, 2047
2047, 2047, 2047, 2047, 2559, 2559, 2559, 2559, 2559, 2559, 2559, 2559, 2559, 2559, 2559, 2559, 2047, 2047, 1056, 1057, 1058, 1059, 1060, 1061, 1062, 1063, 1064, 1065, 1066, 1067, 1068, 1069, 1070, 1063, 1064, 1065, 1066, 1067, 1068, 1069, 1070, 1071, 1072, 1073, 1074, 1075, 1076, 1077, 1078, 1075, 1076, 1077, 1078, 1079, 1080, 1081, 1082, 1083, 1084, 1085, 1086, 1087, 2559, 2559, 2559, 2559, 2559, 2559, 2559, 2559, 2559, 2559, 2559, 2559, 2559, 2559, 2559, 2559, 2559, 2047
2493, 2493, 2047, 2047, 2559, 2559, 2559, 2559, 2559, 2559, 2559, 2559, 2559, 2559, 2559, 2559, 2559, 2559, 2559, 2559, 2559, 2559, 2559, 2559, 2559, 2559, 2559, 2559, 2559, 2559, 2559, 2047, 2047, 2559, 2559, 2559, 2559, 2559, 2559, 2559, 2559, 2559, 2559, 2559, 2559, 2559, 2559, 2559, 2559, 2559, 2559, 2559, 2559, 2559, 2559, 2559, 2559, 2559, 2559, 2559, 2559, 2559, 2559, 2559, 2559, 2559, 2559, 2559, 2559, 2559, 2559, 2559, 2559, 2559, 2559, 2559, 2559, 2559, 2559, 2047
2493, 2493, 2047, 2047, 2559, 2559, 2559, 2559, 2559, 2559, 2559, 2559, 2559, 2559, 2559, 2559, 2559, 2559, 2559, 2559, 2559, 2559, 2559, 2559, 2559, 2559, 2559, 2559, 2559, 2559, 2559, 2559, 2559, 2559, 2559, 2559, 2559, 2559, 2559, 2559, 2559, 2559, 2559, 2559, 2559, 2559, 2559, 2559, 2559, 2559, 2559, 2559, 2559, 2559, 2559, 2559, 2559, 2559, 2559, 2559, 2559, 2559, 2559, 2559, 2559, 2559, 2559, 2559, 2559, 2047, 2047, 2047, 2047, 2047, 2047, 2047, 2047, 2047, 2047, 2047
2047, 2047, 2047, 2047, 2559, 2559, 2559, 2559, 2559, 2559, 2559, 2559, 2559, 2559, 2559, 2559, 2559, 2559, 2559, 2559, 2559, 2559, 2559, 2559, 2559, 2559, 2559, 2559, 2559, 2559, 2559, 2559, 2559, 2559, 2559, 2559, 2559, 2559, 2559, 2559, 2559, 2559, 2559, 2559, 2559, 2559, 2559, 2559, 2559, 2559, 2559, 2559, 2559, 2559, 2559, 2559, 2559, 2559, 2559, 2559, 2559, 2559, 2559, 2559, 2559, 2559, 2559, 2559, 2559, 2047, 2047, 2047, 2047, 2047, 2047, 2047, 2047, 2047, 2047, 2047
