1121, 1121, 1121, 1121, 1121, 1121, 1121, 1121, 1121, 1121, 1121, 1121, 1121, 1121, 1121, 1121, 1121, 1121, 1121, 1121, 1121, 1121, 1121, 1121, 1121, 1121, 1121, 1121, 1121, 1121, 1121, 1121, 1121, 1121, 1121, 1121, 1121, 1121, 1121, 1121, 1121, 1121, 1121, 1121, 1121, 1121, 1121, 1121, 1121, 1121, 1121, 1121, 1121, 1121, 1121, 1121, 1121, 1121, 1121, 1121, 1121, 1121, 1121, 1121, 1121, 1121, 1121, 1121, 1121, 1121, 1121, 1121, 1121, 1121, 1121, 1121, 1121, 1121, 1121, 1121
1121, 1121, 1121, 1121, 1121, 1121, 1121, 1121, 1121, 1121, 1121, 1121, 1121, 1121, 1121, 1121, 1121, 1121, 1121, 1121, 1121, 1121, 1121, 1121, 1121, 1121, 1121, 1121, 1121, 1121, 1121, 1121, 1121, 1121, 1121, 1121, 1121, 1121, 1121, 1121, 1121, 1121, 1121, 1121, 1121, 1121, 1121, 1121, 1121, 1121, 1121, 1121, 1121, 1121, 1121, 1121, 1121, 1121, 1121, 1121, 1121, 1121, 1121, 1121, 1121, 1121, 1121, 1121, 1121, 1121, 1121, 1121, 1121, 1121, 1121, 1121, 1121, 1121, 1121, 1121
1121, 1121, 1121, 1121, 1121, 1121, 1121, 1121, 1121, 1121, 1121, 1121, 1121, 1121, 1121, 1121, 1121, 1121, 1121, 1121, 1121, 1121, 1121, 1121, 1121, 1121, 1121, 1121, 1121, 1121, 1121, 1121, 1121, 1121, 1121, 1121, 1121, 1121, 1121, 1121, 1121, 1121, 1121, 1121, 1121, 1121, 1121, 1121, 1121, 1121, 1121, 1121, 1121, 1121, 1121, 1121, 1121, 1121, 1121, 1121, 1121, 1121, 1121, 1121, 1121, 1121, 1121, 1121, 1121, 1121, 1121, 1121, 1121, 1121, 1121, 1121, 1121, 1121, 1121, 1121
1102, 1102, 1102, 1102, 1102, 1102, 1102, 1102, 1102, 1102, 1102, 1102, 1102, 1102, 1102, 1102, 1102, 1102, 1102, 1102, 1102, 1102, 1101, 1101, 1101, 1101, 1101, 1101, 1101, 1101, 1101, 1101, 1102, 1102, 1102, 1102, 1102, 1102, 1102, 1102, 1102, 1102, 1102, 1102, 1102, 1102, 1102, 1102, 1102, 1102, 1102, 1102, 1102, 1102, 1102, 1102, 1102, 1102, 1102, 1102, 1102, 1102, 1102, 1102, 1102, 1102, 1102, 1102, 1102, 1102, 1102, 1102, 1102, 1102, 1102, 1102, 1102, 1102, 1102, 1102
1102, 1102, 1102, 1102, 1102, 1102, 1102, 1102, 1102, 1102, 1102, 1102, 1102, 1102, 1102, 1102, 1102, 1102, 1102, 1102, 1102, 1101, 1101, 1101, 1101, 1101, 1101, 1101, 1101, 1101, 1101, 1101, 1102, 1102, 1102, 1102, 1102, 1102, 1102, 1102, 1102, 1102, 1102, 1102, 1102, 1102, 1102, 1102, 1102, 1102, 1102, 1102, 1102, 1102, 1102, 1102, 1102, 1102, 1102, 1102, 1102, 1102, 1102, 1102, 1102, 1102, 1102, 1102, 1102, 1102, 1102, 1102, 1102, 1102, 1102, 1102, 1102, 1102, 1102, 1102
1102, 1158, 1159, 1160, 1161, 1162, 1163, 1164, 1165, 1166, 1167, 1168, 1169, 1170, 1171, 1172, 1173, 1174, 1175, 1158, 1159, 1101, 1101, 1101, 1101, 1101, 1101, 1101, 1101, 1101, 1101, 1101, 1167, 1168, 1169, 1170, 1171, 1172, 1173, 1174, 1175, 1176, 1177, 1178, 1179, 1180, 1181, 1182, 1158, 1159, 1160, 1161, 1162, 1163, 1164, 1165, 1166, 1167, 1168, 1169, 1170, 1171, 1172, 1173, 1174, 1175, 1176, 1177, 1178, 1179, 1180, 1181, 1182, 1102, 1102, 1102, 1102, 1102, 1102, 1102
1158, 1158, 1159, 1160, 1161, 1162, 1163, 1164, 1165, 1166, 1167, 1168, 1169, 1170, 1171, 1172, 1173, 1174, 1175, 1158, 1159, 1101, 1101, 1101, 1101, 1101, 1101, 1101, 1101, 1101, 1101, 1101, 1168, 1169, 1170, 1171, 1172, 1173, 1174, 1175, 1176, 1177, 1178, 1179, 1180, 1181, 1182, 1158, 1159, 1160, 1161, 1162, 1163, 1164, 1165, 1166, 1167, 1168, 1169, 1170, 1171, 1172, 1173, 1174, 1175, 1176, 1177, 1178, 1179, 1180, 1181, 1182, 1182, 1102, 1102, 1102, 1102, 1102, 1102, 1102
1158, 1158, 1159, 1160, 1161, 1162, 1163, 1164, 1165, 1166, 1167, 1168, 1169, 1170, 1171, 1172, 1173, 1174, 1175, 1158, 1159, 1101, 1101, 1101, 1101, 1101, 1101, 1101, 1101, 1101, 1101, 1101, 1168, 1169, 1170, 1171, 1172, 1173, 1174, 1175, 1176, 1177, 1178, 1179, 1180, 1181, 1182, 1158, 1159, 1160, 1161, 1162, 1163, 1164, 1165, 1166, 1167, 1168, 1169, 1170, 1171, 1172, 1173, 1174, 1175, 1176, 1177, 1178, 1179, 1180, 1181, 1182, 1182, 1102, 1102, 1102, 1102, 1102, 1102, 1102
1158, 1158, 1159, 1160, 1161, 1162, 1163, 1164, 1165, 1166, 1167, 1168, 1169, 1170, 1171, 1172, 1173, 1174, 1175, 1158, 1159, 1101, 1101, 1101, 1101, 1101, 1101, 1101, 1101, 1101, 1101, 1167, 1168, 1169, 1170, 1171, 1172, 1173, 1174, 1175, 1176, 1177, 1178, 1179, 1180, 1181, 1182, 1158, 1159, 1160, 1161, 1162, 1163, 1164, 1165, 1166, 1167, 1168, 1169, 1170, 1171, 1172, 1173, 1174, 1175, 1176, 1177, 1178, 1179, 1180, 1181, 1182, 1182, 1102, 1102, 1102, 1102, 1102, 1102, 1102
1158, 1159, 1160, 1161, 1162, 1163, 1164, 1165, 1166, 1167, 1168, 1169, 1170, 1171, 1172, 1173, 1174, 1175, 1176, 1177, 1178, 1179, 1158, 1159, 1160, 1161, 1162, 1163, 1164, 1165, 1166, 1167, 1168, 1169, 1170, 1171, 1172, 1173, 1174, 1175, 1176, 1177, 1178, 1179, 1180, 1181, 1182, 1158, 1159, 1160, 1161, 1162, 1163, 1164, 1165, 1166, 1167, 1168, 1169, 1170, 1171, 1172, 1173, 1174, 1175, 1176, 1177, 1178, 1179, 1180, 1181, 1182, 1102, 1102, 1102, 1102, 1102, 1102, 1102, 1102
1102, 1089, 1093, 1093, 1093, 1093, 1053, 1053, 1093, 1093, 1093, 1093, 1093, 1093, 1093, 1093, 1093, 1093, 1093, 1093, 1093, 1093, 1093, 1093, 1093, 1093, 1093, 1093, 1093, 1093, 1093, 1093, 1093, 1093, 1093, 1093, 1093, 1093, 1093, 1093, 1093, 1093, 1093, 1093, 1093, 1093, 1093, 1093, 1093, 1093, 1093, 1093, 1093, 1093, 1093, 1093, 1093, 1093, 1093, 1093, 1093, 1093, 1093, 1093, 1091, 1091, 1053, 1053, 1093, 1093, 1093, 1100, 1102, 1102, 1102, 1102, 1102, 1102, 1102, 1102
1102, 1103, 224, 225, 226, 227, 1052, 1052, 230, 231, 232, 233, 234, 331, 331, 237, 238, 96, 97, 98, 192, 193, 224, 225, 226, 227, 228, 224, 225, 226, 227, 228, 224, 225, 226, 227, 228, 229, 224, 225, 226, 227, 228, 192, 193, 194, 192, 193, 194, 224, 225, 224, 225, 226, 227, 228, 229, 331, 331, 331, 331, 433, 235, 236, 308, 308, 1052, 1052, 241, 242, 243, 1106, 1102, 1102, 1102, 1102, 1102, 1102, 1102, 1102
1102, 1103, 256, 257, 258, 259, 260, 261, 262, 263, 264, 265, 266, 331, 331, 331, 270, 128, 664, 664, 224, 225, 256, 257, 258, 259, 260, 256, 257, 258, 259, 260, 256, 257, 258, 259, 260, 261, 256, 257, 258, 259, 260, 224, 225, 226, 224, 225, 226, 256, 257, 256, 257, 258, 259, 260, 261, 331, 331, 201, 202, 433, 267, 268, 331, 331, 271, 272, 331, 331, 275, 1106, 1102, 1102, 1102, 1102, 1102, 1102, 1102, 1102
1102, 1103, 288, 289, 331, 331, 331, 331, 294, 295, 296, 297, 298, 331, 331, 331, 302, 160, 177, 177, 256, 257, 288, 289, 290, 291, 292, 288, 228, 229, 230, 231, 232, 233, 290, 291, 138, 139, 140, 141, 142, 143, 292, 256, 257, 258, 256, 356, 357, 358, 359, 360, 361, 290, 291, 292, 201, 202, 331, 233, 234, 298, 299, 300, 194, 201, 202, 212, 331, 331, 307, 1106, 1102, 1102, 1102, 1102, 1102, 1102, 1102, 1102
1102, 1103, 320, 321, 331, 331, 331, 331, 103, 104, 105, 106, 330, 331, 178, 179, 334, 192, 177, 177, 288, 289, 320, 321, 322, 323, 324, 320, 234, 235, 236, 237, 238, 239, 322, 323, 144, 145, 146, 147, 148, 149, 324, 288, 289, 290, 288, 362, 363, 364, 365, 366, 367, 322, 323, 324, 233, 234, 331, 331, 194, 195, 331, 332, 226, 233, 234, 211, 212, 331, 339, 1106, 1102, 1102, 1102, 1102, 1102, 1102, 1102, 1102
1102, 1103, 352, 353, 331, 331, 356, 357, 107, 108, 109, 110, 362, 331, 210, 211, 366, 224, 194, 195, 320, 321, 352, 353, 354, 355, 356, 138, 240, 241, 242, 243, 244, 245, 231, 232, 233, 151, 152, 153, 154, 155, 356, 320, 321, 322, 356, 368, 369, 370, 371, 372, 373, 331, 331, 356, 357, 358, 331, 331, 226, 227, 363, 364, 365, 226, 227, 243, 244, 331, 371, 1106, 1102, 1102, 1102, 1102, 1102, 1102, 1102, 1102
1102, 1103, 384, 385, 331, 331, 388, 389, 111, 112, 113, 114, 394, 331, 331, 364, 365, 256, 226, 227, 352, 353, 384, 385, 386, 387, 388, 144, 246, 247, 260, 261, 262, 263, 237, 238, 239, 157, 170, 171, 172, 173, 360, 361, 353, 354, 362, 374, 375, 388, 389, 390, 391, 331, 331, 388, 389, 390, 331, 331, 393, 394, 395, 396, 397, 194, 195, 331, 401, 402, 403, 1106, 1102, 1102, 1102, 1102, 1102, 1102, 1102, 1102
1102, 1103, 416, 417, 331, 331, 420, 421, 115, 116, 117, 118, 470, 1024, 1024, 396, 397, 288, 331, 331, 384, 385, 416, 417, 418, 419, 420, 150, 264, 265, 266, 267, 268, 269, 243, 244, 245, 175, 176, 208, 209, 210, 211, 212, 213, 386, 368, 392, 393, 394, 395, 396, 397, 331, 331, 420, 421, 422, 1053, 1053, 425, 426, 427, 428, 429, 226, 227, 331, 433, 434, 435, 1106, 1102, 1102, 1102, 1102, 1102, 1102, 1102, 1102
1102, 1103, 448, 449, 331, 331, 452, 453, 470, 470, 331, 331, 331, 1024, 1024, 461, 462, 664, 331, 178, 179, 417, 448, 449, 450, 451, 452, 156, 270, 271, 272, 273, 274, 275, 261, 262, 263, 181, 182, 214, 215, 216, 217, 218, 219, 418, 374, 398, 399, 400, 401, 402, 403, 331, 451, 452, 453, 454, 1053, 1053, 331, 331, 331, 460, 461, 331, 331, 464, 465, 466, 467, 1106, 1102, 1102, 1102, 1102, 1102, 1102, 1102, 1102
1102, 1103, 480, 481, 1053, 1053, 1053, 1053, 486, 487, 331, 331, 331, 491, 492, 493, 494, 664, 178, 179, 211, 449, 480, 177, 177, 483, 484, 174, 175, 176, 177, 264, 265, 266, 267, 268, 208, 209, 210, 220, 221, 222, 223, 240, 241, 450, 392, 393, 394, 395, 396, 397, 360, 361, 331, 484, 485, 486, 433, 433, 331, 331, 331, 492, 493, 1026, 1026, 1026, 1026, 498, 499, 1106, 1102, 1102, 1102, 1102, 1102, 1102, 1102, 1102
1102, 1103, 64, 65, 1053, 1053, 1053, 1053, 70, 71, 331, 331, 74, 75, 76, 77, 78, 384, 210, 211, 480, 481, 457, 458, 177, 515, 516, 180, 181, 182, 183, 270, 271, 272, 273, 274, 214, 215, 216, 242, 243, 244, 245, 246, 247, 482, 398, 399, 400, 401, 402, 403, 356, 357, 358, 359, 360, 361, 519, 520, 201, 202, 523, 524, 525, 1026, 1026, 1026, 1026, 530, 531, 1106, 1102, 1102, 1102, 1102, 1102, 1102, 1102, 1102
1102, 1103, 96, 97, 98, 99, 100, 101, 102, 103, 331, 331, 106, 107, 108, 109, 110, 416, 331, 331, 512, 513, 489, 490, 331, 517, 518, 519, 520, 521, 522, 156, 157, 234, 235, 236, 220, 221, 222, 248, 249, 250, 251, 252, 253, 514, 512, 513, 368, 369, 370, 371, 362, 363, 364, 365, 366, 367, 519, 520, 233, 234, 523, 524, 525, 526, 527, 528, 529, 530, 531, 1106, 1105, 1102, 1102, 1102, 1102, 1102, 1102, 1102
1102, 1103, 128, 129, 130, 131, 132, 133, 134, 135, 331, 331, 138, 664, 664, 141, 142, 448, 1024, 1024, 451, 452, 489, 490, 195, 480, 481, 482, 483, 484, 485, 174, 175, 240, 241, 242, 242, 243, 244, 254, 255, 272, 273, 274, 275, 449, 450, 451, 374, 375, 388, 389, 356, 357, 358, 359, 360, 361, 462, 463, 331, 331, 466, 467, 463, 464, 465, 466, 467, 157, 147, 1106, 1105, 1102, 1102, 1102, 1102, 1102, 1102, 1102
1102, 1103, 160, 161, 162, 163, 164, 165, 166, 167, 331, 331, 170, 664, 664, 331, 331, 331, 1024, 1024, 483, 484, 485, 194, 195, 356, 357, 358, 359, 360, 361, 180, 181, 246, 247, 260, 248, 249, 250, 251, 252, 253, 373, 374, 375, 481, 482, 483, 392, 393, 394, 395, 362, 363, 364, 365, 366, 367, 494, 495, 331, 331, 498, 499, 495, 496, 497, 498, 499, 189, 179, 1106, 1105, 1102, 1102, 1102, 1102, 1102, 1102, 1102
1102, 1103, 192, 193, 194, 195, 196, 197, 198, 199, 1053, 1053, 1053, 664, 664, 331, 331, 331, 513, 514, 515, 516, 517, 364, 365, 388, 389, 390, 391, 392, 393, 394, 395, 264, 265, 266, 254, 255, 272, 273, 274, 275, 405, 406, 407, 513, 514, 515, 398, 399, 400, 401, 368, 369, 370, 371, 372, 373, 526, 527, 1026, 1026, 1026, 531, 527, 528, 529, 530, 531, 221, 211, 1106, 1105, 1102, 1102, 1102, 1102, 1102, 1102, 1102
1102, 1103, 224, 225, 226, 227, 228, 229, 230, 231, 1053, 1053, 1053, 235, 236, 331, 331, 239, 194, 364, 365, 483, 484, 396, 397, 420, 421, 422, 423, 424, 425, 426, 427, 270, 271, 272, 273, 274, 275, 434, 435, 436, 437, 438, 439, 483, 484, 485, 331, 331, 488, 489, 374, 375, 388, 389, 390, 391, 496, 497, 1026, 1026, 1026, 498, 499, 307, 308, 309, 310, 253, 243, 1106, 1102, 1102, 1102, 1102, 1102, 1102, 1102, 1102
1102, 1103, 256, 257, 258, 259, 260, 261, 262, 263, 264, 265, 266, 267, 268, 364, 365, 271, 226, 396, 397, 515, 516, 331, 331, 452, 453, 454, 455, 456, 457, 458, 459, 460, 461, 462, 463, 464, 465, 466, 467, 468, 469, 470, 471, 515, 516, 517, 1053, 1053, 520, 521, 392, 393, 394, 395, 396, 397, 528, 529, 530, 531, 529, 530, 531, 339, 340, 341, 342, 285, 275, 1106, 1102, 1102, 1102, 1102, 1102, 1102, 1102, 1102
1102, 1103, 288, 289, 290, 291, 292, 293, 294, 295, 296, 297, 298, 299, 331, 396, 397, 303, 304, 305, 306, 307, 179, 1024, 1024, 484, 485, 486, 487, 488, 489, 490, 491, 492, 493, 494, 495, 496, 497, 498, 499, 208, 209, 210, 211, 212, 213, 260, 1053, 1053, 356, 357, 398, 399, 400, 401, 402, 403, 364, 365, 366, 367, 368, 369, 370, 371, 372, 373, 374, 317, 307, 1106, 1105, 1102, 1102, 1102, 1102, 1102, 1102, 1102
1102, 1103, 320, 321, 322, 323, 324, 325, 326, 356, 357, 358, 359, 360, 361, 331, 334, 335, 664, 664, 338, 339, 211, 1024, 1024, 516, 517, 518, 356, 357, 358, 359, 360, 361, 525, 526, 527, 528, 529, 530, 531, 214, 215, 216, 217, 218, 219, 292, 293, 387, 388, 389, 390, 391, 331, 331, 394, 395, 396, 397, 398, 399, 400, 201, 202, 403, 404, 405, 406, 349, 339, 1106, 1105, 1102, 1102, 1102, 1102, 1102, 1102, 1102
1102, 1103, 352, 353, 354, 355, 356, 357, 358, 362, 363, 364, 365, 366, 367, 1053, 1053, 1053, 356, 357, 358, 359, 360, 361, 375, 375, 356, 357, 362, 363, 364, 365, 366, 367, 1053, 1053, 424, 425, 426, 427, 664, 220, 221, 222, 223, 240, 241, 331, 331, 331, 335, 421, 422, 423, 1026, 1026, 1026, 427, 428, 429, 430, 431, 432, 233, 234, 201, 202, 437, 438, 381, 371, 1106, 1105, 1102, 1102, 1102, 1102, 1102, 1102, 1102
1102, 1103, 384, 385, 386, 387, 388, 389, 390, 368, 369, 370, 371, 372, 373, 1053, 1053, 1053, 362, 363, 364, 365, 366, 356, 357, 358, 362, 363, 368, 369, 370, 371, 372, 373, 1053, 1053, 456, 457, 458, 459, 664, 242, 243, 244, 245, 246, 247, 361, 331, 331, 335, 453, 454, 455, 1026, 1026, 1026, 459, 460, 461, 462, 463, 464, 465, 466, 233, 234, 469, 470, 413, 403, 1106, 1105, 1102, 1102, 1102, 1102, 1102, 1102, 1102
1102, 1103, 416, 417, 418, 419, 420, 421, 422, 374, 375, 388, 389, 390, 391, 360, 356, 357, 358, 359, 360, 361, 372, 362, 363, 364, 368, 369, 374, 375, 388, 389, 390, 391, 1053, 1053, 488, 489, 490, 491, 664, 248, 249, 250, 251, 252, 253, 367, 389, 483, 484, 485, 486, 487, 488, 489, 490, 491, 492, 493, 494, 495, 496, 497, 498, 499, 500, 501, 502, 445, 435, 1106, 1102, 1102, 1102, 1102, 1102, 1102, 1102, 1102
1102, 1103, 448, 449, 450, 451, 452, 453, 454, 392, 393, 394, 395, 396, 397, 366, 362, 363, 364, 365, 366, 367, 390, 368, 369, 370, 374, 375, 392, 393, 394, 395, 396, 397, 1053, 1053, 520, 521, 522, 208, 209, 254, 255, 272, 273, 274, 275, 373, 421, 515, 516, 517, 518, 519, 520, 521, 522, 523, 524, 525, 526, 527, 528, 529, 530, 531, 532, 533, 534, 477, 24, 1106, 1102, 1102, 1102, 1102, 1102, 1102, 1102, 1102
1102, 1103, 480, 481, 482, 483, 484, 485, 486, 398, 399, 400, 401, 402, 403, 372, 368, 369, 370, 371, 372, 373, 396, 374, 208, 209, 210, 211, 212, 213, 400, 401, 402, 403, 1053, 1053, 491, 492, 493, 214, 215, 216, 217, 218, 219, 389, 390, 391, 453, 454, 455, 456, 457, 458, 459, 460, 461, 462, 463, 464, 465, 466, 467, 356, 357, 358, 359, 360, 361, 19, 20, 1106, 1102, 1102, 1102, 1102, 1102, 1102, 1102, 1102
1102, 1103, 512, 513, 514, 515, 516, 517, 518, 519, 520, 374, 375, 388, 389, 390, 374, 375, 388, 389, 390, 391, 402, 392, 214, 215, 216, 217, 218, 219, 402, 403, 375, 520, 1053, 1053, 523, 524, 525, 220, 221, 222, 223, 240, 241, 395, 396, 397, 485, 486, 487, 488, 489, 490, 491, 492, 493, 494, 495, 496, 497, 498, 499, 362, 363, 364, 365, 366, 367, 51, 52, 1106, 1102, 1102, 1102, 1102, 1102, 1102, 1102, 1102
1102, 1103, 64, 65, 66, 67, 68, 69, 70, 71, 72, 392, 393, 394, 395, 396, 392, 393, 394, 395, 396, 397, 375, 398, 220, 221, 222, 223, 240, 241, 375, 419, 420, 421, 1053, 1053, 424, 425, 426, 242, 243, 244, 245, 246, 247, 401, 1026, 1026, 1026, 518, 519, 520, 521, 522, 523, 524, 525, 356, 357, 358, 359, 360, 361, 368, 369, 370, 371, 372, 373, 83, 84, 1106, 1102, 1102, 1102, 1102, 1102, 1102, 1102, 1102
1102, 1103, 64, 65, 66, 67, 68, 69, 70, 71, 72, 398, 399, 400, 401, 402, 398, 399, 400, 401, 402, 403, 375, 375, 242, 243, 244, 245, 246, 247, 375, 177, 177, 453, 1053, 1053, 456, 457, 458, 248, 249, 250, 251, 252, 253, 465, 1026, 1026, 1026, 469, 470, 370, 371, 372, 427, 428, 429, 362, 363, 364, 365, 366, 367, 374, 375, 388, 389, 390, 391, 115, 116, 1106, 1102, 1102, 1102, 1102, 1102, 1102, 1102, 1102
1102, 1103, 96, 97, 98, 99, 100, 101, 102, 103, 104, 105, 106, 1053, 1053, 1053, 1053, 1053, 1053, 1053, 1053, 1053, 1053, 1053, 248, 249, 250, 251, 252, 253, 1053, 1053, 1053, 485, 486, 487, 488, 489, 490, 254, 255, 272, 273, 274, 275, 497, 498, 499, 500, 501, 502, 402, 403, 404, 459, 460, 461, 368, 369, 370, 371, 372, 373, 392, 393, 394, 395, 396, 397, 147, 148, 1106, 1102, 1102, 1102, 1102, 1102, 1102, 1102, 1102
1102, 1103, 128, 129, 130, 131, 132, 133, 134, 135, 136, 137, 138, 1053, 1053, 1053, 1053, 1053, 1053, 1053, 1053, 1053, 1053, 1053, 254, 255, 272, 273, 274, 275, 1053, 1053, 1053, 517, 518, 519, 520, 521, 522, 362, 363, 364, 365, 366, 367, 529, 530, 531, 532, 533, 534, 434, 435, 436, 396, 397, 398, 374, 375, 388, 389, 390, 391, 398, 399, 400, 401, 201, 202, 179, 180, 1106, 1102, 1102, 1102, 1102, 1102, 1102, 1102, 1102
1102, 1103, 160, 161, 162, 163, 164, 165, 166, 167, 168, 169, 170, 171, 172, 173, 174, 175, 176, 177, 178, 179, 423, 424, 425, 426, 427, 428, 429, 430, 431, 432, 433, 434, 449, 450, 451, 452, 453, 368, 369, 370, 371, 372, 373, 460, 461, 462, 463, 464, 465, 466, 467, 468, 428, 429, 430, 392, 393, 394, 395, 396, 397, 205, 206, 207, 208, 233, 234, 211, 212, 1106, 1102, 1102, 1102, 1102, 1102, 1102, 1102, 1102
1102, 1103, 192, 193, 194, 195, 196, 197, 198, 199, 210, 210, 210, 66, 67, 68, 69, 70, 71, 72, 73, 74, 75, 76, 77, 78, 79, 80, 81, 66, 67, 68, 69, 70, 71, 72, 73, 74, 75, 374, 375, 388, 389, 390, 391, 71, 72, 73, 74, 66, 67, 68, 69, 70, 71, 72, 73, 398, 399, 400, 401, 402, 403, 201, 202, 82, 83, 84, 85, 243, 244, 1106, 1102, 1102, 1102, 1102, 1102, 1102, 1102, 1102
1102, 1103, 224, 225, 226, 227, 228, 229, 230, 231, 210, 210, 210, 98, 99, 100, 101, 102, 103, 104, 105, 106, 107, 108, 109, 110, 111, 112, 113, 98, 99, 100, 101, 102, 103, 104, 105, 106, 107, 392, 393, 394, 395, 396, 397, 103, 104, 105, 106, 98, 99, 100, 101, 102, 103, 104, 105, 106, 107, 108, 109, 110, 111, 233, 234, 114, 115, 116, 117, 275, 276, 1106, 1102, 1102, 1102, 1102, 1102, 1102, 1102, 1102
1102, 1103, 256, 257, 258, 259, 260, 261, 262, 263, 264, 265, 266, 130, 131, 132, 133, 134, 135, 136, 137, 138, 139, 140, 141, 142, 143, 144, 145, 130, 131, 132, 133, 134, 135, 136, 137, 138, 139, 398, 399, 400, 401, 402, 403, 135, 136, 137, 138, 130, 131, 132, 133, 134, 135, 136, 137, 138, 139, 140, 141, 142, 143, 144, 145, 146, 147, 148, 149, 307, 308, 1106, 1102, 1102, 1102, 1102, 1102, 1102, 1102, 1102
1102, 1103, 288, 289, 290, 291, 292, 293, 294, 295, 296, 297, 298, 162, 163, 164, 165, 166, 167, 168, 169, 170, 171, 172, 173, 174, 175, 176, 177, 162, 163, 164, 165, 166, 167, 168, 169, 170, 171, 172, 162, 163, 164, 165, 166, 167, 168, 169, 170, 162, 163, 164, 165, 166, 167, 168, 169, 170, 171, 172, 173, 174, 175, 176, 177, 178, 179, 180, 181, 339, 340, 1106, 1102, 1102, 1102, 1102, 1102, 1102, 1102, 1102
1102, 1103, 320, 321, 322, 323, 324, 325, 326, 327, 328, 329, 330, 194, 195, 196, 197, 198, 199, 200, 201, 202, 203, 204, 205, 206, 207, 208, 209, 194, 195, 196, 197, 198, 199, 200, 201, 202, 203, 204, 194, 195, 196, 197, 198, 199, 200, 201, 202, 194, 195, 196, 197, 198, 199, 200, 201, 202, 203, 204, 205, 206, 207, 208, 209, 210, 211, 212, 213, 371, 372, 1106, 1102, 1102, 1102, 1102, 1102, 1102, 1102, 1102
1102, 1103, 352, 353, 354, 355, 356, 357, 358, 208, 209, 210, 211, 212, 213, 228, 229, 230, 231, 232, 233, 234, 235, 236, 237, 238, 239, 240, 241, 226, 227, 228, 229, 230, 231, 232, 233, 234, 235, 236, 226, 227, 228, 229, 230, 231, 232, 233, 234, 226, 227, 228, 229, 230, 231, 232, 233, 234, 235, 236, 237, 238, 239, 240, 241, 242, 243, 244, 245, 403, 404, 1106, 1102, 1102, 1102, 1102, 1102, 1102, 1102, 1102
1102, 1103, 384, 385, 386, 387, 388, 389, 390, 214, 215, 216, 217, 218, 219, 397, 398, 1053, 1053, 1053, 1053, 1053, 1053, 1053, 1053, 1053, 1053, 1053, 1053, 1053, 1053, 1053, 1053, 1053, 1053, 1053, 1053, 1053, 1053, 1053, 1053, 1053, 1053, 1053, 1053, 1053, 1053, 1053, 1053, 1053, 1053, 1053, 1053, 1053, 1053, 1053, 1053, 1053, 1053, 1053, 1053, 1053, 1053, 1053, 1053, 1053, 1053, 1053, 1053, 435, 436, 1106, 1102, 1102, 1102, 1102, 1102, 1102, 1102, 1102
1102, 1103, 416, 417, 418, 419, 420, 421, 422, 220, 221, 222, 223, 240, 241, 429, 430, 1053, 1053, 1053, 1053, 1053, 1053, 1053, 1053, 1053, 1053, 1053, 1053, 1053, 1053, 1053, 1053, 1053, 1053, 1053, 1053, 1053, 1053, 1053, 1053, 1053, 1053, 1053, 1053, 1053, 1053, 1053, 1053, 1053, 1053, 1053, 1053, 1053, 1053, 1053, 1053, 1053, 1053, 1053, 1053, 1053, 1053, 1053, 1053, 1053, 1053, 1053, 1053, 467, 468, 1106, 1102, 1102, 1102, 1102, 1102, 1102, 1102, 1102
1102, 1103, 448, 449, 450, 451, 452, 453, 454, 242, 243, 244, 245, 246, 247, 461, 462, 463, 464, 465, 466, 467, 417, 418, 419, 420, 421, 422, 423, 424, 425, 426, 427, 428, 429, 430, 431, 432, 433, 434, 435, 436, 208, 208, 208, 208, 356, 357, 358, 359, 360, 361, 362, 363, 364, 365, 366, 367, 368, 369, 370, 371, 372, 373, 374, 375, 208, 208, 208, 208, 208, 1106, 1102, 1102, 1102, 1102, 1102, 1102, 1102, 1102
1102, 1103, 356, 357, 358, 359, 360, 361, 362, 248, 249, 250, 251, 252, 253, 369, 370, 356, 357, 358, 359, 360, 361, 362, 363, 364, 365, 366, 367, 368, 369, 370, 371, 372, 373, 374, 375, 357, 358, 359, 360, 361, 362, 363, 364, 365, 388, 389, 390, 391, 392, 393, 394, 395, 396, 397, 398, 399, 400, 401, 402, 403, 404, 405, 406, 407, 372, 373, 374, 375, 208, 1106, 1102, 1102, 1102, 1102, 1102, 1102, 1102, 1102
1102, 1103, 356, 357, 358, 359, 360, 361, 362, 254, 255, 272, 273, 274, 275, 369, 370, 388, 389, 390, 391, 392, 393, 394, 395, 396, 397, 398, 399, 208, 209, 210, 211, 212, 213, 406, 407, 370, 356, 357, 358, 359, 360, 361, 362, 363, 420, 421, 422, 423, 424, 425, 426, 427, 428, 429, 430, 431, 432, 433, 434, 435, 436, 437, 438, 439, 404, 405, 406, 407, 208, 1106, 1102, 1102, 1102, 1102, 1102, 1102, 1102, 1102
1102, 1103, 388, 389, 390, 391, 392, 393, 394, 395, 396, 397, 398, 399, 400, 401, 402, 420, 421, 422, 423, 424, 425, 426, 427, 428, 429, 430, 431, 214, 215, 216, 217, 218, 219, 438, 439, 402, 388, 389, 390, 391, 392, 393, 394, 395, 452, 453, 454, 455, 456, 457, 458, 459, 460, 461, 462, 463, 464, 465, 466, 467, 468, 469, 470, 471, 436, 437, 890, 890, 891, 1106, 1102, 1102, 1102, 1102, 1102, 1102, 1102, 1102
1102, 1103, 420, 421, 422, 423, 424, 425, 426, 427, 428, 429, 430, 431, 432, 433, 434, 452, 453, 454, 455, 456, 457, 458, 459, 460, 461, 462, 463, 220, 221, 222, 223, 240, 241, 470, 471, 434, 420, 421, 422, 423, 424, 425, 426, 427, 484, 485, 486, 487, 488, 489, 490, 491, 492, 493, 494, 495, 496, 497, 498, 499, 500, 501, 502, 503, 468, 469, 922, 922, 923, 1106, 1102, 1102, 1102, 1102, 1102, 1102, 1102, 1102
1102, 1103, 452, 453, 454, 455, 456, 457, 458, 459, 460, 461, 462, 463, 464, 465, 466, 484, 485, 486, 487, 488, 489, 490, 491, 492, 493, 494, 495, 242, 243, 244, 245, 246, 247, 502, 503, 466, 452, 453, 454, 455, 456, 457, 458, 459, 516, 517, 518, 519, 520, 521, 522, 523, 524, 525, 526, 527, 528, 529, 305, 306, 532, 533, 534, 535, 500, 501, 502, 890, 891, 1106, 1102, 1102, 1102, 1102, 1102, 1102, 1102, 1102
1102, 1103, 484, 485, 486, 487, 488, 489, 490, 491, 492, 493, 494, 495, 496, 497, 498, 516, 517, 518, 519, 520, 521, 522, 523, 524, 525, 526, 527, 248, 249, 250, 251, 252, 253, 534, 535, 498, 484, 485, 486, 487, 488, 489, 490, 491, 492, 493, 494, 495, 496, 497, 498, 499, 500, 501, 502, 503, 305, 306, 337, 890, 891, 529, 890, 891, 202, 533, 534, 922, 923, 1106, 1102, 1102, 1102, 1102, 1102, 1102, 1102, 1102
1102, 1103, 516, 517, 518, 519, 520, 521, 522, 523, 524, 525, 526, 527, 528, 529, 530, 531, 532, 533, 534, 535, 528, 516, 517, 518, 519, 520, 521, 254, 255, 272, 273, 274, 275, 528, 529, 530, 516, 517, 518, 519, 520, 521, 522, 523, 524, 525, 526, 527, 528, 529, 530, 531, 532, 533, 534, 535, 337, 338, 238, 922, 923, 238, 922, 923, 234, 238, 238, 233, 234, 1106, 1102, 1102, 1102, 1102, 1102, 1102, 1102, 1102
1102, 1057, 1059, 1059, 1059, 1059, 1059, 1059, 1059, 1059, 1059, 1059, 1059, 1059, 1059, 1059, 1059, 1059, 1059, 1059, 1059, 1059, 1059, 1059, 1059, 1059, 1059, 1059, 1059, 1059, 1059, 1059, 1059, 1059, 1059, 1059, 1059, 1059, 1059, 1059, 1059, 1059, 1059, 1059, 1059, 1059, 1059, 1059, 1059, 1059, 1059, 1059, 1059, 1059, 1059, 1059, 1059, 1059, 1059, 1059, 1059, 1059, 1059, 1059, 1059, 1059, 1059, 1059, 1059, 1059, 1059, 1068, 1102, 1102, 1102, 1102, 1102, 1102, 1102, 1102
1102, 1102, 1102, 1102, 1102, 1102, 1102, 1102, 1102, 1102, 1102, 1102, 1102, 1102, 1102, 1102, 1102, 1102, 1102, 1102, 1102, 1102, 1102, 1102, 1102, 1102, 1102, 1102, 1102, 1136, 1136, 1136, 1136, 1136, 1136, 1136, 1136, 1136, 1136, 1136, 1136, 1136, 1136, 1136, 1136, 1136, 1136, 1136, 1136, 1136, 1136, 1136, 1136, 1136, 1136, 1136, 1136, 1136, 1136, 1136, 1136, 1136, 1136, 1136, 1136, 1136, 1136, 1136, 1136, 1102, 1102, 1102, 1102, 1102, 1102, 1102, 1102, 1102, 1102, 1102
1102, 1102, 1102, 1136, 1136, 1136, 1136, 1136, 1136, 1136, 1136, 1136, 1136, 1136, 1136, 1136, 1136, 1136, 1136, 1136, 1136, 1136, 1136, 1136, 1136, 1136, 1136, 1136, 1136, 1136, 1136, 1136, 1136, 1136, 1136, 1136, 1136, 1136, 1136, 1136, 1136, 1136, 1136, 1136, 1136, 1136, 1136, 1136, 1136, 1136, 1136, 1136, 1136, 1136, 1136, 1136, 1136, 1136, 1136, 1136, 1136, 1136, 1136, 1136, 1136, 1136, 1136, 1136, 1136, 1102, 1102, 1102, 1102, 1102, 1102, 1102, 1102, 1102, 1102, 1102
1102, 1102, 1102, 1136, 1136, 1136, 1136, 1136, 1136, 1136, 1136, 1136, 1136, 1136, 1136, 1136, 1136, 1136, 1136, 1136, 1136, 1136, 1136, 1136, 1136, 1136, 1136, 1136, 1136, 1136, 1136, 1136, 1136, 1136, 1136, 1136, 1136, 1136, 1136, 1136, 1136, 1136, 1136, 1136, 1136, 1136, 1136, 1136, 1136, 1136, 1136, 1136, 1136, 1136, 1136, 1136, 1136, 1136, 1136, 1136, 1136, 1136, 1136, 1136, 1136, 1136, 1136, 1136, 1136, 1102, 1102, 1102, 1102, 1102, 1102, 1102, 1102, 1102, 1102, 1102
