2559, 2559, 2559, 2559, 2559, 2559, 2559, 2559, 2559, 2559, 2559, 2559, 2047, 2047, 2047, 2047, 2047, 2047, 2047, 2047, 2047, 2047, 2047, 2047, 2047, 2047, 2047, 2047, 2047, 2047, 2047, 2047, 2047, 2047, 2047, 2047, 2047, 2047, 2047, 2047, 2047, 2047, 2047, 2047, 2047, 2047, 2047, 2047, 2047, 2047, 2047, 2047, 2047, 2047, 2047, 2047, 2047, 2047, 2047, 2047, 2047, 2047, 2047, 2047, 2047, 2047, 2047, 2047, 2559, 2559, 2559, 2559, 2559, 2559, 2559, 2559, 2559, 2559, 2559, 2047
2559, 2559, 2559, 2559, 2559, 2559, 2559, 2559, 2559, 2559, 2559, 2559, 2559, 2559, 2559, 2559, 2559, 2559, 2559, 2559, 2559, 2559, 2559, 2559, 2559, 2559, 2559, 2559, 2559, 2559, 2559, 2559, 2559, 2559, 2559, 2559, 2559, 2559, 2559, 2559, 2559, 2559, 2559, 2559, 2559, 2559, 2559, 2559, 2559, 2559, 2559, 2559, 2559, 2559, 2559, 2559, 2559, 2559, 2559, 2559, 2559, 2559, 2559, 2559, 2559, 2559, 2559, 2559, 2559, 2559, 2559, 2559, 2559, 2559, 2559, 2559, 2559, 2559, 2559, 2047
2559, 2559, 2559, 2559, 2559, 2559, 2559, 2559, 2559, 2559, 2559, 2559, 2559, 2559, 2559, 2559, 2559, 2559, 2559, 2559, 2559, 2559, 2559, 2559, 2559, 2559, 2559, 2559, 2559, 2559, 2559, 2559, 2559, 2559, 2559, 2559, 2559, 2559, 2559, 2559, 2559, 2559, 2559, 2559, 2559, 2559, 2559, 2559, 2559, 2559, 2559, 2559, 2559, 2559, 2559, 2559, 2559, 2559, 2559, 2559, 2559, 2559, 2559, 2559, 2559, 2559, 2559, 2559, 2559, 2559, 2559, 2559, 2559, 2559, 2559, 2559, 2559, 2559, 2559, 2047
2559, 2559, 2559, 2559, 2559, 2559, 2559, 2559, 2559, 2559, 2559, 2559, 2559, 2559, 2559, 2559, 2559, 2559, 2559, 2559, 2559, 2559, 2559, 2559, 2559, 2559, 2559, 2559, 2559, 2559, 2559, 2559, 2559, 2559, 2559, 2559, 2559, 2559, 2559, 2559, 2559, 2559, 2559, 2559, 2559, 2559, 2559, 2559, 2559, 2559, 2559, 2559, 2559, 2559, 2559, 2559, 2559, 2559, 2559, 2559, 2559, 2559, 2559, 2559, 2559, 2559, 2559, 2559, 2559, 2559, 2559, 2559, 2559, 2559, 2559, 2559, 2559, 2559, 2559, 2047
2559, 1356, 1357, 1358, 1359, 1360, 1361, 2559, 2559, 2559, 2559, 2559, 2559, 2559, 2559, 2559, 2559, 2559, 2559, 2559, 2559, 2559, 2559, 2559, 2559, 2559, 2559, 2559, 2559, 2559, 2559, 2559, 2559, 2559, 2559, 2559, 2559, 2559, 2559, 2559, 2559, 2559, 2559, 2559, 2559, 2559, 2559, 2559, 2559, 2559, 2559, 2559, 2559, 2559, 2559, 2559, 2559, 2559, 2559, 2559, 2559, 2559, 2559, 2559, 2559, 2559, 2559, 2559, 2559, 2559, 2559, 2559, 2559, 2559, 2559, 2559, 2559, 2559, 2559, 2047
2559, 1388, 1389, 1390, 1391, 1392, 1393, 2559, 2559, 2559, 2559, 2559, 2559, 2559, 2559, 2559, 2559, 2559, 2559, 2559, 2559, 2559, 2559, 2559, 2559, 2559, 2559, 2559, 2559, 2559, 2559, 2559, 2559, 2559, 2559, 2559, 2559, 2559, 2559, 2559, 2559, 2559, 2559, 2559, 2559, 2559, 2559, 2559, 2559, 2559, 2559, 2559, 2559, 2559, 2559, 2559, 2559, 2559, 2559, 2559, 2559, 2559, 2559, 2559, 2559, 2559, 2559, 2559, 2559, 2559, 2559, 2559, 2559, 2559, 2559, 2559, 2559, 2559, 2559, 2047
2559, 1420, 1421, 1422, 1423, 1424, 1425, 2559, 2559, 2559, 2559, 2559, 2559, 2559, 2559, 2559, 2559, 2559, 2559, 2559, 2559, 2559, 2559, 2559, 2559, 2559, 2559, 2559, 2559, 2559, 2559, 2559, 2559, 2559, 2559, 2559, 2559, 2559, 2559, 2559, 2559, 2559, 2559, 2559, 2559, 2559, 2559, 2559, 2559, 2559, 2559, 2559, 2559, 2559, 2559, 2559, 2559, 2559, 2559, 2559, 2559, 2559, 2559, 2559, 2559, 2559, 2559, 2559, 2559, 2559, 2559, 2559, 2559, 2559, 2559, 2559, 2559, 2559, 2559, 2047
2559, 1452, 1453, 1454, 1455, 1456, 1457, 2559, 2559, 2559, 2559, 2559, 2559, 2559, 2559, 2559, 2559, 2047, 5124, 5125, 4804, 4805, 4806, 4807, 4808, 4809, 4810, 4811, 4812, 4813, 4814, 4815, 4816, 4817, 4818, 4819, 4820, 4821, 4822, 4823, 4824, 4825, 4826, 4827, 4828, 4829, 4830, 4831, 4832, 4833, 4834, 4835, 4836, 4837, 4838, 4839, 4840, 4841, 4842, 4843, 5126, 5127, 2559, 2559, 2559, 2559, 2559, 2559, 2559, 2559, 2559, 2559, 2559, 2559, 2559, 2559, 2559, 2559, 2559, 2047
2559, 1484, 1485, 1486, 1487, 1488, 1489, 2559, 2559, 2559, 2559, 2559, 2559, 2559, 2559, 2559, 2559, 2047, 5204, 5205, 4884, 4885, 4886, 4887, 4888, 4889, 4890, 4891, 4892, 4893, 4894, 4895, 4896, 4897, 4898, 4899, 4900, 4901, 4902, 4903, 4904, 4905, 4906, 4907, 4908, 4909, 4910, 4911, 4912, 4913, 4914, 4915, 4916, 4917, 4918, 4919, 4920, 4921, 4922, 4923, 5206, 5207, 2559, 2559, 2559, 2559, 2559, 2559, 2559, 2559, 2559, 2559, 2559, 2559, 2559, 2559, 2559, 2559, 2559, 2047
2559, 1516, 1517, 1518, 1519, 1520, 1521, 2559, 2559, 2559, 2559, 2559, 2559, 2559, 2559, 2559, 2559, 2047, 960, 961, 0, 1, 2, 3, 4, 5, 6, 7, 8, 9, 10, 11, 12, 13, 14, 15, 16, 17, 18, 19, 20, 21, 22, 23, 24, 25, 26, 27, 28, 29, 30, 31, 32, 33, 34, 35, 36, 37, 38, 39, 990, 991, 2559, 2559, 2559, 2559, 2559, 2559, 2559, 2559, 2559, 2559, 2559, 2559, 2559, 2559, 2559, 2559, 2559, 2047
2559, 1548, 1549, 1550, 1551, 1552, 1553, 2559, 2559, 2559, 2559, 2559, 2559, 2559, 2559, 2559, 2559, 2047, 1088, 1089, 80, 81, 82, 83, 84, 85, 86, 87, 88, 89, 90, 91, 92, 93, 94, 95, 96, 97, 98, 99, 100, 101, 102, 103, 104, 105, 106, 107, 108, 109, 110, 111, 112, 113, 114, 115, 116, 117, 118, 119, 1092, 1093, 2559, 2559, 2559, 2559, 2559, 2559, 2559, 2559, 2559, 2559, 2559, 2559, 2559, 2559, 2559, 2559, 2559, 2047
2559, 2559, 2559, 2559, 2559, 2559, 2559, 2559, 2559, 2559, 2559, 2559, 2559, 2559, 2559, 2559, 2559, 2559, 1120, 1121, 160, 161, 162, 163, 164, 165, 166, 167, 168, 169, 170, 171, 172, 173, 174, 175, 176, 177, 178, 179, 180, 181, 182, 183, 184, 185, 186, 187, 188, 189, 190, 191, 192, 193, 194, 195, 196, 197, 198, 199, 1124, 1125, 2559, 2559, 2559, 2559, 2559, 2559, 2559, 2559, 2559, 2559, 2559, 2559, 2559, 2559, 2559, 2559, 2559, 2047
2559, 2559, 2559, 2559, 2559, 2559, 2559, 2559, 2559, 2559, 2559, 2559, 2559, 2559, 2559, 2559, 2559, 2559, 1152, 1153, 240, 241, 242, 243, 244, 245, 246, 247, 248, 249, 250, 251, 252, 253, 254, 255, 256, 257, 258, 259, 260, 261, 262, 263, 264, 265, 266, 267, 268, 269, 270, 271, 272, 273, 274, 275, 276, 277, 278, 279, 1156, 1157, 2559, 2559, 2559, 2559, 2559, 2559, 2559, 2559, 2559, 2559, 2559, 2559, 2559, 2559, 2559, 2559, 2559, 2047
2559, 2559, 2559, 2559, 2559, 2559, 2559, 2559, 2559, 2559, 2559, 2559, 2559, 2559, 2559, 2559, 2559, 2559, 1184, 1185, 320, 321, 322, 323, 324, 325, 326, 327, 328, 329, 330, 331, 332, 333, 334, 335, 336, 337, 338, 339, 340, 341, 342, 343, 344, 345, 346, 347, 348, 349, 350, 351, 352, 353, 354, 355, 356, 357, 358, 359, 1188, 1189, 2559, 2559, 2559, 2559, 2559, 2559, 2559, 2559, 2559, 2559, 2559, 2559, 2559, 2559, 2559, 2559, 2559, 2559
2559, 2559, 2559, 2559, 2559, 2559, 2559, 2559, 2559, 2559, 2559, 2559, 2559, 2559, 2559, 2559, 2559, 2559, 1216, 1217, 400, 401, 402, 403, 404, 405, 406, 407, 408, 409, 410, 411, 412, 413, 414, 415, 416, 417, 418, 419, 420, 421, 422, 423, 424, 425, 426, 427, 428, 429, 430, 431, 432, 433, 434, 435, 436, 437, 438, 439, 1220, 1221, 2559, 2559, 2559, 2559, 2559, 2559, 2559, 1350, 1351, 1352, 1353, 1354, 1355, 2559, 2559, 2559, 2559, 2559
1362, 1363, 1364, 2559, 2559, 2559, 2559, 2559, 2559, 2559, 2559, 2559, 2559, 2559, 2559, 2559, 2559, 2559, 1248, 1249, 480, 481, 482, 483, 484, 485, 486, 487, 488, 489, 490, 491, 492, 493, 494, 495, 496, 497, 498, 499, 500, 501, 502, 503, 504, 505, 506, 507, 508, 509, 510, 511, 512, 513, 514, 515, 516, 517, 518, 519, 1252, 1253, 2559, 2559, 2559, 2559, 2559, 2559, 2559, 1382, 1383, 1384, 1385, 1386, 1387, 2559, 2559, 2559, 2559, 2559
1394, 1395, 1396, 2047, 2047, 2047, 2047, 2047, 2047, 2559, 2559, 2559, 2559, 2559, 2559, 2559, 2559, 2559, 1280, 1281, 560, 561, 562, 563, 564, 565, 566, 567, 568, 569, 570, 571, 572, 573, 574, 575, 576, 577, 578, 579, 580, 581, 582, 583, 584, 585, 586, 587, 588, 589, 590, 591, 592, 593, 594, 595, 596, 597, 598, 599, 1284, 1285, 2559, 2559, 2559, 2559, 2559, 2559, 2559, 1414, 1415, 1416, 1417, 1418, 1419, 2559, 2559, 2559, 2559, 2559
1426, 1427, 1428, 2047, 2047, 2047, 2047, 2047, 2047, 2047, 2559, 2559, 1461, 1462, 1463, 1464, 2559, 2559, 1088, 1089, 640, 641, 642, 643, 644, 645, 646, 647, 648, 649, 650, 651, 652, 653, 654, 655, 656, 657, 658, 659, 660, 661, 662, 663, 664, 665, 666, 667, 668, 669, 670, 671, 672, 673, 674, 675, 676, 677, 678, 679, 1316, 1317, 2559, 2559, 2559, 2559, 2559, 2559, 2559, 1446, 1447, 1448, 1449, 1450, 1451, 2559, 2559, 2559, 2559, 2559
2047, 2047, 2047, 2047, 2047, 2047, 2047, 2047, 2047, 2047, 2559, 2559, 1493, 1494, 1495, 1496, 2559, 2559, 1120, 1121, 720, 721, 722, 723, 724, 725, 726, 727, 728, 729, 730, 731, 732, 733, 734, 735, 736, 737, 738, 739, 740, 741, 742, 743, 744, 745, 746, 747, 748, 749, 750, 751, 752, 753, 754, 755, 756, 757, 758, 759, 1092, 1093, 2559, 2559, 2559, 2559, 2559, 2559, 2559, 1478, 1479, 1480, 1481, 1482, 1483, 2559, 2559, 2559, 2559, 2559
2047, 2047, 2047, 2047, 2047, 2047, 2047, 2047, 2047, 2047, 2559, 2559, 1525, 1526, 1527, 1528, 2559, 2559, 1152, 1153, 800, 801, 802, 803, 804, 805, 806, 807, 808, 809, 810, 811, 812, 813, 814, 815, 816, 817, 818, 819, 820, 821, 822, 823, 824, 825, 826, 827, 828, 829, 830, 831, 832, 833, 834, 835, 836, 837, 838, 839, 1124, 1125, 2559, 2559, 2559, 2559, 2559, 2559, 2559, 1510, 1511, 1512, 1513, 1514, 1515, 2559, 2559, 2559, 2559, 2559
2047, 2047, 2047, 2047, 2047, 2559, 2559, 2559, 2559, 2559, 2559, 2559, 2559, 2559, 2559, 2559, 2559, 2559, 1184, 1185, 880, 881, 882, 883, 884, 885, 886, 887, 888, 889, 890, 891, 892, 893, 894, 895, 896, 897, 898, 899, 900, 901, 902, 903, 904, 905, 906, 907, 908, 909, 910, 911, 912, 913, 914, 915, 916, 917, 918, 919, 1156, 1157, 2559, 2559, 1344, 1345, 1346, 1347, 1348, 1542, 1543, 1544, 1545, 1546, 1547, 2559, 2559, 2559, 2559, 2559
2047, 2047, 2559, 2559, 1344, 1345, 1346, 1347, 1348, 1349, 2559, 2559, 2559, 2559, 2559, 2559, 2559, 2559, 1216, 1217, 960, 961, 962, 963, 964, 965, 966, 967, 968, 969, 970, 971, 972, 973, 974, 975, 976, 977, 978, 979, 980, 981, 982, 983, 984, 985, 986, 987, 988, 989, 990, 991, 992, 993, 994, 995, 996, 997, 998, 999, 1188, 1189, 2559, 2559, 1376, 1377, 1378, 1379, 1380, 1381, 2559, 2047, 2047, 2559, 2559, 2559, 2559, 2559, 2559, 2559
2047, 2047, 2559, 2559, 1376, 1377, 1378, 1379, 1380, 1381, 2559, 2559, 2559, 2559, 2559, 2559, 2559, 2559, 1248, 1249, 1040, 1041, 1042, 1043, 1044, 1045, 1046, 1047, 1048, 1049, 1050, 1051, 1052, 1053, 1054, 1055, 1056, 1057, 1058, 1059, 1060, 1061, 1062, 1063, 1064, 1065, 1066, 1067, 1068, 1069, 1070, 1071, 1072, 1073, 1074, 1075, 1076, 1077, 1078, 1079, 1220, 1221, 2559, 2559, 1408, 1409, 1410, 1411, 1412, 1413, 2559, 2047, 2047, 2559, 2559, 2559, 2559, 2559, 2559, 2559
2047, 2047, 2559, 2559, 1408, 1409, 1410, 1411, 1412, 1413, 2559, 2559, 2559, 2559, 2559, 2559, 2559, 2559, 1088, 1089, 1120, 1121, 1122, 1123, 1124, 1125, 1126, 1127, 1128, 1129, 1130, 1131, 1132, 1133, 1134, 1135, 1136, 1137, 1138, 1139, 1140, 1141, 1142, 1143, 1144, 1145, 1146, 1147, 1148, 1149, 1150, 1151, 1152, 1153, 1154, 1155, 1156, 1157, 1158, 1159, 1252, 1253, 2559, 2559, 1440, 1441, 1442, 1443, 1444, 1445, 2559, 2047, 2047, 2559, 2559, 2559, 2559, 2559, 2559, 2559
2047, 2047, 2559, 2559, 1440, 1441, 1442, 1443, 1444, 1445, 2559, 2559, 2559, 2559, 2559, 2559, 2559, 2559, 1120, 1121, 1200, 1201, 1202, 1203, 1204, 1205, 1206, 1207, 1208, 1209, 1210, 1211, 1212, 1213, 1214, 1215, 1216, 1217, 1218, 1219, 1220, 1221, 1222, 1223, 1224, 1225, 1226, 1227, 1228, 1229, 1230, 1231, 1232, 1233, 1234, 1235, 1236, 1237, 1238, 1239, 1284, 1285, 2559, 2559, 1472, 1473, 1474, 1475, 1476, 1477, 2559, 2559, 2559, 2559, 2559, 2559, 2559, 2559, 2559, 2559
2047, 2047, 2559, 2559, 1472, 1473, 1474, 1475, 1476, 1477, 2559, 2559, 2559, 2559, 2559, 2559, 2559, 2559, 1152, 1153, 1280, 1281, 1282, 1283, 1284, 1285, 1286, 1287, 1288, 1289, 1290, 1291, 1292, 1293, 1294, 1295, 1296, 1297, 1298, 1299, 1300, 1301, 1302, 1303, 1304, 1305, 1306, 1307, 1308, 1309, 1310, 1311, 1312, 1313, 1314, 1315, 1316, 1317, 1318, 1319, 1316, 1317, 2559, 2559, 1504, 1505, 1506, 1507, 1508, 1509, 2559, 2559, 2559, 2559, 2559, 2559, 2559, 2559, 2559, 2559
2047, 2047, 2559, 2559, 1504, 1505, 1506, 1507, 1508, 1509, 2559, 2559, 2559, 2559, 2559, 2559, 2559, 2559, 1184, 1185, 1360, 1361, 1362, 1363, 1364, 1365, 1366, 1367, 1368, 1369, 1370, 1371, 1372, 1373, 1374, 1375, 1376, 1377, 1378, 1379, 1380, 1381, 1382, 1383, 1384, 1385, 1386, 1387, 1388, 1389, 1390, 1391, 1392, 1393, 1394, 1395, 1396, 1397, 1398, 1399, 1092, 1093, 2559, 2559, 1536, 1537, 1538, 1539, 1540, 1541, 2559, 2559, 2559, 2559, 2559, 2559, 2559, 2559, 2559, 2559
2047, 2047, 2559, 2559, 1536, 1537, 1538, 1539, 1540, 1541, 2559, 2559, 2559, 2559, 2559, 2559, 2559, 2559, 1216, 1217, 1440, 1441, 1442, 1443, 1444, 1445, 1446, 1447, 1448, 1449, 1450, 1451, 1452, 1453, 1454, 1455, 1456, 1457, 1458, 1459, 1460, 1461, 1462, 1463, 1464, 1465, 1466, 1467, 1468, 1469, 1470, 1471, 1472, 1473, 1474, 1475, 1476, 1477, 1478, 1479, 1124, 1125, 2559, 2559, 2559, 2559, 2559, 2559, 2559, 2559, 2559, 2559, 2559, 2559, 2559, 2559, 2559, 2559, 2559, 2559
2047, 2047, 2559, 2559, 2559, 2559, 2559, 2559, 2559, 2559, 2559, 2559, 2559, 2559, 2559, 2559, 2559, 2559, 1248, 1249, 1520, 1521, 1522, 1523, 1524, 1525, 1526, 1527, 1528, 1529, 1530, 1531, 1532, 1533, 1534, 1535, 1536, 1537, 1538, 1539, 1540, 1541, 1542, 1543, 1544, 1545, 1546, 1547, 1548, 1549, 1550, 1551, 1552, 1553, 1554, 1555, 1556, 1557, 1558, 1559, 1156, 1157, 2559, 2559, 2559, 2559, 2559, 2559, 2559, 2559, 2559, 2559, 2559, 2559, 2559, 2559, 2559, 2559, 1574, 1575
2047, 2047, 2559, 2559, 2559, 2559, 2559, 2559, 2559, 2559, 2559, 2559, 2559, 2559, 2559, 2559, 2559, 2559, 1280, 1281, 1600, 1601, 1602, 1603, 1604, 1605, 1606, 1607, 1608, 1609, 1610, 1611, 1612, 1613, 1614, 1615, 1616, 1617, 1618, 1619, 1620, 1621, 1622, 1623, 1624, 1625, 1626, 1627, 1628, 1629, 1630, 1631, 1632, 1633, 1634, 1635, 1636, 1637, 1638, 1639, 1188, 1189, 2559, 2559, 2559, 2559, 2559, 2559, 2559, 2559, 1362, 1363, 1364, 2559, 2559, 2559, 2559, 2559, 1606, 1607
2047, 2047, 2559, 2559, 2559, 2559, 2559, 2559, 2559, 2559, 2559, 2559, 2559, 2559, 2559, 2559, 2559, 2559, 1088, 1089, 1680, 1681, 1682, 1683, 1684, 1685, 1686, 1687, 1688, 1689, 1690, 1691, 1692, 1693, 1694, 1695, 1696, 1697, 1698, 1699, 1700, 1701, 1702, 1703, 1704, 1705, 1706, 1707, 1708, 1709, 1710, 1711, 1712, 1713, 1714, 1715, 1716, 1717, 1718, 1719, 1220, 1221, 2559, 2559, 2559, 2559, 2559, 2559, 2559, 2559, 1394, 1395, 1396, 2559, 2559, 2559, 1574, 1575, 1574, 1575
2047, 2047, 2559, 2559, 2559, 2559, 2559, 2559, 2559, 2559, 2559, 2559, 2559, 2559, 2559, 2559, 2559, 2559, 1120, 1121, 1760, 1761, 1762, 1763, 1764, 1765, 1766, 1767, 1768, 1769, 1770, 1771, 1772, 1773, 1774, 1775, 1776, 1777, 1778, 1779, 1780, 1781, 1782, 1783, 1784, 1785, 1786, 1787, 1788, 1789, 1790, 1791, 1792, 1793, 1794, 1795, 1796, 1797, 1798, 1799, 1252, 1253, 2559, 2559, 2559, 2559, 2559, 2559, 2559, 2559, 1426, 1427, 1428, 2559, 2559, 2559, 1606, 1607, 1606, 1607
2047, 2047, 2559, 2559, 2559, 2559, 2559, 2559, 2559, 2559, 2559, 2559, 2559, 2559, 2559, 2559, 2559, 2559, 1152, 1153, 1840, 1841, 1842, 1843, 1844, 1845, 1846, 1847, 1848, 1849, 1850, 1851, 1852, 1853, 1854, 1855, 1856, 1857, 1858, 1859, 1860, 1861, 1862, 1863, 1864, 1865, 1866, 1867, 1868, 1869, 1870, 1871, 1872, 1873, 1874, 1875, 1876, 1877, 1878, 1879, 1284, 1285, 2559, 2559, 2559, 2559, 2559, 2559, 2559, 2559, 2559, 2559, 2559, 2559, 2559, 2559, 2559, 2559, 2559, 2559
2047, 2047, 2559, 2559, 2559, 2559, 2559, 2559, 2559, 2559, 2559, 2559, 2559, 2559, 2559, 2559, 2559, 2559, 1184, 1185, 1920, 1921, 1922, 1923, 1924, 1925, 1926, 1927, 1928, 1929, 1930, 1931, 1932, 1933, 1934, 1935, 1936, 1937, 1938, 1939, 1940, 1941, 1942, 1943, 1944, 1945, 1946, 1947, 1948, 1949, 1950, 1951, 1952, 1953, 1954, 1955, 1956, 1957, 1958, 1959, 1092, 1093, 2559, 2559, 2559, 2559, 2559, 2559, 2559, 2559, 2559, 2559, 2559, 2559, 2559, 2559, 2559, 2559, 2559, 2559
2047, 2047, 2559, 2559, 2559, 2559, 2559, 1458, 1459, 1460, 2559, 2559, 2559, 2559, 2559, 2559, 2559, 2559, 1216, 1217, 2000, 2001, 2002, 2003, 2004, 2005, 2006, 2007, 2008, 2009, 2010, 2011, 2012, 2013, 2014, 2015, 2016, 2017, 2018, 2019, 2020, 2021, 2022, 2023, 2024, 2025, 2026, 2027, 2028, 2029, 2030, 2031, 2032, 2033, 2034, 2035, 2036, 2037, 2038, 2039, 1124, 1125, 2559, 2559, 2559, 2559, 2559, 2559, 2559, 2559, 2559, 2559, 2559, 2559, 2559, 2559, 2559, 2559, 2559, 2559
2047, 2047, 2559, 2559, 2559, 1574, 1575, 1490, 1491, 1492, 1356, 1357, 1358, 1359, 1360, 1361, 2559, 2559, 1248, 1249, 2080, 2081, 2082, 2083, 2084, 2085, 2086, 2087, 2088, 2089, 2090, 2091, 2092, 2093, 2094, 2095, 2096, 2097, 2098, 2099, 2100, 2101, 2102, 2103, 2104, 2105, 2106, 2107, 2108, 2109, 2110, 2111, 2112, 2113, 2114, 2115, 2116, 2117, 2118, 2119, 1156, 1157, 2559, 2559, 2559, 2559, 2559, 2559, 2559, 2559, 2559, 2559, 2559, 2559, 2559, 2559, 2559, 2559, 2559, 2559
2047, 2047, 2559, 2559, 2559, 1606, 1607, 1522, 1523, 1524, 1388, 1389, 1390, 1391, 1392, 1393, 2047, 2047, 1088, 1089, 2160, 2161, 2162, 2163, 2164, 2165, 2166, 2167, 2168, 2169, 2170, 2171, 2172, 2173, 2174, 2175, 2176, 2177, 2178, 2179, 2180, 2181, 2182, 2183, 2184, 2185, 2186, 2187, 2188, 2189, 2190, 2191, 2192, 2193, 2194, 2195, 2196, 2197, 2198, 2199, 1188, 1189, 2559, 2559, 2559, 2559, 2559, 2559, 2559, 2559, 2559, 2559, 2559, 2559, 2559, 2559, 2559, 2559, 2559, 2559
2047, 2047, 2047, 2047, 2047, 2047, 2047, 2047, 2047, 2047, 1420, 1421, 1422, 1423, 1424, 1425, 2047, 2047, 1120, 1121, 2240, 2241, 2242, 2243, 2244, 2245, 2246, 2247, 2248, 2249, 2250, 2251, 2252, 2253, 2254, 2255, 2256, 2257, 2258, 2259, 2260, 2261, 2262, 2263, 2264, 2265, 2266, 2267, 2268, 2269, 2270, 2271, 2272, 2273, 2274, 2275, 2276, 2277, 2278, 2279, 1220, 1221, 2559, 2559, 2559, 2559, 2559, 2559, 2559, 2559, 2559, 2559, 2559, 2559, 2559, 2559, 2559, 2559, 2559, 2559
2047, 2559, 2559, 2559, 2559, 2559, 2559, 2559, 2559, 2559, 1452, 1453, 1454, 1455, 1456, 1457, 2047, 2047, 1152, 1153, 2320, 2321, 2322, 2323, 2324, 2325, 2326, 2327, 2328, 2329, 2330, 2331, 2332, 2333, 2334, 2335, 2336, 2337, 2338, 2339, 2340, 2341, 2342, 2343, 2344, 2345, 2346, 2347, 2348, 2349, 2350, 2351, 2352, 2353, 2354, 2355, 2356, 2357, 2358, 2359, 1252, 1253, 2559, 2559, 2559, 2559, 2559, 2559, 2559, 2559, 2559, 2559, 2559, 2559, 2559, 2559, 2559, 2559, 2559, 2559
2047, 2559, 2559, 2559, 2559, 2559, 2559, 2559, 2559, 2559, 1484, 1485, 1486, 1487, 1488, 1489, 2559, 2559, 1184, 1185, 2400, 2401, 2402, 2403, 2404, 2405, 2406, 2407, 2408, 2409, 2410, 2411, 2412, 2413, 2414, 2415, 2416, 2417, 2418, 2419, 2420, 2421, 2422, 2423, 2424, 2425, 2426, 2427, 2428, 2429, 2430, 2431, 2432, 2433, 2434, 2435, 2436, 2437, 2438, 2439, 1284, 1285, 2559, 2559, 2559, 2559, 2559, 2559, 2559, 2559, 2559, 2559, 2559, 2559, 2559, 2559, 2559, 2559, 2559, 2559
2047, 2559, 2559, 2559, 2559, 2559, 2559, 2559, 2559, 2559, 1516, 1517, 1518, 1519, 1520, 1521, 2559, 2559, 1216, 1217, 2480, 2481, 2482, 2483, 2484, 2485, 2486, 2487, 2488, 2489, 2490, 2491, 2492, 2493, 2494, 2495, 2496, 2497, 2498, 2499, 2500, 2501, 2502, 2503, 2504, 2505, 2506, 2507, 2508, 2509, 2510, 2511, 2512, 2513, 2514, 2515, 2516, 2517, 2518, 2519, 1316, 1317, 2559, 2559, 2559, 2559, 2559, 2559, 2559, 2559, 2559, 2559, 2559, 2559, 2559, 2559, 2559, 2559, 2559, 2559
2493, 2559, 2559, 2559, 2559, 2559, 2559, 2559, 2559, 2559, 1548, 1549, 1550, 1551, 1552, 1553, 2559, 2559, 1088, 1089, 2560, 2561, 2562, 2563, 2564, 2565, 2566, 2567, 2568, 2569, 2570, 2571, 2572, 2573, 2574, 2575, 2576, 2577, 2578, 2579, 2580, 2581, 2582, 2583, 2584, 2585, 2586, 2587, 2588, 2589, 2590, 2591, 2592, 2593, 2594, 2595, 2596, 2597, 2598, 2599, 1092, 1093, 2559, 2559, 2559, 2559, 2559, 2559, 2559, 2559, 2559, 2559, 2559, 2559, 2559, 2559, 2559, 2559, 2559, 2559
2493, 2559, 2559, 2559, 2559, 2559, 2559, 2559, 2559, 2559, 2559, 2559, 2559, 2559, 2559, 2559, 2559, 2559, 1120, 1121, 2640, 2641, 2642, 2643, 2644, 2645, 2646, 2647, 2648, 2649, 2650, 2651, 2652, 2653, 2654, 2655, 2656, 2657, 2658, 2659, 2660, 2661, 2662, 2663, 2664, 2665, 2666, 2667, 2668, 2669, 2670, 2671, 2672, 2673, 2674, 2675, 2676, 2677, 2678, 2679, 1124, 1125, 2559, 2559, 2559, 2559, 2559, 2559, 2559, 2559, 2559, 2559, 2559, 2559, 2559, 2559, 2559, 2559, 2559, 2559
1433, 1434, 1435, 1436, 1437, 1438, 2559, 2559, 2559, 2559, 2559, 2559, 2559, 2559, 2559, 2559, 2559, 2559, 1152, 1153, 2720, 2721, 2722, 2723, 2724, 2725, 2726, 2727, 2728, 2729, 2730, 2731, 2732, 2733, 2734, 2735, 2736, 2737, 2738, 2739, 2740, 2741, 2742, 2743, 2744, 2745, 2746, 2747, 2748, 2749, 2750, 2751, 2752, 2753, 2754, 2755, 2756, 2757, 2758, 2759, 1156, 1157, 2559, 2559, 2559, 2559, 2559, 2559, 2559, 2559, 2559, 2559, 2559, 2559, 2559, 2559, 2559, 2559, 2559, 2559
1465, 1466, 1467, 1468, 1469, 1470, 2559, 2559, 2559, 2559, 2559, 2559, 2559, 2559, 2559, 2559, 2559, 2559, 1184, 1185, 2800, 2801, 2802, 2803, 2804, 2805, 2806, 2807, 2808, 2809, 2810, 2811, 2812, 2813, 2814, 2815, 2816, 2817, 2818, 2819, 2820, 2821, 2822, 2823, 2824, 2825, 2826, 2827, 2828, 2829, 2830, 2831, 2832, 2833, 2834, 2835, 2836, 2837, 2838, 2839, 1188, 1189, 2559, 2559, 2559, 2559, 2559, 2559, 2559, 2559, 2559, 2559, 2559, 2559, 2559, 2559, 2559, 2559, 2559, 2559
2493, 2559, 2559, 2559, 2559, 2559, 2559, 2559, 2559, 2559, 2559, 2559, 2559, 2559, 2559, 2559, 2559, 2559, 1216, 1217, 2880, 2881, 2882, 2883, 2884, 2885, 2886, 2887, 2888, 2889, 2890, 2891, 2892, 2893, 2894, 2895, 2896, 2897, 2898, 2899, 2900, 2901, 2902, 2903, 2904, 2905, 2906, 2907, 2908, 2909, 2910, 2911, 2912, 2913, 2914, 2915, 2916, 2917, 2918, 2919, 1220, 1221, 2559, 2559, 2559, 2559, 2559, 2559, 2559, 2559, 2559, 1574, 1575, 1568, 1569, 1570, 1571, 1572, 1573, 2559
2047, 2559, 2559, 2559, 2559, 2559, 2559, 2559, 2559, 2559, 2559, 2559, 2559, 2559, 2559, 2559, 2559, 2559, 1088, 1089, 2960, 2961, 2962, 2963, 2964, 2965, 2966, 2967, 2968, 2969, 2970, 2971, 2972, 2973, 2974, 2975, 2976, 2977, 2978, 2979, 2980, 2981, 2982, 2983, 2984, 2985, 2986, 2987, 2988, 2989, 2990, 2991, 2992, 2993, 2994, 2995, 2996, 2997, 2998, 2999, 1092, 1093, 2559, 2559, 2559, 2559, 2559, 2559, 2559, 2559, 2559, 1606, 1607, 1600, 1601, 1602, 1603, 1604, 1605, 2047
2047, 2559, 2559, 2559, 2559, 2559, 2559, 2559, 2559, 2559, 2559, 2559, 2559, 2559, 2559, 2559, 2559, 2559, 1120, 1121, 3040, 3041, 3042, 3043, 3044, 3045, 3046, 3047, 3048, 3049, 3050, 3051, 3052, 3053, 3054, 3055, 3056, 3057, 3058, 3059, 3060, 3061, 3062, 3063, 3064, 3065, 3066, 3067, 3068, 3069, 3070, 3071, 3072, 3073, 3074, 3075, 3076, 3077, 3078, 3079, 1124, 1125, 2559, 2559, 2559, 2559, 2559, 2559, 2559, 2559, 2559, 2559, 2559, 2559, 2559, 2559, 2559, 2559, 2559, 2047
1344, 1345, 1346, 1347, 1348, 1349, 2559, 2559, 2559, 2559, 2559, 2559, 2559, 2559, 2559, 2559, 2559, 2559, 1152, 1153, 3120, 3121, 3122, 3123, 3124, 3125, 3126, 3127, 3128, 3129, 3130, 3131, 3132, 3133, 3134, 3135, 3136, 3137, 3138, 3139, 3140, 3141, 3142, 3143, 3144, 3145, 3146, 3147, 3148, 3149, 3150, 3151, 3152, 3153, 3154, 3155, 3156, 3157, 3158, 3159, 1156, 1157, 2559, 2559, 2559, 2559, 2559, 2559, 2559, 2559, 2559, 2559, 1356, 1357, 1358, 1359, 1360, 1361, 2559, 2047
1376, 1377, 1378, 1379, 1380, 1381, 2559, 2559, 2559, 2559, 2559, 2559, 2559, 2559, 2559, 2559, 2559, 2559, 1184, 1185, 3200, 3201, 3202, 3203, 3204, 3205, 3206, 3207, 3208, 3209, 3210, 3211, 3212, 3213, 3214, 3215, 3216, 3217, 3218, 3219, 3220, 3221, 3222, 3223, 3224, 3225, 3226, 3227, 3228, 3229, 3230, 3231, 3232, 3233, 3234, 3235, 3236, 3237, 3238, 3239, 1188, 1189, 2559, 2559, 2559, 2559, 2559, 2559, 2559, 2559, 2559, 2559, 1388, 1389, 1390, 1391, 1392, 1393, 2559, 2047
1408, 1409, 1410, 1411, 1412, 1413, 2559, 2559, 2559, 1362, 1363, 1364, 2559, 2559, 2559, 2559, 2559, 2559, 1216, 1217, 3280, 3281, 3282, 3283, 3284, 3285, 3286, 3287, 3288, 3289, 3290, 3291, 3292, 3293, 3294, 3295, 3296, 3297, 3298, 3299, 3300, 3301, 3302, 3303, 3304, 3305, 3306, 3307, 3308, 3309, 3310, 3311, 3312, 3313, 3314, 3315, 3316, 3317, 3318, 3319, 1220, 1221, 2559, 2559, 2559, 2559, 2559, 1461, 1462, 1463, 1464, 1574, 1575, 1421, 1422, 1423, 1424, 1425, 2559, 2047
1440, 1441, 1442, 1443, 1444, 1445, 2559, 2559, 2559, 1394, 1395, 1396, 2559, 2559, 2559, 2559, 2559, 2559, 1248, 1249, 3360, 3361, 3362, 3363, 3364, 3365, 3366, 3367, 3368, 3369, 3370, 3371, 3372, 3373, 3374, 3375, 3376, 3377, 3378, 3379, 3380, 3381, 3382, 3383, 3384, 3385, 3386, 3387, 3388, 3389, 3390, 3391, 3392, 3393, 3394, 3395, 3396, 3397, 3398, 3399, 1252, 1253, 2559, 2559, 2559, 2559, 2559, 1493, 1494, 1495, 1496, 1606, 1607, 1453, 1454, 1455, 1456, 1457, 2559, 2047
1472, 1473, 1474, 1475, 1476, 1477, 2559, 2559, 2559, 1426, 1427, 1428, 2559, 2559, 2559, 2559, 2559, 2559, 1280, 1281, 3440, 3441, 3442, 3443, 3444, 3445, 3446, 3447, 3448, 3449, 3450, 3451, 3452, 3453, 3454, 3455, 3456, 3457, 3458, 3459, 3460, 3461, 3462, 3463, 3464, 3465, 3466, 3467, 3468, 3469, 3470, 3471, 3472, 3473, 3474, 3475, 3476, 3477, 3478, 3479, 1284, 1285, 2559, 2559, 2559, 2559, 2559, 1525, 1526, 1527, 1528, 2559, 1484, 1485, 1486, 1487, 1488, 1489, 2559, 2047
1504, 1505, 1506, 1507, 1508, 1509, 2559, 2559, 2559, 2559, 2559, 2559, 2559, 2559, 2559, 2559, 2559, 2559, 1312, 1313, 3520, 3521, 3522, 3523, 3524, 3525, 3526, 3527, 3528, 3529, 3530, 3531, 3532, 3533, 3534, 3535, 3536, 3537, 3538, 3539, 3540, 3541, 3542, 3543, 3544, 3545, 3546, 3547, 3548, 3549, 3550, 3551, 3552, 3553, 3554, 3555, 3556, 3557, 3558, 3559, 1316, 1317, 2559, 2559, 2559, 2559, 2559, 2559, 2559, 2559, 2559, 2559, 1516, 1517, 1518, 1519, 1520, 1521, 2559, 2047
1536, 1537, 1538, 1539, 1540, 1541, 2559, 2559, 2559, 2559, 2559, 2559, 2559, 2559, 2559, 2559, 2559, 2559, 5284, 5285, 4964, 4965, 4966, 4967, 4968, 4969, 4970, 4971, 4972, 4973, 4974, 4975, 4976, 4977, 4978, 4979, 4980, 4981, 4982, 4983, 4984, 4985, 4986, 4987, 4988, 4989, 4990, 4991, 4992, 4993, 4994, 4995, 4996, 4997, 4998, 4999, 5000, 5001, 5002, 5003, 5286, 5287, 2559, 2559, 2559, 2559, 2559, 2559, 2559, 2559, 2559, 2559, 1548, 1549, 1550, 1551, 1552, 1553, 2559, 2047
2047, 2047, 2047, 2047, 2559, 2559, 2559, 2559, 2559, 2559, 2559, 2559, 2559, 2559, 2559, 2559, 2047, 2047, 5364, 5365, 5044, 5045, 5046, 5047, 5048, 5049, 5050, 5051, 5052, 5053, 5054, 5055, 5056, 5057, 5058, 5059, 5060, 5061, 5062, 5063, 5064, 5065, 5066, 5067, 5068, 5069, 5070, 5071, 5072, 5073, 5074, 5075, 5076, 5077, 5078, 5079, 5080, 5081, 5082, 5083, 5366, 5367, 2559, 2559, 2559, 2559, 2559, 2559, 2559, 2559, 2559, 2559, 2559, 2559, 2559, 2559, 2559, 2559, 2559, 2047
2047, 2047, 2047, 2047, 2559, 2559, 2559, 2559, 2559, 2559, 2559, 2559, 2559, 2559, 2559, 2559, 2047, 2047, 1056, 1057, 1058, 1059, 1060, 1061, 1062, 1063, 1064, 1065, 1066, 1067, 1068, 1069, 1070, 1063, 1064, 1065, 1066, 1067, 1068, 1069, 1070, 1071, 1072, 1073, 1074, 1075, 1076, 1077, 1078, 1075, 1076, 1077, 1078, 1079, 1080, 1081, 1082, 1083, 1084, 1085, 1086, 1087, 2559, 2559, 2559, 2559, 2559, 2559, 2559, 2559, 2559, 2559, 2559, 2559, 2559, 2559, 2559, 2559, 2559, 2047
2493, 2493, 2047, 2047, 2559, 2559, 2559, 2559, 2559, 2559, 2559, 2559, 2559, 2559, 2559, 2559, 2559, 2559, 2559, 2559, 2559, 2559, 2559, 2559, 2559, 2559, 2559, 2559, 2559, 2559, 2559, 2047, 2047, 2559, 2559, 2559, 2559, 2559, 2559, 2559, 2559, 2559, 2559, 2559, 2559, 2559, 2559, 2559, 2559, 2559, 2559, 2559, 2559, 2559, 2559, 2559, 2559, 2559, 2559, 2559, 2559, 2559, 2559, 2559, 2559, 2559, 2559, 2559, 2559, 2559, 2559, 2559, 2559, 2559, 2559, 2559, 2559, 2559, 2559, 2047
2493, 2493, 2047, 2047, 2559, 2559, 2559, 2559, 2559, 2559, 2559, 2559, 2559, 2559, 2559, 2559, 2559, 2559, 2559, 2559, 2559, 2559, 2559, 2559, 2559, 2559, 2559, 2559, 2559, 2559, 2559, 2559, 2559, 2559, 2559, 2559, 2559, 2559, 2559, 2559, 2559, 2559, 2559, 2559, 2559, 2559, 2559, 2559, 2559, 2559, 2559, 2559, 2559, 2559, 2559, 2559, 2559, 2559, 2559, 2559, 2559, 2559, 2559, 2559, 2559, 2559, 2559, 2559, 2559, 2047, 2047, 2047, 2047, 2047, 2047, 2047, 2047, 2047, 2047, 2047
2047, 2047, 2047, 2047, 2559, 2559, 2559, 2559, 2559, 2559, 2559, 2559, 2559, 2559, 2559, 2559, 2559, 2559, 2559, 2559, 2559, 2559, 2559, 2559, 2559, 2559, 2559, 2559, 2559, 2559, 2559, 2559, 2559, 2559, 2559, 2559, 2559, 2559, 2559, 2559, 2559, 2559, 2559, 2559, 2559, 2559, 2559, 2559, 2559, 2559, 2559, 2559, 2559, 2559, 2559, 2559, 2559, 2559, 2559, 2559, 2559, 2559, 2559, 2559, 2559, 2559, 2559, 2559, 2559, 2047, 2047, 2047, 2047, 2047, 2047, 2047, 2047, 2047, 2047, 2047
