1121, 1121, 1121, 1121, 1121, 1121, 1121, 1121, 1121, 1121, 1121, 1121, 1121, 1121, 1121, 1121, 1121, 1121, 1121, 1121, 1121, 1121, 1121, 1121, 1121, 1121, 1121, 1121, 1121, 1121, 1121, 1121, 1121, 1121, 1121, 1121, 1121, 1121, 1121, 1121, 1121, 1121, 1121, 1121, 1121, 1121, 1121, 1121, 1121, 1121, 1121, 1121, 1121, 1121, 1121, 1121, 1121, 1121, 1121, 1121, 1121, 1121, 1121, 1121, 1121, 1121, 1121, 1121, 1121, 1121, 1121, 1121, 1121, 1121, 1121, 1121, 1121, 1121, 1121, 1121
1121, 1121, 1121, 1121, 1121, 1121, 1121, 1121, 1121, 1121, 1121, 1121, 1121, 1121, 1121, 1121, 1121, 1121, 1121, 1121, 1121, 1121, 1121, 1121, 1121, 1121, 1121, 1121, 1121, 1121, 1121, 1121, 1121, 1121, 1121, 1121, 1121, 1121, 1121, 1121, 1121, 1121, 1121, 1121, 1121, 1121, 1121, 1121, 1121, 1121, 1121, 1121, 1121, 1121, 1121, 1121, 1121, 1121, 1121, 1121, 1121, 1121, 1121, 1121, 1121, 1121, 1121, 1121, 1121, 1121, 1121, 1121, 1121, 1121, 1121, 1121, 1121, 1121, 1121, 1121
1121, 1121, 1121, 1121, 1121, 1121, 1121, 1121, 1121, 1121, 1121, 1121, 1121, 1121, 1121, 1121, 1121, 1121, 1121, 1121, 1121, 1121, 1121, 1121, 1121, 1121, 1121, 1121, 1121, 1121, 1121, 1121, 1121, 1121, 1121, 1121, 1121, 1121, 1121, 1121, 1121, 1121, 1121, 1121, 1121, 1121, 1121, 1121, 1121, 1121, 1121, 1121, 1121, 1121, 1121, 1121, 1121, 1121, 1121, 1121, 1121, 1121, 1121, 1121, 1121, 1121, 1121, 1121, 1121, 1121, 1121, 1121, 1121, 1121, 1121, 1121, 1121, 1121, 1121, 1121
1121, 1121, 1121, 1121, 1121, 1121, 1121, 1121, 1121, 1121, 1121, 1121, 1121, 1121, 1121, 1121, 1121, 1121, 1121, 1121, 1121, 1121, 1121, 1121, 1121, 1121, 1121, 1121, 1121, 1121, 1121, 1121, 1121, 1121, 1121, 1121, 1121, 1121, 1121, 1121, 1121, 1121, 1121, 1121, 1121, 1121, 1121, 1121, 1121, 1121, 1121, 1121, 1121, 1121, 1121, 1121, 1121, 1121, 1121, 1121, 1121, 1121, 1121, 1121, 1121, 1121, 1121, 1121, 1121, 1121, 1121, 1121, 1121, 1121, 1121, 1121, 1121, 1121, 1121, 1121
1121, 1121, 1121, 1121, 1121, 1121, 1121, 1121, 1121, 1121, 1121, 1121, 1121, 1121, 1121, 1121, 1121, 1121, 1121, 1121, 1121, 1121, 1121, 1121, 1121, 1121, 1121, 1121, 1121, 1121, 1121, 1121, 1121, 1121, 1121, 1121, 1121, 1121, 1121, 1121, 1121, 1121, 1121, 1121, 1121, 1121, 1121, 1121, 1121, 1121, 1121, 1121, 1121, 1121, 1121, 1121, 1121, 1121, 1121, 1121, 1121, 1121, 1121, 1121, 1121, 1121, 1121, 1121, 1121, 1121, 1121, 1121, 1121, 1121, 1121, 1121, 1121, 1121, 1121, 1121
1121, 1121, 1121, 1121, 1121, 1121, 1121, 1121, 1121, 1121, 1121, 1121, 1121, 1121, 1121, 1121, 1121, 1121, 1121, 1121, 1121, 1121, 1121, 1121, 1121, 1121, 1121, 1121, 1121, 1121, 1121, 1121, 1121, 1121, 1121, 1121, 1121, 1121, 1121, 1121, 1121, 1121, 1121, 1121, 1121, 1121, 1121, 1121, 1121, 1121, 1121, 1121, 1121, 1121, 1121, 1121, 1121, 1121, 1121, 1121, 1121, 1121, 1121, 1121, 1121, 1121, 1121, 1121, 1121, 1121, 1121, 1121, 1121, 1121, 1121, 1121, 1121, 1121, 1121, 1121
1121, 1121, 1121, 1121, 1121, 1121, 1121, 1121, 1121, 1121, 1121, 1121, 1121, 1121, 1121, 1121, 1121, 1121, 1121, 1121, 1121, 1121, 1121, 1121, 1121, 1121, 1121, 1121, 1121, 1121, 1121, 1121, 1121, 1121, 1121, 1121, 1121, 1121, 1121, 1121, 1121, 1121, 1121, 1121, 1121, 1121, 1121, 1121, 1121, 1121, 1121, 1121, 1121, 1121, 1121, 1121, 1121, 1121, 1121, 1121, 1121, 1121, 1121, 1121, 1121, 1121, 1121, 1121, 1121, 1121, 1121, 1121, 1121, 1121, 1121, 1121, 1121, 1121, 1121, 1121
1121, 1121, 1121, 1121, 1121, 1121, 1121, 1121, 1121, 1121, 1121, 1121, 1121, 1121, 1121, 1121, 1121, 1121, 1121, 1121, 1121, 1121, 1121, 1121, 1121, 1121, 1121, 1121, 1121, 1121, 1121, 1121, 1121, 1121, 1121, 1121, 1121, 1121, 1121, 1121, 1121, 1121, 1121, 1121, 1121, 1121, 1121, 1121, 1121, 1121, 1121, 1121, 1121, 1121, 1121, 1121, 1121, 1121, 1121, 1121, 1121, 1121, 1121, 1121, 1121, 1121, 1121, 1121, 1121, 1121, 1121, 1121, 1121, 1121, 1121, 1121, 1121, 1121, 1121, 1121
1121, 1121, 1121, 1121, 1121, 1121, 1121, 1121, 1121, 1121, 1121, 1121, 1121, 1121, 1121, 1121, 1121, 1121, 1121, 1121, 1121, 1121, 1121, 1121, 1121, 1121, 1121, 1121, 1121, 1121, 1121, 1121, 1121, 1121, 1121, 1121, 1121, 1121, 1121, 1121, 1121, 1121, 1121, 1121, 1121, 1121, 1121, 1121, 1121, 1121, 1121, 1121, 1121, 1121, 1121, 1121, 1121, 1121, 1121, 1121, 1121, 1121, 1121, 1121, 1121, 1121, 1121, 1121, 1121, 1121, 1121, 1121, 1121, 1121, 1121, 1121, 1121, 1121, 1121, 1121
1121, 1121, 1121, 1121, 1121, 1121, 1121, 1121, 1121, 1121, 1121, 1121, 1121, 1121, 1089, 1093, 1093, 1093, 1093, 1093, 1093, 1094, 1094, 1094, 1094, 1094, 1094, 1094, 1094, 1094, 1094, 1094, 1094, 1093, 1093, 1093, 1093, 1053, 1053, 1093, 1093, 1093, 1094, 1094, 1094, 1094, 1094, 1094, 1094, 1094, 1094, 1094, 1094, 1094, 1094, 1094, 1094, 1094, 1094, 1100, 1165, 1165, 1165, 1165, 1165, 1165, 1165, 1165, 1165, 1165, 1165, 1165, 1165, 1165, 1165, 1165, 1165, 1165, 1165, 1165
1121, 1121, 1121, 1121, 1121, 1121, 1121, 1121, 1121, 1121, 1121, 1121, 1121, 1121, 1103, 170, 171, 172, 173, 174, 175, 0, 0, 0, 0, 0, 0, 0, 0, 0, 0, 0, 0, 0, 0, 0, 0, 1052, 1052, 1053, 0, 0, 0, 0, 0, 0, 0, 0, 0, 0, 0, 0, 0, 0, 0, 0, 0, 0, 0, 1106, 1165, 1165, 1165, 1165, 1165, 1165, 1165, 1165, 1165, 1165, 1165, 1165, 1165, 1165, 1165, 1165, 1165, 1165, 1165, 1165
1121, 1121, 1121, 1121, 1121, 1121, 1121, 1121, 1121, 1121, 1121, 1121, 1121, 1121, 1103, 202, 203, 204, 205, 206, 207, 0, 0, 0, 0, 0, 0, 0, 0, 0, 0, 0, 0, 0, 0, 0, 0, 0, 0, 0, 0, 0, 0, 0, 0, 0, 0, 0, 0, 0, 0, 0, 0, 0, 0, 0, 0, 0, 0, 1106, 1165, 1165, 1165, 1165, 1165, 1165, 1165, 1165, 1165, 1165, 1165, 1165, 1165, 1165, 1165, 1165, 1165, 1165, 1165, 1165
1121, 1121, 1121, 1121, 1121, 1121, 1121, 1121, 1121, 1121, 1121, 1121, 1121, 1121, 1103, 234, 235, 236, 237, 238, 239, 0, 1, 2, 3, 4, 5, 6, 7, 8, 9, 10, 11, 12, 13, 14, 15, 0, 1, 2, 3, 4, 5, 6, 7, 8, 9, 10, 11, 12, 13, 14, 15, 0, 0, 0, 0, 0, 0, 1106, 1165, 1165, 1165, 1165, 1165, 1165, 1165, 1165, 1165, 1165, 1165, 1165, 1165, 1165, 1165, 1165, 1165, 1165, 1165, 1165
1121, 1121, 1121, 1121, 1121, 1121, 1121, 1121, 1121, 1121, 1121, 1121, 1121, 1121, 1103, 170, 171, 172, 173, 174, 175, 32, 33, 34, 35, 36, 37, 38, 39, 40, 41, 42, 43, 44, 45, 46, 47, 32, 33, 34, 35, 36, 37, 38, 39, 40, 41, 42, 43, 44, 45, 46, 47, 0, 0, 0, 1, 2, 3, 1106, 1165, 1165, 1165, 1165, 1165, 1165, 1165, 1165, 1165, 1165, 1165, 1165, 1165, 1165, 1165, 1165, 1165, 1165, 1165, 1165
1121, 1121, 1121, 1121, 1121, 1121, 1121, 1121, 1121, 1121, 1121, 1121, 1121, 1121, 1103, 170, 171, 172, 173, 174, 175, 64, 65, 66, 67, 68, 69, 70, 71, 72, 73, 74, 75, 76, 77, 78, 79, 64, 65, 66, 67, 68, 69, 70, 71, 72, 73, 74, 75, 76, 77, 78, 79, 0, 0, 32, 33, 34, 35, 1106, 1165, 1165, 1165, 1165, 1165, 1165, 1165, 1165, 1165, 1165, 1165, 1165, 1165, 1165, 1165, 1165, 1165, 1165, 1165, 1165
1121, 1121, 1121, 1121, 1121, 1121, 1121, 1121, 1121, 1121, 1121, 1121, 1121, 1121, 1103, 202, 203, 204, 205, 206, 207, 96, 97, 98, 99, 100, 1028, 1028, 1028, 1028, 1028, 1028, 170, 170, 170, 110, 111, 1028, 1028, 1028, 1028, 1028, 1028, 170, 170, 170, 170, 106, 1028, 1028, 1028, 1028, 1028, 1028, 0, 64, 65, 66, 67, 1106, 1165, 1165, 1165, 1165, 1165, 1165, 1165, 1165, 1165, 1165, 1165, 1165, 1165, 1165, 1165, 1165, 1165, 1165, 1165, 1165
1121, 1121, 1121, 1121, 1121, 1121, 1121, 1121, 1121, 1121, 1121, 1121, 1121, 1121, 1103, 234, 235, 236, 237, 238, 239, 128, 129, 130, 131, 132, 1028, 1028, 1028, 1028, 1028, 1028, 170, 170, 170, 142, 143, 1028, 1028, 1028, 1028, 1028, 1028, 170, 170, 170, 170, 138, 1028, 1028, 1028, 1028, 1028, 1028, 0, 96, 97, 98, 99, 1106, 1165, 1165, 1165, 1165, 1165, 1165, 1165, 1165, 1165, 1165, 1165, 1165, 1165, 1165, 1165, 1165, 1165, 1165, 1165, 1165
1121, 1121, 1121, 1121, 1121, 1121, 1121, 1121, 1121, 1121, 1121, 1121, 1121, 1121, 1103, 266, 267, 268, 269, 270, 271, 160, 161, 162, 163, 164, 1028, 1028, 1028, 1028, 1028, 1028, 170, 170, 170, 174, 175, 1028, 1028, 1028, 1028, 1028, 1028, 170, 170, 170, 170, 170, 1028, 1028, 1028, 1028, 1028, 1028, 134, 128, 129, 130, 131, 1106, 1165, 1165, 1165, 1165, 1165, 1165, 1165, 1165, 1165, 1165, 1165, 1165, 1165, 1165, 1165, 1165, 1165, 1165, 1165, 1165
1121, 1121, 1121, 1121, 1121, 1121, 1121, 1121, 1121, 1121, 1121, 1121, 1121, 1121, 1103, 298, 299, 300, 301, 302, 303, 192, 193, 194, 195, 196, 1028, 1028, 1028, 1028, 1028, 1028, 170, 170, 170, 206, 207, 1028, 1028, 1028, 1028, 1028, 1028, 170, 170, 170, 170, 202, 1028, 1028, 1028, 1028, 1028, 1028, 166, 160, 161, 162, 163, 1106, 1165, 1165, 1165, 1165, 1165, 1165, 1165, 1165, 1165, 1165, 1165, 1165, 1165, 1165, 1165, 1165, 1165, 1165, 1165, 1165
1121, 1121, 1121, 1121, 1121, 1121, 1121, 1121, 1121, 1121, 1121, 1121, 1121, 1121, 1103, 330, 331, 332, 333, 334, 335, 224, 225, 226, 227, 228, 1028, 1028, 1028, 1028, 1028, 1028, 170, 170, 170, 238, 239, 1028, 1028, 1028, 1028, 1028, 1028, 170, 170, 170, 170, 234, 1028, 1028, 1028, 1028, 1028, 1028, 198, 192, 193, 194, 195, 1106, 1165, 1165, 1165, 1165, 1165, 1165, 1165, 1165, 1165, 1165, 1165, 1165, 1165, 1165, 1165, 1165, 1165, 1165, 1165, 1165
1121, 1121, 1121, 1121, 1121, 1121, 1121, 1121, 1121, 1121, 1121, 1121, 1121, 1121, 1103, 170, 171, 172, 173, 174, 175, 256, 257, 258, 259, 260, 1028, 1028, 1028, 1028, 1028, 1028, 170, 170, 170, 270, 271, 1028, 1028, 1028, 1028, 1028, 1028, 170, 170, 170, 170, 266, 1028, 1028, 1028, 1028, 1028, 1028, 230, 224, 225, 226, 227, 1106, 1165, 1165, 1165, 1165, 1165, 1165, 1165, 1165, 1165, 1165, 1165, 1165, 1165, 1165, 1165, 1165, 1165, 1165, 1165, 1165
1121, 1121, 1121, 1121, 1121, 1121, 1121, 1121, 1121, 1121, 1121, 1121, 1121, 1121, 1103, 202, 203, 204, 205, 206, 207, 288, 289, 290, 291, 292, 1028, 1028, 1028, 1028, 1028, 1028, 170, 170, 170, 302, 303, 1028, 1028, 1028, 1028, 1028, 1028, 170, 170, 170, 170, 298, 1028, 1028, 1028, 1028, 1028, 1028, 262, 256, 257, 258, 259, 1106, 1165, 1165, 1165, 1165, 1165, 1165, 1165, 1165, 1165, 1165, 1165, 1165, 1165, 1165, 1165, 1165, 1165, 1165, 1165, 1165
1121, 1121, 1121, 1121, 1121, 1121, 1121, 1121, 1121, 1121, 1121, 1121, 1121, 1121, 1103, 234, 235, 236, 237, 238, 239, 320, 321, 322, 323, 324, 1028, 1028, 1028, 1028, 1028, 1028, 170, 170, 170, 334, 335, 1028, 1028, 1028, 1028, 1028, 1028, 170, 170, 170, 170, 330, 1028, 1028, 1028, 1028, 1028, 1028, 294, 288, 289, 290, 291, 1106, 1165, 1165, 1165, 1165, 1165, 1165, 1165, 1165, 1165, 1165, 1165, 1165, 1165, 1165, 1165, 1165, 1165, 1165, 1165, 1165
1121, 1121, 1121, 1121, 1121, 1121, 1121, 1121, 1121, 1121, 1121, 1121, 1121, 1121, 1103, 266, 267, 268, 269, 270, 271, 352, 353, 354, 355, 356, 357, 358, 359, 360, 361, 362, 363, 364, 365, 366, 367, 352, 353, 354, 355, 356, 357, 358, 359, 360, 361, 362, 363, 364, 365, 366, 367, 304, 326, 320, 321, 322, 1053, 1106, 1165, 1165, 1165, 1165, 1165, 1165, 1165, 1165, 1165, 1165, 1165, 1165, 1165, 1165, 1165, 1165, 1165, 1165, 1165, 1165
1121, 1121, 1121, 1121, 1121, 1121, 1121, 1121, 1121, 1121, 1121, 1121, 1121, 1121, 1103, 298, 299, 300, 301, 302, 303, 384, 385, 386, 387, 388, 389, 390, 956, 957, 393, 394, 395, 396, 397, 398, 399, 384, 385, 386, 387, 388, 389, 390, 391, 392, 393, 394, 395, 396, 397, 398, 399, 336, 358, 352, 353, 354, 355, 1106, 1165, 1165, 1165, 1165, 1165, 1165, 1165, 1165, 1165, 1165, 1165, 1165, 1165, 1165, 1165, 1165, 1165, 1165, 1165, 1165
1121, 1121, 1121, 1121, 1121, 1121, 1121, 1121, 1121, 1121, 1121, 1121, 1121, 1121, 1103, 1053, 331, 332, 333, 334, 335, 458, 417, 418, 419, 420, 421, 422, 988, 989, 425, 426, 427, 428, 429, 430, 431, 416, 417, 418, 419, 420, 421, 422, 423, 424, 425, 426, 427, 428, 429, 430, 431, 368, 390, 384, 385, 386, 387, 1106, 1165, 1165, 1165, 1165, 1165, 1165, 1165, 1165, 1165, 1165, 1165, 1165, 1165, 1165, 1165, 1165, 1165, 1165, 1165, 1165
1121, 1121, 1121, 1121, 1121, 1121, 1121, 1121, 1121, 1121, 1121, 1121, 1121, 1121, 1103, 170, 171, 172, 173, 174, 175, 448, 449, 450, 451, 452, 453, 454, 455, 456, 457, 458, 459, 460, 461, 462, 463, 448, 449, 450, 451, 452, 453, 454, 455, 456, 457, 458, 459, 460, 461, 462, 463, 145, 422, 416, 417, 418, 419, 1106, 1165, 1165, 1165, 1165, 1165, 1165, 1165, 1165, 1165, 1165, 1165, 1165, 1165, 1165, 1165, 1165, 1165, 1165, 1165, 1165
1121, 1121, 1121, 1121, 1121, 1121, 1121, 1121, 1121, 1121, 1121, 1121, 1121, 1121, 1103, 202, 203, 204, 205, 206, 207, 480, 481, 482, 483, 484, 485, 486, 487, 488, 489, 490, 491, 492, 493, 494, 495, 480, 481, 482, 483, 484, 485, 486, 487, 488, 489, 490, 491, 492, 493, 494, 495, 177, 454, 448, 449, 450, 451, 1106, 1165, 1165, 1165, 1165, 1165, 1165, 1165, 1165, 1165, 1165, 1165, 1165, 1165, 1165, 1165, 1165, 1165, 1165, 1165, 1165
1121, 1121, 1121, 1121, 1121, 1121, 1121, 1121, 1121, 1121, 1121, 1121, 1121, 1121, 1103, 234, 235, 236, 237, 238, 239, 0, 1, 2, 3, 4, 5, 6, 7, 8, 9, 10, 11, 12, 956, 957, 15, 32, 33, 34, 35, 36, 37, 38, 39, 40, 41, 203, 1028, 1028, 1028, 1028, 1028, 1028, 486, 480, 481, 482, 483, 1106, 1165, 1165, 1165, 1165, 1165, 1165, 1165, 1165, 1165, 1165, 1165, 1165, 1165, 1165, 1165, 1165, 1165, 1165, 1165, 1165
1121, 1121, 1121, 1121, 1121, 1121, 1121, 1121, 1121, 1121, 1121, 1121, 1121, 1121, 1103, 266, 267, 268, 269, 270, 271, 42, 43, 44, 45, 46, 1028, 1028, 1028, 1028, 1028, 1028, 69, 70, 988, 989, 394, 111, 112, 113, 114, 115, 116, 96, 97, 98, 99, 235, 1028, 1028, 1028, 1028, 1028, 1028, 5, 6, 7, 8, 9, 1106, 1165, 1165, 1165, 1165, 1165, 1165, 1165, 1165, 1165, 1165, 1165, 1165, 1165, 1165, 1165, 1165, 1165, 1165, 1165, 1165
1121, 1121, 1121, 1121, 1121, 1121, 1121, 1121, 1121, 1121, 1121, 1121, 1121, 1121, 1103, 298, 299, 300, 301, 302, 303, 100, 101, 102, 103, 104, 1028, 1028, 1028, 1028, 1028, 1028, 111, 128, 129, 130, 131, 143, 144, 145, 146, 147, 148, 138, 139, 140, 141, 267, 1028, 1028, 1028, 1028, 1028, 1028, 47, 64, 65, 66, 67, 1106, 1165, 1165, 1165, 1165, 1165, 1165, 1165, 1165, 1165, 1165, 1165, 1165, 1165, 1165, 1165, 1165, 1165, 1165, 1165, 1165
1121, 1121, 1121, 1121, 1121, 1121, 1121, 1121, 1121, 1121, 1121, 1121, 1121, 1121, 1103, 330, 331, 332, 333, 334, 335, 142, 143, 160, 161, 162, 1028, 1028, 1028, 1028, 1028, 1028, 169, 170, 171, 172, 173, 111, 112, 113, 114, 115, 116, 196, 197, 198, 199, 299, 1028, 1028, 1028, 1028, 1028, 1028, 105, 106, 107, 108, 109, 1106, 1165, 1165, 1165, 1165, 1165, 1165, 1165, 1165, 1165, 1165, 1165, 1165, 1165, 1165, 1165, 1165, 1165, 1165, 1165, 1165
1121, 1121, 1121, 1121, 1121, 1121, 1121, 1121, 1121, 1121, 1121, 1121, 1121, 1121, 1103, 170, 171, 172, 173, 174, 175, 200, 201, 202, 203, 204, 1028, 1028, 1028, 1028, 1028, 1028, 227, 228, 229, 230, 231, 143, 144, 145, 146, 147, 148, 238, 239, 256, 257, 331, 1028, 1028, 1028, 1028, 1028, 1028, 163, 164, 165, 166, 167, 1106, 1165, 1165, 1165, 1165, 1165, 1165, 1165, 1165, 1165, 1165, 1165, 1165, 1165, 1165, 1165, 1165, 1165, 1165, 1165, 1165
1121, 1121, 1121, 1121, 1121, 1121, 1121, 1121, 1121, 1121, 1121, 1121, 1121, 1121, 1103, 202, 203, 204, 205, 206, 207, 258, 259, 260, 261, 262, 1028, 1028, 1028, 1028, 1028, 1028, 269, 270, 271, 288, 289, 175, 176, 177, 178, 179, 180, 296, 297, 298, 299, 363, 1028, 1028, 1028, 1028, 1028, 1028, 205, 206, 207, 224, 225, 1106, 1165, 1165, 1165, 1165, 1165, 1165, 1165, 1165, 1165, 1165, 1165, 1165, 1165, 1165, 1165, 1165, 1165, 1165, 1165, 1165
1121, 1121, 1121, 1121, 1121, 1121, 1121, 1121, 1121, 1121, 1121, 1121, 1121, 1121, 1103, 234, 235, 236, 237, 238, 239, 300, 301, 302, 303, 320, 1028, 1028, 1028, 1028, 1028, 1028, 327, 328, 329, 330, 331, 207, 208, 209, 210, 211, 212, 354, 355, 356, 357, 395, 1028, 1028, 1028, 1028, 1028, 1028, 263, 264, 265, 266, 267, 1106, 1165, 1165, 1165, 1165, 1165, 1165, 1165, 1165, 1165, 1165, 1165, 1165, 1165, 1165, 1165, 1165, 1165, 1165, 1165, 1165
1121, 1121, 1121, 1121, 1121, 1121, 1121, 1121, 1121, 1121, 1121, 1121, 1121, 1121, 1103, 266, 267, 268, 269, 270, 271, 358, 359, 360, 361, 362, 1028, 1028, 1028, 1028, 1028, 1028, 385, 386, 387, 388, 389, 239, 240, 241, 242, 243, 244, 396, 397, 398, 399, 427, 1028, 1028, 1028, 1028, 1028, 1028, 321, 322, 323, 324, 325, 1106, 1165, 1165, 1165, 1165, 1165, 1165, 1165, 1165, 1165, 1165, 1165, 1165, 1165, 1165, 1165, 1165, 1165, 1165, 1165, 1165
1121, 1121, 1121, 1121, 1121, 1121, 1121, 1121, 1121, 1121, 1121, 1121, 1121, 1121, 1103, 298, 299, 300, 301, 302, 303, 416, 417, 418, 419, 420, 1028, 1028, 1028, 1028, 1028, 1028, 427, 428, 429, 430, 431, 271, 272, 273, 274, 275, 276, 454, 455, 456, 457, 135, 136, 358, 359, 360, 361, 362, 363, 364, 365, 366, 367, 1106, 1165, 1165, 1165, 1165, 1165, 1165, 1165, 1165, 1165, 1165, 1165, 1165, 1165, 1165, 1165, 1165, 1165, 1165, 1165, 1165
1121, 1121, 1121, 1121, 1121, 1121, 1121, 1121, 1121, 1121, 1121, 1121, 1121, 1121, 1103, 330, 331, 332, 333, 334, 335, 458, 459, 460, 461, 462, 463, 480, 481, 482, 483, 484, 485, 486, 487, 488, 489, 490, 491, 492, 493, 494, 495, 0, 1, 2, 3, 167, 168, 416, 417, 418, 419, 420, 421, 422, 423, 424, 425, 1106, 1165, 1165, 1165, 1165, 1165, 1165, 1165, 1165, 1165, 1165, 1165, 1165, 1165, 1165, 1165, 1165, 1165, 1165, 1165, 1165
1121, 1121, 1121, 1121, 1121, 1121, 1121, 1121, 1121, 1121, 1121, 1121, 1121, 1121, 1103, 170, 171, 172, 173, 174, 175, 4, 5, 6, 7, 8, 9, 10, 11, 12, 13, 14, 15, 32, 33, 34, 35, 36, 37, 38, 39, 40, 41, 42, 43, 44, 45, 199, 200, 458, 459, 460, 461, 462, 463, 480, 481, 482, 239, 1106, 1165, 1165, 1165, 1165, 1165, 1165, 1165, 1165, 1165, 1165, 1165, 1165, 1165, 1165, 1165, 1165, 1165, 1165, 1165, 1165
1121, 1121, 1121, 1121, 1121, 1121, 1121, 1121, 1121, 1121, 1121, 1121, 1121, 1121, 1103, 1053, 203, 204, 205, 206, 207, 458, 47, 64, 65, 66, 67, 68, 69, 70, 71, 72, 73, 74, 75, 76, 77, 78, 79, 96, 97, 98, 99, 100, 101, 102, 103, 231, 232, 4, 5, 6, 7, 8, 9, 10, 11, 12, 13, 1106, 1165, 1165, 1165, 1165, 1165, 1165, 1165, 1165, 1165, 1165, 1165, 1165, 1165, 1165, 1165, 1165, 1165, 1165, 1165, 1165
1121, 1121, 1121, 1121, 1121, 1121, 1121, 1121, 1121, 1121, 1121, 1121, 1121, 1121, 1103, 234, 235, 236, 237, 238, 239, 137, 105, 106, 107, 108, 109, 110, 111, 128, 129, 130, 131, 132, 133, 134, 135, 136, 137, 138, 139, 140, 141, 142, 143, 160, 161, 263, 264, 46, 47, 64, 65, 66, 67, 68, 69, 70, 71, 1106, 1165, 1165, 1165, 1165, 1165, 1165, 1165, 1165, 1165, 1165, 1165, 1165, 1165, 1165, 1165, 1165, 1165, 1165, 1165, 1165
1121, 1121, 1121, 1121, 1121, 1121, 1121, 1121, 1121, 1121, 1121, 1121, 1121, 1121, 1103, 266, 267, 268, 269, 270, 271, 162, 163, 164, 165, 166, 167, 168, 169, 170, 171, 172, 173, 174, 175, 192, 193, 194, 195, 196, 197, 198, 199, 200, 201, 202, 203, 295, 296, 104, 105, 106, 107, 108, 109, 110, 111, 128, 1053, 1106, 1165, 1165, 1165, 1165, 1165, 1165, 1165, 1165, 1165, 1165, 1165, 1165, 1165, 1165, 1165, 1165, 1165, 1165, 1165, 1165
1121, 1121, 1121, 1121, 1121, 1121, 1121, 1121, 1121, 1121, 1121, 1121, 1121, 1121, 1103, 298, 299, 300, 301, 302, 303, 204, 205, 206, 207, 224, 1028, 1028, 1028, 1028, 1028, 1028, 231, 232, 233, 234, 235, 1028, 1028, 1028, 1028, 1028, 1028, 258, 259, 260, 261, 327, 1028, 1028, 1028, 1028, 1028, 1028, 167, 168, 169, 170, 171, 1106, 1165, 1165, 1165, 1165, 1165, 1165, 1165, 1165, 1165, 1165, 1165, 1165, 1165, 1165, 1165, 1165, 1165, 1165, 1165, 1165
1121, 1121, 1121, 1121, 1121, 1121, 1121, 1121, 1121, 1121, 1121, 1121, 1121, 1121, 1103, 330, 331, 332, 333, 334, 335, 262, 263, 264, 265, 266, 1028, 1028, 1028, 1028, 1028, 1028, 289, 290, 291, 292, 293, 1028, 1028, 1028, 1028, 1028, 1028, 300, 301, 302, 956, 957, 1028, 1028, 1028, 1028, 1028, 1028, 225, 226, 227, 228, 229, 1106, 1165, 1165, 1165, 1165, 1165, 1165, 1165, 1165, 1165, 1165, 1165, 1165, 1165, 1165, 1165, 1165, 1165, 1165, 1165, 1165
1121, 1121, 1121, 1121, 1121, 1121, 1121, 1121, 1121, 1121, 1121, 1121, 1121, 1121, 1103, 170, 171, 172, 173, 174, 175, 320, 321, 322, 323, 324, 1028, 1028, 1028, 1028, 1028, 1028, 331, 332, 333, 334, 335, 1028, 1028, 1028, 1028, 1028, 1028, 358, 359, 360, 988, 989, 1028, 1028, 1028, 1028, 1028, 1028, 267, 268, 269, 270, 271, 1106, 1165, 1165, 1165, 1165, 1165, 1165, 1165, 1165, 1165, 1165, 1165, 1165, 1165, 1165, 1165, 1165, 1165, 1165, 1165, 1165
1121, 1121, 1121, 1121, 1121, 1121, 1121, 1121, 1121, 1121, 1121, 1121, 1121, 1121, 1103, 202, 203, 204, 205, 206, 207, 362, 363, 364, 365, 366, 1028, 1028, 1028, 1028, 1028, 1028, 389, 390, 391, 392, 393, 1028, 1028, 1028, 1028, 1028, 1028, 416, 417, 418, 419, 177, 1028, 1028, 1028, 1028, 1028, 1028, 325, 326, 327, 328, 329, 1106, 1165, 1165, 1165, 1165, 1165, 1165, 1165, 1165, 1165, 1165, 1165, 1165, 1165, 1165, 1165, 1165, 1165, 1165, 1165, 1165
1121, 1121, 1121, 1121, 1121, 1121, 1121, 1121, 1121, 1121, 1121, 1121, 1121, 1121, 1103, 234, 235, 236, 237, 238, 239, 420, 421, 422, 423, 424, 1028, 1028, 1028, 1028, 1028, 1028, 431, 448, 449, 450, 451, 1028, 1028, 1028, 1028, 1028, 1028, 458, 459, 460, 461, 209, 1028, 1028, 1028, 1028, 1028, 1028, 367, 384, 385, 386, 387, 1106, 1165, 1165, 1165, 1165, 1165, 1165, 1165, 1165, 1165, 1165, 1165, 1165, 1165, 1165, 1165, 1165, 1165, 1165, 1165, 1165
1121, 1121, 1121, 1121, 1121, 1121, 1121, 1121, 1121, 1121, 1121, 1121, 1121, 1121, 1103, 266, 267, 268, 269, 270, 271, 462, 463, 480, 481, 482, 1028, 1028, 1028, 1028, 1028, 1028, 489, 490, 491, 492, 493, 1028, 1028, 1028, 1028, 1028, 1028, 4, 5, 6, 7, 241, 1028, 1028, 1028, 1028, 1028, 1028, 425, 426, 427, 428, 429, 1106, 1165, 1165, 1165, 1165, 1165, 1165, 1165, 1165, 1165, 1165, 1165, 1165, 1165, 1165, 1165, 1165, 1165, 1165, 1165, 1165
1121, 1121, 1121, 1121, 1121, 1121, 1121, 1121, 1121, 1121, 1121, 1121, 1121, 1121, 1103, 298, 299, 300, 301, 302, 303, 8, 9, 10, 11, 12, 1028, 1028, 1028, 1028, 1028, 1028, 35, 36, 37, 38, 39, 1028, 1028, 1028, 1028, 1028, 1028, 46, 47, 64, 65, 273, 1028, 1028, 1028, 1028, 1028, 1028, 483, 484, 485, 486, 487, 1106, 1165, 1165, 1165, 1165, 1165, 1165, 1165, 1165, 1165, 1165, 1165, 1165, 1165, 1165, 1165, 1165, 1165, 1165, 1165, 1165
1121, 1121, 1121, 1121, 1121, 1121, 1121, 1121, 1121, 1121, 1121, 1121, 1121, 1121, 1103, 330, 331, 332, 333, 334, 335, 66, 67, 68, 69, 70, 1028, 1028, 1028, 1028, 1028, 1028, 77, 78, 79, 96, 97, 1028, 1028, 1028, 1028, 1028, 1028, 104, 105, 106, 107, 305, 1028, 1028, 1028, 1028, 1028, 1028, 13, 14, 15, 32, 33, 1106, 1165, 1165, 1165, 1165, 1165, 1165, 1165, 1165, 1165, 1165, 1165, 1165, 1165, 1165, 1165, 1165, 1165, 1165, 1165, 1165
1121, 1121, 1121, 1121, 1121, 1121, 1121, 1121, 1121, 1121, 1121, 1121, 1121, 1121, 1103, 170, 171, 172, 173, 174, 175, 108, 109, 110, 111, 128, 129, 130, 131, 132, 133, 134, 135, 136, 137, 138, 139, 140, 141, 142, 143, 160, 161, 162, 163, 164, 165, 337, 334, 66, 67, 68, 69, 70, 71, 72, 73, 74, 75, 1106, 1165, 1165, 1165, 1165, 1165, 1165, 1165, 1165, 1165, 1165, 1165, 1165, 1165, 1165, 1165, 1165, 1165, 1165, 1165, 1165
1121, 1121, 1121, 1121, 1121, 1121, 1121, 1121, 1121, 1121, 1121, 1121, 1121, 1121, 1103, 202, 203, 204, 205, 206, 207, 166, 167, 168, 169, 170, 956, 957, 956, 957, 956, 957, 193, 194, 195, 196, 197, 198, 199, 200, 201, 202, 203, 204, 205, 206, 207, 369, 366, 108, 109, 110, 111, 128, 129, 130, 131, 132, 133, 1106, 1165, 1165, 1165, 1165, 1165, 1165, 1165, 1165, 1165, 1165, 1165, 1165, 1165, 1165, 1165, 1165, 1165, 1165, 1165, 1165
1121, 1121, 1121, 1121, 1121, 1121, 1121, 1121, 1121, 1121, 1121, 1121, 1121, 1121, 1103, 234, 235, 236, 237, 238, 239, 224, 225, 226, 227, 228, 988, 989, 988, 989, 988, 989, 235, 236, 237, 238, 239, 256, 257, 258, 259, 260, 261, 262, 263, 264, 265, 401, 398, 166, 167, 168, 169, 170, 171, 172, 173, 174, 175, 1106, 1165, 1165, 1165, 1165, 1165, 1165, 1165, 1165, 1165, 1165, 1165, 1165, 1165, 1165, 1165, 1165, 1165, 1165, 1165, 1165
1121, 1121, 1121, 1121, 1121, 1121, 1121, 1121, 1121, 1121, 1121, 1121, 1121, 1121, 1103, 266, 267, 396, 396, 396, 396, 266, 267, 268, 269, 270, 271, 288, 289, 290, 291, 292, 293, 294, 295, 296, 297, 298, 299, 300, 301, 302, 303, 320, 0, 1, 1053, 3, 4, 5, 6, 7, 8, 9, 10, 11, 12, 13, 14, 1106, 1165, 1165, 1165, 1165, 1165, 1165, 1165, 1165, 1165, 1165, 1165, 1165, 1165, 1165, 1165, 1165, 1165, 1165, 1165, 1165
1121, 1121, 1121, 1121, 1121, 1121, 1121, 1121, 1121, 1121, 1121, 1121, 1121, 1121, 1057, 1061, 1061, 1061, 1061, 1061, 1061, 1062, 1063, 1064, 1062, 1063, 1064, 1062, 1063, 1064, 1062, 1063, 1064, 1062, 1063, 1064, 1062, 1063, 1064, 1062, 1062, 1063, 1064, 1062, 1063, 1064, 1062, 1063, 1064, 1062, 1063, 1064, 1062, 1063, 1064, 1062, 1063, 1064, 1062, 1068, 1165, 1165, 1165, 1165, 1165, 1165, 1165, 1165, 1165, 1165, 1165, 1165, 1165, 1165, 1165, 1165, 1165, 1165, 1165, 1165
1121, 1121, 1121, 1121, 1121, 1121, 1121, 1121, 1121, 1121, 1121, 1121, 1121, 1121, 1121, 1121, 1121, 1121, 1121, 1121, 1167, 1168, 1169, 1167, 1168, 1169, 1167, 1168, 1169, 1167, 1168, 1169, 1167, 1168, 1169, 1167, 1168, 1169, 1167, 1168, 1169, 1167, 1168, 1169, 1167, 1168, 1169, 1167, 1168, 1169, 1167, 1168, 1169, 1167, 1168, 1169, 1167, 1168, 1169, 1167, 1168, 1169, 1167, 1168, 1169, 1165, 1165, 1165, 1165, 1165, 1165, 1165, 1165, 1165, 1165, 1165, 1165, 1165, 1165, 1165
1121, 1121, 1121, 1121, 1121, 1121, 1121, 1121, 1121, 1121, 1121, 1121, 1121, 1121, 1121, 1121, 1121, 1121, 1121, 1121, 1167, 1168, 1169, 1167, 1168, 1169, 1167, 1168, 1169, 1167, 1168, 1169, 1167, 1168, 1169, 1167, 1168, 1169, 1167, 1168, 1169, 1167, 1168, 1169, 1167, 1168, 1169, 1167, 1168, 1169, 1167, 1168, 1169, 1167, 1168, 1169, 1167, 1168, 1169, 1167, 1168, 1169, 1167, 1168, 1169, 1165, 1165, 1165, 1165, 1165, 1165, 1165, 1165, 1165, 1165, 1165, 1165, 1165, 1165, 1165
1121, 1121, 1121, 1121, 1121, 1121, 1121, 1121, 1121, 1121, 1121, 1121, 1121, 1121, 1121, 1121, 1121, 1121, 1121, 1121, 1167, 1168, 1169, 1167, 1168, 1169, 1167, 1168, 1169, 1167, 1168, 1169, 1167, 1168, 1169, 1167, 1168, 1169, 1167, 1168, 1169, 1167, 1168, 1169, 1167, 1168, 1169, 1167, 1168, 1169, 1167, 1168, 1169, 1167, 1168, 1169, 1167, 1168, 1169, 1167, 1168, 1169, 1167, 1168, 1169, 1165, 1165, 1165, 1165, 1165, 1165, 1165, 1165, 1165, 1165, 1165, 1165, 1165, 1165, 1165
1121, 1121, 1121, 1121, 1121, 1121, 1121, 1121, 1121, 1121, 1121, 1121, 1121, 1121, 1121, 1121, 1121, 1121, 1121, 1121, 1167, 1168, 1169, 1167, 1168, 1169, 1167, 1168, 1169, 1167, 1168, 1169, 1167, 1168, 1169, 1167, 1168, 1169, 1167, 1168, 1169, 1167, 1168, 1169, 1167, 1168, 1169, 1167, 1168, 1169, 1167, 1168, 1169, 1167, 1168, 1169, 1167, 1168, 1169, 1167, 1168, 1169, 1167, 1168, 1169, 1121, 1121, 1121, 1121, 1121, 1121, 1121, 1121, 1121, 1121, 1121, 1121, 1121, 1121, 1121
1121, 1121, 1121, 1121, 1121, 1121, 1121, 1121, 1121, 1121, 1121, 1121, 1121, 1121, 1121, 1121, 1121, 1121, 1121, 1121, 1121, 1121, 1121, 1121, 1121, 1121, 1121, 1121, 1121, 1121, 1121, 1121, 1121, 1121, 1121, 1121, 1121, 1121, 1121, 1121, 1121, 1121, 1121, 1121, 1121, 1121, 1121, 1121, 1121, 1121, 1121, 1121, 1121, 1121, 1121, 1121, 1121, 1121, 1121, 1121, 1121, 1121, 1121, 1121, 1121, 1121, 1121, 1121, 1121, 1121, 1121, 1121, 1121, 1121, 1121, 1121, 1121, 1121, 1121, 1121
