1168, 1168, 1168, 1168, 1168, 1168, 1168, 1168, 1168, 1168, 1168, 1168, 1168, 1168, 1168, 1168, 1168, 1168, 1168, 1168, 1168, 1168, 1168, 1168, 1168, 1168, 1168, 1168, 1168, 1168, 1168, 1168, 1168, 1168, 1168, 1168, 1168, 1168, 1168, 1168, 1168, 1168, 1165, 1165, 1165, 1165, 1165, 1165, 1165, 1165, 1165, 1165, 1165, 1165, 1165, 1165, 1165, 1165, 1165, 1165, 1165, 1165, 1165, 1165, 1165, 1165, 1165, 1165, 1165, 1165, 1165, 1165, 1165, 1165, 1165, 1165, 1165, 1165, 1165, 1165
1168, 1168, 1168, 1168, 1168, 1168, 1168, 1168, 1168, 1168, 1168, 1168, 1168, 1168, 1168, 1168, 1168, 1168, 1168, 1168, 1168, 1168, 1168, 1168, 1168, 1168, 1168, 1168, 1168, 1168, 1168, 1168, 1168, 1168, 1168, 1168, 1168, 1168, 1168, 1168, 1168, 1168, 1165, 1165, 1165, 1165, 1165, 1165, 1165, 1165, 1165, 1165, 1165, 1165, 1165, 1165, 1165, 1165, 1165, 1165, 1165, 1165, 1165, 1165, 1165, 1165, 1165, 1165, 1165, 1165, 1165, 1165, 1165, 1165, 1165, 1165, 1165, 1165, 1165, 1165
1168, 1168, 1168, 1168, 1168, 1168, 1168, 1168, 1168, 1168, 1168, 1168, 1168, 1168, 1168, 1168, 1168, 1168, 1168, 896, 897, 898, 899, 900, 901, 902, 903, 904, 905, 906, 907, 908, 909, 910, 903, 904, 905, 906, 907, 903, 904, 905, 906, 907, 908, 909, 910, 911, 912, 913, 914, 915, 916, 917, 918, 1165, 1165, 1165, 1165, 1165, 1165, 1165, 1165, 1165, 1165, 1165, 1165, 1165, 1165, 1165, 1165, 1165, 1165, 1165, 1165, 1165, 1165, 1165, 1165, 1165
1168, 1168, 1168, 1168, 1168, 1168, 1168, 1168, 1168, 1168, 1168, 1168, 1168, 1168, 1168, 1168, 1168, 1168, 896, 897, 898, 899, 900, 901, 902, 903, 904, 905, 906, 907, 908, 909, 910, 911, 903, 904, 905, 906, 907, 903, 904, 905, 906, 907, 908, 909, 910, 911, 912, 913, 914, 915, 916, 917, 918, 915, 916, 917, 918, 919, 920, 921, 922, 923, 924, 925, 926, 927, 1165, 1165, 1165, 1165, 1165, 1165, 1165, 1165, 1165, 1165, 1165, 1165
1168, 1168, 1168, 1168, 1168, 1168, 1168, 1168, 1168, 1168, 1168, 1168, 1168, 1168, 1168, 1168, 1168, 1168, 928, 929, 930, 931, 932, 933, 934, 935, 936, 937, 938, 939, 940, 941, 942, 943, 935, 936, 937, 938, 939, 935, 936, 937, 938, 939, 940, 941, 942, 943, 944, 945, 946, 947, 948, 949, 950, 947, 948, 949, 950, 951, 952, 953, 954, 955, 956, 957, 958, 959, 1165, 1165, 1165, 1165, 1165, 1165, 1165, 1165, 1165, 1165, 1165, 1165
1168, 1168, 1168, 1168, 1168, 1168, 1168, 1168, 1168, 1168, 1168, 1168, 1168, 1168, 1168, 1168, 1168, 1168, 960, 961, 962, 963, 964, 965, 966, 967, 968, 969, 970, 971, 972, 973, 974, 975, 967, 968, 969, 970, 971, 967, 968, 969, 970, 971, 972, 973, 974, 975, 976, 977, 978, 979, 980, 981, 982, 979, 980, 981, 982, 983, 984, 985, 1747, 1748, 988, 989, 990, 991, 1165, 1165, 1165, 1165, 1165, 1165, 1165, 1165, 1165, 1165, 1165, 1165
1168, 1168, 1168, 1168, 1168, 1168, 1168, 1168, 1168, 1168, 1168, 1168, 1168, 1168, 1168, 1168, 1168, 1168, 1088, 1089, 1090, 299, 300, 301, 302, 303, 304, 305, 306, 299, 300, 301, 302, 303, 304, 305, 306, 66, 67, 11, 12, 13, 14, 15, 1747, 1748, 117, 118, 119, 15, 16, 17, 18, 1104, 1103, 1103, 1104, 23, 24, 25, 43, 307, 1779, 1780, 308, 1091, 1092, 1093, 1165, 1165, 1165, 1165, 1165, 1165, 1165, 1165, 1165, 1165, 1165, 1165
1168, 1168, 1168, 1168, 1168, 1168, 1168, 1168, 1168, 1168, 1168, 1168, 1168, 1168, 1168, 1168, 1168, 1168, 1120, 1121, 1122, 331, 332, 333, 334, 335, 336, 337, 338, 331, 332, 333, 334, 335, 336, 337, 338, 98, 99, 48, 49, 50, 51, 52, 1779, 1780, 149, 150, 151, 244, 245, 244, 245, 1104, 1104, 1104, 1104, 244, 245, 245, 244, 339, 1747, 1748, 340, 1123, 1124, 1125, 1165, 1165, 1165, 1165, 1165, 1165, 1165, 1165, 1165, 1165, 1165, 1165
1168, 1168, 1168, 1168, 1168, 1168, 1168, 1168, 1168, 1168, 1168, 1168, 1168, 1168, 1168, 1168, 1168, 1168, 1152, 1153, 1154, 363, 364, 365, 366, 367, 368, 369, 370, 363, 364, 365, 366, 367, 368, 369, 370, 130, 131, 85, 86, 87, 88, 89, 1747, 1748, 181, 182, 183, 276, 277, 276, 277, 276, 277, 276, 277, 276, 277, 277, 307, 308, 1779, 1780, 121, 1155, 1156, 1157, 1165, 1165, 1165, 1165, 1165, 1165, 1165, 1165, 1165, 1165, 1165, 1165
1168, 1168, 1168, 1168, 1168, 1168, 1168, 1168, 1168, 1168, 1168, 1168, 1168, 1168, 1168, 1168, 1168, 1168, 1184, 1185, 1186, 395, 396, 397, 398, 399, 400, 401, 402, 395, 396, 397, 398, 399, 400, 401, 402, 162, 163, 139, 140, 141, 142, 143, 1779, 1780, 213, 214, 215, 143, 144, 145, 146, 147, 148, 149, 150, 151, 152, 153, 339, 340, 339, 340, 175, 1187, 1188, 1189, 1165, 1165, 1165, 1165, 1165, 1165, 1165, 1165, 1165, 1165, 1165, 1165
1168, 1168, 1168, 1168, 1168, 1168, 1168, 1168, 1168, 1168, 1168, 1168, 1168, 1168, 1168, 1168, 1168, 1168, 1216, 1217, 1218, 427, 428, 429, 430, 431, 432, 433, 434, 427, 428, 429, 430, 431, 432, 433, 434, 194, 195, 176, 177, 178, 179, 180, 1747, 1748, 245, 246, 247, 180, 181, 182, 183, 184, 185, 203, 204, 299, 300, 301, 302, 303, 304, 305, 306, 1219, 1220, 1221, 1165, 1165, 1165, 1165, 1165, 1165, 1165, 1165, 1165, 1165, 1165, 1165
1168, 1168, 1168, 1168, 1168, 1168, 1168, 1168, 1168, 1168, 1168, 1168, 1168, 1168, 1168, 1168, 1168, 1168, 1248, 1249, 1250, 459, 460, 461, 462, 463, 464, 465, 466, 459, 460, 461, 462, 463, 464, 465, 466, 226, 227, 213, 214, 215, 216, 217, 1779, 1780, 214, 215, 216, 217, 235, 236, 237, 238, 239, 240, 241, 331, 332, 333, 334, 335, 336, 337, 338, 1251, 1252, 1253, 1165, 1165, 1165, 1165, 1165, 1165, 1165, 1165, 1165, 1165, 1165, 1165
1168, 1168, 1168, 1168, 1168, 1168, 1168, 1168, 1168, 1168, 1168, 1168, 1168, 1168, 1168, 1168, 1168, 1168, 1280, 1281, 1282, 491, 492, 493, 494, 495, 496, 497, 498, 491, 492, 493, 494, 495, 496, 497, 498, 258, 259, 267, 268, 269, 270, 271, 1747, 1748, 268, 269, 270, 271, 272, 273, 274, 275, 276, 277, 278, 363, 364, 365, 366, 367, 368, 369, 370, 1283, 1284, 1285, 1165, 1165, 1165, 1165, 1165, 1165, 1165, 1165, 1165, 1165, 1165, 1165
1168, 1168, 1168, 1168, 1168, 1168, 1168, 1168, 1168, 1168, 1168, 1168, 1168, 1168, 1168, 1168, 1168, 1168, 1312, 1313, 1314, 523, 524, 525, 526, 527, 528, 529, 530, 523, 524, 525, 526, 527, 528, 529, 530, 290, 291, 304, 305, 306, 307, 308, 1779, 1780, 305, 306, 307, 308, 309, 310, 311, 312, 313, 331, 332, 395, 396, 397, 398, 399, 400, 401, 402, 1315, 1316, 1317, 1165, 1165, 1165, 1165, 1165, 1165, 1165, 1165, 1165, 1165, 1165, 1165
1168, 1168, 1168, 1168, 1168, 1168, 1168, 1168, 1168, 1168, 1168, 1168, 1168, 1168, 1168, 1168, 1168, 1168, 1088, 1089, 1090, 174, 174, 358, 359, 360, 361, 362, 299, 300, 301, 302, 303, 304, 305, 306, 321, 322, 323, 341, 342, 343, 344, 345, 1747, 1748, 342, 343, 344, 345, 363, 364, 365, 366, 367, 368, 369, 427, 428, 429, 430, 431, 432, 433, 434, 1091, 1092, 1093, 1165, 1165, 1165, 1165, 1165, 1165, 1165, 1165, 1165, 1165, 1165, 1165
1168, 1168, 1168, 1168, 1168, 1168, 1168, 1168, 1168, 1168, 1168, 1168, 1168, 1168, 1168, 1168, 1168, 1168, 1120, 1121, 1122, 206, 206, 390, 391, 392, 393, 394, 331, 332, 333, 334, 335, 336, 337, 338, 353, 354, 355, 395, 396, 397, 398, 399, 1779, 1780, 396, 397, 398, 399, 400, 401, 402, 403, 404, 405, 406, 459, 460, 461, 462, 463, 464, 465, 466, 1123, 1124, 1125, 1165, 1165, 1165, 1165, 1165, 1165, 1165, 1165, 1165, 1165, 1165, 1165
1168, 1168, 1168, 1168, 1168, 1168, 1168, 1168, 1168, 1168, 1168, 1168, 1168, 1168, 1168, 1168, 1168, 1168, 1152, 1153, 1154, 238, 238, 422, 423, 424, 425, 426, 363, 364, 365, 366, 367, 368, 369, 370, 385, 386, 387, 432, 433, 434, 435, 436, 1747, 1748, 433, 434, 435, 436, 437, 438, 439, 440, 441, 459, 460, 491, 492, 493, 494, 495, 496, 497, 498, 1155, 1156, 1157, 1165, 1165, 1165, 1165, 1165, 1165, 1165, 1165, 1165, 1165, 1165, 1165
1168, 1168, 1168, 1168, 1168, 1168, 1168, 1168, 1168, 1168, 1168, 1168, 1168, 1168, 1168, 1168, 1168, 1168, 1184, 1185, 1186, 270, 270, 454, 455, 456, 457, 458, 395, 396, 397, 398, 399, 400, 401, 402, 417, 418, 419, 469, 470, 471, 472, 473, 1779, 1780, 470, 471, 472, 473, 11, 12, 13, 14, 15, 16, 17, 523, 524, 525, 526, 527, 528, 529, 530, 1187, 1188, 1189, 1165, 1165, 1165, 1165, 1165, 1165, 1165, 1165, 1165, 1165, 1165, 1165
1168, 1168, 1168, 1168, 1168, 1168, 1168, 1168, 1168, 1168, 1168, 1168, 1168, 1168, 1168, 1168, 1168, 1168, 1216, 1217, 1218, 110, 110, 486, 487, 299, 300, 301, 302, 303, 304, 305, 306, 432, 433, 434, 449, 450, 451, 43, 44, 45, 46, 47, 48, 43, 44, 45, 46, 47, 48, 49, 50, 51, 52, 53, 54, 299, 300, 301, 302, 303, 304, 305, 306, 1219, 1220, 1221, 1165, 1165, 1165, 1165, 1165, 1165, 1165, 1165, 1165, 1165, 1165, 1165
1168, 1168, 1168, 1168, 1168, 1168, 1168, 1168, 1168, 1168, 1168, 1168, 1168, 1168, 1168, 1168, 1168, 1168, 1248, 1249, 1250, 142, 142, 38, 39, 331, 332, 333, 334, 335, 336, 337, 338, 464, 465, 466, 481, 482, 483, 80, 81, 82, 83, 84, 85, 80, 81, 82, 83, 84, 85, 86, 87, 88, 89, 107, 108, 331, 332, 333, 334, 335, 336, 337, 338, 1251, 1252, 1253, 1165, 1165, 1165, 1165, 1165, 1165, 1165, 1165, 1165, 1165, 1165, 1165
1168, 1168, 1168, 1168, 1168, 1168, 1168, 1168, 1168, 1168, 1168, 1168, 1168, 1168, 1168, 1168, 1168, 1168, 1280, 1281, 1282, 174, 174, 117, 118, 363, 364, 365, 366, 367, 368, 369, 370, 496, 497, 498, 116, 117, 118, 119, 118, 119, 120, 121, 139, 117, 118, 119, 120, 121, 139, 140, 141, 142, 143, 144, 145, 363, 364, 365, 366, 367, 368, 369, 370, 1283, 1284, 1285, 1165, 1165, 1165, 1165, 1165, 1165, 1165, 1165, 1165, 1165, 1165, 1165
1168, 1168, 1168, 1168, 1168, 1168, 1168, 1168, 1168, 1168, 1168, 1168, 1168, 1168, 1168, 1168, 1168, 1168, 1088, 1089, 1090, 206, 206, 149, 150, 395, 396, 397, 398, 399, 400, 401, 402, 528, 529, 530, 148, 149, 150, 151, 172, 173, 174, 175, 176, 171, 172, 173, 174, 175, 176, 177, 178, 179, 180, 181, 182, 395, 396, 397, 398, 399, 400, 401, 402, 1315, 1316, 1317, 1165, 1165, 1165, 1165, 1165, 1165, 1165, 1165, 1165, 1165, 1165, 1165
1168, 1168, 1168, 1168, 1168, 1168, 1168, 1168, 1168, 1168, 1168, 1168, 1168, 1168, 1168, 1168, 1168, 1168, 1120, 1121, 1122, 238, 238, 181, 182, 427, 428, 429, 430, 431, 432, 433, 434, 182, 183, 179, 180, 181, 182, 183, 118, 119, 211, 212, 213, 208, 209, 210, 211, 212, 213, 214, 215, 216, 217, 235, 236, 427, 428, 429, 430, 431, 432, 433, 434, 1091, 1092, 1093, 1165, 1165, 1165, 1165, 1165, 1165, 1165, 1165, 1165, 1165, 1165, 1165
1168, 1168, 1168, 1168, 1168, 1168, 1168, 1168, 1168, 1168, 1168, 1168, 1168, 1168, 1168, 1168, 1168, 1168, 1152, 1153, 1154, 270, 270, 213, 214, 459, 460, 461, 462, 463, 464, 465, 466, 214, 215, 211, 212, 213, 214, 215, 150, 151, 248, 249, 267, 245, 246, 247, 248, 249, 267, 268, 269, 270, 271, 272, 115, 459, 460, 461, 462, 463, 464, 465, 466, 1123, 1124, 1125, 1165, 1165, 1165, 1165, 1165, 1165, 1165, 1165, 1165, 1165, 1165, 1165
1168, 1168, 1168, 1168, 1168, 1168, 1168, 1168, 1168, 1168, 1168, 1168, 1168, 1168, 1168, 1168, 1168, 1168, 1184, 1185, 1186, 110, 110, 245, 246, 491, 492, 493, 494, 495, 496, 497, 498, 246, 247, 243, 244, 245, 246, 247, 182, 183, 302, 303, 304, 299, 300, 301, 302, 303, 304, 305, 306, 307, 308, 309, 147, 491, 492, 493, 494, 495, 496, 497, 498, 1155, 1156, 1157, 1165, 1165, 1165, 1165, 1165, 1165, 1165, 1165, 1165, 1165, 1165, 1165
1168, 1168, 1168, 1168, 1168, 1168, 1168, 1168, 1168, 1168, 1168, 1168, 1168, 1168, 1168, 1168, 1168, 1168, 1216, 1217, 1218, 142, 142, 354, 355, 523, 524, 525, 526, 527, 528, 529, 530, 262, 263, 264, 265, 211, 212, 213, 214, 215, 339, 340, 341, 336, 770, 770, 770, 340, 770, 770, 343, 770, 770, 363, 179, 523, 524, 525, 526, 527, 528, 529, 530, 1187, 1188, 1189, 1165, 1165, 1165, 1165, 1165, 1165, 1165, 1165, 1165, 1165, 1165, 1165
1168, 1168, 1168, 1168, 1168, 1168, 1168, 1168, 1168, 1168, 1168, 1168, 1168, 1168, 1168, 1168, 1168, 1168, 1248, 1249, 1250, 110, 174, 396, 397, 398, 399, 427, 428, 300, 301, 302, 303, 320, 321, 322, 323, 243, 244, 245, 246, 247, 14, 15, 16, 176, 177, 178, 179, 180, 181, 182, 183, 184, 185, 203, 211, 331, 332, 333, 334, 335, 336, 337, 338, 1219, 1220, 1221, 1165, 1165, 1165, 1165, 1165, 1165, 1165, 1165, 1165, 1165, 1165, 1165
1168, 1168, 1168, 1168, 1168, 1168, 1168, 1168, 1168, 1168, 1168, 1168, 1168, 1168, 1168, 1168, 1168, 1168, 1280, 1281, 1282, 142, 206, 454, 455, 456, 457, 771, 771, 358, 771, 771, 361, 362, 771, 771, 365, 366, 771, 771, 49, 50, 51, 52, 53, 213, 214, 215, 216, 217, 235, 236, 237, 238, 239, 240, 243, 363, 364, 365, 366, 367, 368, 369, 370, 1251, 1252, 1253, 1165, 1165, 1165, 1165, 1165, 1165, 1165, 1165, 1165, 1165, 1165, 1165
1168, 1168, 1168, 1168, 1168, 1168, 1168, 1168, 1168, 1168, 1168, 1168, 1168, 1168, 1168, 1168, 1168, 1168, 1312, 1313, 1314, 174, 238, 0, 1, 2, 3, 167, 168, 416, 417, 418, 419, 420, 421, 422, 423, 424, 425, 85, 86, 87, 88, 89, 107, 267, 268, 269, 270, 271, 272, 273, 274, 275, 276, 277, 278, 395, 396, 397, 398, 399, 400, 401, 402, 1283, 1284, 1285, 1165, 1165, 1165, 1165, 1165, 1165, 1165, 1165, 1165, 1165, 1165, 1165
1168, 1168, 1168, 1168, 1168, 1168, 1168, 1168, 1168, 1168, 1168, 1168, 1168, 1168, 1168, 1168, 1168, 1168, 1120, 1121, 1122, 206, 270, 42, 43, 44, 45, 199, 200, 458, 459, 460, 461, 462, 463, 480, 481, 482, 483, 139, 140, 141, 142, 143, 144, 304, 305, 306, 307, 308, 309, 310, 311, 312, 313, 331, 332, 427, 428, 429, 430, 431, 432, 433, 434, 1315, 1316, 1317, 1165, 1165, 1165, 1165, 1165, 1165, 1165, 1165, 1165, 1165, 1165, 1165
1168, 1168, 1168, 1168, 1168, 1168, 1168, 1168, 1168, 1168, 1168, 1168, 1168, 1168, 1168, 1168, 1168, 1168, 1152, 1153, 1154, 238, 110, 100, 101, 299, 300, 301, 302, 303, 304, 305, 299, 300, 301, 302, 303, 304, 305, 306, 177, 178, 179, 180, 181, 341, 342, 343, 344, 345, 363, 364, 365, 366, 367, 368, 369, 459, 460, 461, 462, 463, 464, 465, 466, 1091, 1092, 1093, 1165, 1165, 1165, 1165, 1165, 1165, 1165, 1165, 1165, 1165, 1165, 1165
1168, 1168, 1168, 1168, 1168, 1168, 1168, 1168, 1168, 1168, 1168, 1168, 1168, 1168, 1168, 1168, 1168, 1168, 1184, 1185, 1186, 270, 141, 142, 143, 331, 332, 333, 334, 335, 336, 337, 331, 332, 333, 334, 335, 336, 337, 338, 214, 215, 216, 217, 235, 395, 396, 397, 398, 399, 400, 401, 402, 403, 404, 405, 406, 491, 492, 493, 494, 495, 496, 497, 498, 1123, 1124, 1125, 1165, 1165, 1165, 1165, 1165, 1165, 1165, 1165, 1165, 1165, 1165, 1165
1168, 1168, 1168, 1168, 1168, 1168, 1168, 1168, 1168, 1168, 1168, 1168, 1168, 1168, 1168, 1168, 1168, 1168, 1216, 1217, 1218, 110, 199, 200, 201, 363, 364, 365, 366, 367, 368, 369, 363, 364, 365, 366, 367, 368, 369, 370, 268, 269, 270, 271, 272, 432, 433, 434, 435, 436, 437, 438, 439, 440, 441, 459, 460, 523, 524, 525, 526, 527, 528, 529, 530, 1155, 1156, 1157, 1165, 1165, 1165, 1165, 1165, 1165, 1165, 1165, 1165, 1165, 1165, 1165
1168, 1168, 1168, 1168, 1168, 1168, 1168, 1168, 1168, 1168, 1168, 1168, 1168, 1168, 1168, 1168, 1168, 1168, 1248, 1249, 1250, 142, 257, 258, 259, 395, 396, 397, 398, 399, 400, 401, 395, 396, 397, 398, 399, 400, 401, 402, 305, 306, 307, 308, 309, 469, 470, 471, 472, 473, 11, 12, 13, 14, 15, 16, 17, 299, 300, 301, 302, 303, 304, 305, 306, 1187, 1188, 1189, 1165, 1165, 1165, 1165, 1165, 1165, 1165, 1165, 1165, 1165, 1165, 1165
1168, 1168, 1168, 1168, 1168, 1168, 1168, 1168, 1168, 1168, 1168, 1168, 1168, 1168, 1168, 1168, 1168, 1168, 1280, 1281, 1282, 174, 299, 300, 301, 427, 428, 429, 430, 431, 432, 433, 427, 428, 429, 430, 431, 432, 433, 434, 342, 343, 344, 345, 363, 43, 44, 45, 46, 47, 48, 49, 50, 51, 52, 53, 54, 331, 332, 333, 334, 335, 336, 337, 338, 1219, 1220, 1221, 1165, 1165, 1165, 1165, 1165, 1165, 1165, 1165, 1165, 1165, 1165, 1165
1168, 1168, 1168, 1168, 1168, 1168, 1168, 1168, 1168, 1168, 1168, 1168, 1168, 1168, 1168, 1168, 1168, 1168, 1312, 1313, 1314, 206, 357, 358, 359, 459, 460, 461, 462, 463, 464, 465, 459, 460, 461, 462, 463, 464, 465, 466, 396, 397, 398, 399, 400, 80, 770, 770, 770, 84, 770, 770, 87, 770, 770, 107, 108, 363, 364, 365, 366, 367, 368, 369, 370, 1251, 1252, 1253, 1165, 1165, 1165, 1165, 1165, 1165, 1165, 1165, 1165, 1165, 1165, 1165
1168, 1168, 1168, 1168, 1168, 1168, 1168, 1168, 1168, 1168, 1168, 1168, 1168, 1168, 1168, 1168, 1168, 1168, 1152, 1153, 1154, 238, 399, 416, 417, 491, 492, 493, 494, 495, 496, 497, 491, 492, 493, 494, 495, 496, 497, 498, 433, 434, 435, 436, 437, 117, 118, 119, 120, 121, 139, 140, 141, 142, 143, 144, 145, 395, 396, 397, 398, 399, 400, 401, 402, 1283, 1284, 1285, 1165, 1165, 1165, 1165, 1165, 1165, 1165, 1165, 1165, 1165, 1165, 1165
1168, 1168, 1168, 1168, 1168, 1168, 1168, 1168, 1168, 1168, 1168, 1168, 1168, 1168, 1168, 1168, 1168, 1168, 1184, 1185, 1186, 270, 457, 458, 459, 523, 524, 525, 526, 527, 528, 529, 523, 524, 525, 526, 527, 528, 529, 530, 470, 471, 472, 473, 11, 171, 172, 173, 174, 175, 176, 177, 178, 179, 180, 181, 182, 299, 300, 301, 302, 303, 304, 305, 306, 1315, 1316, 1317, 1165, 1165, 1165, 1165, 1165, 1165, 1165, 1165, 1165, 1165, 1165, 1165
1168, 1168, 1168, 1168, 1168, 1168, 1168, 1168, 1168, 1168, 1168, 1168, 1168, 1168, 1168, 1168, 1168, 1168, 1216, 1217, 1218, 110, 3, 4, 5, 6, 7, 241, 238, 420, 421, 422, 423, 424, 425, 426, 427, 428, 429, 43, 44, 45, 46, 47, 48, 208, 299, 300, 301, 302, 303, 304, 299, 300, 301, 302, 303, 304, 305, 306, 334, 335, 336, 337, 338, 1091, 1092, 1093, 1165, 1165, 1165, 1165, 1165, 1165, 1165, 1165, 1165, 1165, 1165, 1165
1168, 1168, 1168, 1168, 1168, 1168, 1168, 1168, 1168, 1168, 1168, 1168, 1168, 1168, 1168, 1168, 1168, 1168, 1248, 1249, 1250, 142, 45, 46, 47, 64, 65, 273, 270, 462, 463, 480, 481, 482, 483, 484, 485, 486, 487, 11, 12, 13, 14, 15, 16, 245, 331, 332, 333, 334, 335, 336, 331, 332, 333, 334, 335, 336, 337, 338, 366, 367, 368, 369, 370, 1123, 1124, 1125, 1165, 1165, 1165, 1165, 1165, 1165, 1165, 1165, 1165, 1165, 1165, 1165
1168, 1168, 1168, 1168, 1168, 1168, 1168, 1168, 1168, 1168, 1168, 1168, 1168, 1168, 1168, 1168, 1168, 1168, 1280, 1281, 1282, 174, 103, 104, 105, 106, 107, 305, 302, 8, 9, 10, 11, 12, 13, 14, 15, 32, 33, 48, 49, 50, 51, 52, 53, 299, 363, 364, 365, 366, 367, 368, 363, 364, 365, 366, 367, 368, 369, 370, 398, 399, 400, 401, 402, 1155, 1156, 1157, 1165, 1165, 1165, 1165, 1165, 1165, 1165, 1165, 1165, 1165, 1165, 1165
1168, 1168, 1168, 1168, 1168, 1168, 1168, 1168, 1168, 1168, 1168, 1168, 1168, 1168, 1168, 1168, 1168, 1168, 1312, 1313, 1314, 206, 161, 162, 163, 164, 165, 771, 771, 66, 771, 771, 69, 771, 771, 72, 73, 771, 771, 85, 86, 87, 88, 89, 107, 336, 395, 396, 397, 398, 399, 400, 395, 396, 397, 398, 399, 400, 401, 402, 430, 431, 432, 433, 434, 1187, 1188, 1189, 1165, 1165, 1165, 1165, 1165, 1165, 1165, 1165, 1165, 1165, 1165, 1165
1168, 1168, 1168, 1168, 1168, 1168, 1168, 1168, 1168, 1168, 1168, 1168, 1168, 1168, 1168, 1168, 1168, 1168, 1088, 1089, 1090, 238, 203, 204, 205, 206, 207, 369, 366, 108, 109, 110, 111, 128, 129, 130, 131, 132, 133, 139, 140, 141, 142, 143, 144, 139, 427, 428, 429, 430, 431, 432, 427, 428, 429, 430, 431, 432, 433, 434, 462, 463, 464, 465, 466, 1219, 1220, 1221, 1165, 1165, 1165, 1165, 1165, 1165, 1165, 1165, 1165, 1165, 1165, 1165
1168, 1168, 1168, 1168, 1168, 1168, 1168, 1168, 1168, 1168, 1168, 1168, 1168, 1168, 1168, 1168, 1168, 1168, 1088, 1089, 1090, 270, 261, 262, 263, 264, 265, 401, 398, 166, 167, 168, 169, 170, 171, 172, 173, 174, 175, 176, 177, 178, 179, 180, 181, 176, 459, 460, 461, 462, 463, 464, 459, 460, 461, 462, 463, 464, 465, 466, 494, 495, 496, 497, 498, 1251, 1252, 1253, 1165, 1165, 1165, 1165, 1165, 1165, 1165, 1165, 1165, 1165, 1165, 1165
1168, 1168, 1168, 1168, 1168, 1168, 1168, 1168, 1168, 1168, 1168, 1168, 1168, 1168, 1168, 1168, 1168, 1168, 1120, 1121, 1122, 110, 303, 320, 0, 1, 2, 3, 4, 5, 6, 7, 8, 9, 10, 11, 12, 13, 14, 213, 214, 215, 216, 217, 235, 213, 491, 492, 493, 494, 495, 496, 491, 492, 493, 494, 495, 496, 497, 498, 526, 527, 528, 529, 530, 1283, 1284, 1285, 1165, 1165, 1165, 1165, 1165, 1165, 1165, 1165, 1165, 1165, 1165, 1165
1168, 1168, 1168, 1168, 1168, 1168, 1168, 1168, 1168, 1168, 1168, 1168, 1168, 1168, 1168, 1168, 1168, 1168, 1152, 1153, 1154, 142, 116, 117, 118, 119, 116, 117, 118, 119, 115, 116, 117, 118, 119, 117, 118, 119, 72, 267, 268, 269, 270, 271, 272, 267, 523, 524, 525, 526, 527, 528, 523, 524, 525, 526, 527, 528, 529, 530, 299, 300, 301, 302, 303, 1315, 1316, 1317, 1165, 1165, 1165, 1165, 1165, 1165, 1165, 1165, 1165, 1165, 1165, 1165
1168, 1168, 1168, 1168, 1168, 1168, 1168, 1168, 1168, 1168, 1168, 1168, 1168, 1168, 1168, 1168, 1168, 1168, 1184, 1185, 1186, 174, 148, 149, 150, 151, 148, 149, 150, 151, 147, 299, 300, 301, 302, 303, 304, 305, 306, 118, 119, 306, 307, 308, 309, 304, 305, 306, 307, 308, 427, 428, 429, 430, 431, 432, 433, 434, 334, 335, 336, 337, 338, 339, 340, 1091, 1092, 1093, 1165, 1165, 1165, 1165, 1165, 1165, 1165, 1165, 1165, 1165, 1165, 1165
1168, 1168, 1168, 1168, 1168, 1168, 1168, 1168, 1168, 1168, 1168, 1168, 1168, 1168, 1168, 1168, 1168, 1168, 1216, 1217, 1218, 206, 180, 181, 182, 183, 180, 181, 182, 183, 179, 331, 332, 333, 334, 335, 336, 337, 338, 150, 151, 343, 344, 345, 1747, 1748, 1725, 1726, 344, 345, 459, 460, 461, 462, 463, 464, 465, 466, 371, 372, 373, 374, 375, 376, 377, 1123, 1124, 1125, 1165, 1165, 1165, 1165, 1165, 1165, 1165, 1165, 1165, 1165, 1165, 1165
1168, 1168, 1168, 1168, 1168, 1168, 1168, 1168, 1168, 1168, 1168, 1168, 1168, 1168, 1168, 1168, 1168, 1168, 1248, 1249, 1250, 238, 212, 213, 214, 215, 212, 213, 214, 215, 211, 363, 364, 365, 366, 367, 368, 369, 370, 182, 183, 397, 398, 399, 1779, 1780, 1757, 1758, 398, 399, 491, 492, 493, 494, 495, 496, 497, 299, 300, 301, 302, 303, 304, 305, 306, 1155, 1156, 1157, 1165, 1165, 1165, 1165, 1165, 1165, 1165, 1165, 1165, 1165, 1165, 1165
1168, 1168, 1168, 1168, 1168, 1168, 1168, 1168, 1168, 1168, 1168, 1168, 1168, 1168, 1168, 1168, 1168, 1168, 1280, 1281, 1282, 270, 244, 245, 246, 247, 244, 245, 246, 247, 243, 395, 396, 397, 398, 399, 400, 401, 402, 214, 215, 434, 435, 436, 1747, 1748, 433, 434, 435, 436, 523, 524, 525, 526, 527, 528, 529, 331, 332, 333, 334, 335, 336, 337, 338, 1187, 1188, 1189, 1165, 1165, 1165, 1165, 1165, 1165, 1165, 1165, 1165, 1165, 1165, 1165
1168, 1168, 1168, 1168, 1168, 1168, 1168, 1168, 1168, 1168, 1168, 1168, 1168, 1168, 1168, 1168, 1168, 1168, 1312, 1313, 1314, 110, 296, 297, 300, 301, 302, 303, 320, 321, 322, 427, 428, 429, 430, 431, 432, 433, 434, 302, 303, 304, 305, 306, 1779, 1780, 470, 471, 472, 473, 11, 12, 13, 14, 15, 16, 17, 363, 364, 365, 366, 367, 368, 369, 370, 1219, 1220, 1221, 1165, 1165, 1165, 1165, 1165, 1165, 1165, 1165, 1165, 1165, 1165, 1165
1168, 1168, 1168, 1168, 1168, 1168, 1168, 1168, 1168, 1168, 1168, 1168, 1168, 1168, 1168, 1168, 1168, 1168, 1088, 1089, 1090, 266, 303, 304, 305, 299, 300, 301, 302, 303, 304, 459, 460, 461, 462, 463, 464, 465, 466, 334, 335, 336, 337, 338, 1747, 1748, 44, 45, 46, 47, 48, 49, 50, 51, 52, 53, 54, 395, 396, 397, 398, 399, 400, 401, 402, 1091, 1092, 1093, 1165, 1165, 1165, 1165, 1165, 1165, 1165, 1165, 1165, 1165, 1165, 1165
1168, 1168, 1168, 1168, 1168, 1168, 1168, 1168, 1168, 1168, 1168, 1168, 1168, 1168, 1168, 1168, 1168, 1168, 1120, 1121, 1122, 266, 335, 336, 337, 331, 332, 333, 334, 335, 336, 491, 492, 493, 494, 495, 496, 497, 498, 366, 367, 368, 369, 370, 1779, 1780, 81, 82, 83, 84, 85, 86, 87, 88, 89, 107, 108, 427, 428, 429, 430, 431, 432, 433, 434, 1123, 1124, 1125, 1165, 1165, 1165, 1165, 1165, 1165, 1165, 1165, 1165, 1165, 1165, 1165
1168, 1168, 1168, 1168, 1168, 1168, 1168, 1168, 1168, 1168, 1168, 1168, 1168, 1168, 1168, 1168, 1168, 1168, 1152, 1153, 1154, 692, 1747, 1748, 369, 363, 364, 365, 366, 367, 368, 523, 524, 525, 526, 527, 528, 529, 530, 398, 399, 400, 401, 402, 1747, 1748, 115, 116, 117, 118, 119, 140, 141, 142, 143, 144, 145, 459, 460, 461, 462, 463, 464, 465, 466, 1155, 1156, 1157, 1165, 1165, 1165, 1165, 1165, 1165, 1165, 1165, 1165, 1165, 1165, 1165
1168, 1168, 1168, 1168, 1168, 1168, 1168, 1168, 1168, 1168, 1168, 1168, 1168, 1168, 1168, 1168, 1168, 1168, 1184, 1185, 1186, 724, 1779, 1780, 401, 395, 396, 397, 398, 399, 400, 401, 395, 396, 397, 398, 427, 428, 429, 430, 431, 432, 433, 434, 1779, 1780, 115, 116, 117, 118, 119, 177, 178, 179, 180, 181, 182, 491, 492, 493, 494, 495, 496, 497, 498, 1187, 1188, 1189, 1165, 1165, 1165, 1165, 1165, 1165, 1165, 1165, 1165, 1165, 1165, 1165
1168, 1168, 1168, 1168, 1168, 1168, 1168, 1168, 1168, 1168, 1168, 1168, 1168, 1168, 1168, 1168, 1168, 1168, 1216, 1217, 1218, 692, 1747, 1748, 433, 427, 428, 429, 430, 431, 432, 433, 427, 428, 429, 430, 459, 460, 461, 462, 463, 464, 465, 466, 1747, 1748, 147, 148, 149, 150, 151, 214, 215, 216, 217, 235, 236, 523, 524, 525, 526, 527, 528, 529, 530, 1219, 1220, 1221, 1165, 1165, 1165, 1165, 1165, 1165, 1165, 1165, 1165, 1165, 1165, 1165
1168, 1168, 1168, 1168, 1168, 1168, 1168, 1168, 1168, 1168, 1168, 1168, 1168, 1168, 1168, 1168, 1168, 1168, 1248, 1249, 1250, 724, 1779, 1780, 465, 459, 460, 461, 462, 463, 464, 465, 459, 460, 461, 462, 491, 492, 493, 494, 495, 496, 497, 498, 1779, 1780, 179, 180, 181, 182, 183, 268, 269, 270, 271, 272, 273, 1757, 1758, 276, 277, 278, 279, 280, 281, 1251, 1252, 1253, 1165, 1165, 1165, 1165, 1165, 1165, 1165, 1165, 1165, 1165, 1165, 1165
1168, 1168, 1168, 1168, 1168, 1168, 1168, 1168, 1168, 1168, 1168, 1168, 1168, 1168, 1168, 1168, 1168, 1168, 1280, 1281, 1282, 692, 1747, 1748, 497, 491, 492, 493, 494, 495, 496, 497, 491, 492, 493, 494, 523, 524, 525, 526, 527, 528, 529, 530, 1747, 1748, 211, 212, 213, 214, 215, 305, 306, 307, 308, 1104, 1104, 1104, 1104, 313, 331, 332, 333, 334, 335, 1283, 1284, 1285, 1165, 1165, 1165, 1165, 1165, 1165, 1165, 1165, 1165, 1165, 1165, 1165
1168, 1168, 1168, 1168, 1168, 1168, 1168, 1168, 1168, 1168, 1168, 1168, 1168, 1168, 1168, 1168, 1168, 1168, 1312, 1313, 1314, 724, 1779, 1780, 529, 523, 524, 525, 526, 527, 528, 529, 523, 524, 525, 526, 527, 528, 529, 530, 337, 338, 339, 340, 1779, 1780, 243, 244, 245, 246, 247, 342, 343, 344, 345, 1104, 1103, 1103, 1104, 367, 368, 369, 370, 371, 372, 1315, 1316, 1317, 1165, 1165, 1165, 1165, 1165, 1165, 1165, 1165, 1165, 1165, 1165, 1165
1168, 1168, 1168, 1168, 1168, 1168, 1168, 1168, 1168, 1168, 1168, 1168, 1168, 1168, 1168, 1168, 1168, 1168, 992, 993, 994, 995, 996, 997, 998, 999, 1000, 1001, 1002, 1003, 1004, 1005, 1006, 1007, 1006, 1000, 1000, 1001, 1002, 1003, 1004, 1005, 1006, 1007, 1008, 1009, 1010, 1011, 1012, 1013, 1014, 1015, 1008, 1009, 1010, 1011, 1012, 1013, 1014, 1015, 1016, 1017, 1018, 1019, 1020, 1021, 1022, 1023, 1165, 1165, 1165, 1165, 1165, 1165, 1165, 1165, 1165, 1165, 1165, 1165
