1102, 1102, 1102, 1102, 1102, 1102, 1102, 1102, 1102, 1102, 1102, 1102, 1102, 1102, 1102, 1102, 1102, 1102, 1102, 1102, 1102, 1102, 1102, 1102, 1102, 1102, 1102, 1136, 1136, 1102, 1102, 1102, 1102, 1102, 1102, 1102, 1102, 1102, 1102, 1102, 1102, 1102, 1102, 1102, 1102, 1102, 1102, 1102, 1102, 1102, 1102, 1102, 1102, 1102, 1102, 1102, 1102, 1102, 1102, 1102, 1102, 1102, 1102, 1102, 1102, 1102, 1102, 1102, 1102, 1102, 1102, 1102, 1102, 1102, 1102, 1102, 1102, 1102, 1102, 1102
1102, 1102, 1102, 1102, 1102, 1102, 1102, 1102, 1102, 1102, 1102, 1102, 1102, 1102, 1102, 1102, 1102, 1102, 1102, 1102, 1102, 1102, 1102, 1102, 1102, 1102, 1102, 1136, 1136, 1102, 1102, 1102, 1102, 1102, 1102, 1102, 1102, 1102, 1102, 1102, 1102, 1102, 1102, 1102, 1102, 1102, 1102, 1102, 1102, 1102, 1102, 1102, 1102, 1102, 1102, 1102, 1102, 1102, 1102, 1102, 1102, 1102, 1102, 1102, 1102, 1102, 1102, 1102, 1102, 1102, 1102, 1102, 1102, 1102, 1102, 1102, 1102, 1102, 1102, 1102
1102, 1102, 1102, 1102, 1102, 1102, 1102, 1102, 1102, 1102, 1102, 1102, 1102, 1102, 1102, 1102, 1102, 1102, 1102, 1102, 1102, 1102, 1102, 1102, 1102, 1102, 1102, 1102, 1102, 1102, 1102, 1102, 1102, 1102, 1102, 1102, 1102, 1102, 1102, 1102, 1102, 1102, 1102, 1102, 1102, 1102, 1102, 1102, 1102, 1102, 1102, 1102, 1102, 1102, 1102, 1102, 1102, 1102, 1102, 1102, 1102, 1102, 1102, 1102, 1102, 1102, 1102, 1102, 1102, 1102, 1102, 1102, 1102, 1102, 1102, 1102, 1102, 1102, 1102, 1102
1102, 1102, 1102, 1102, 1102, 1102, 1102, 1102, 1102, 1102, 1102, 1102, 1102, 1102, 1102, 1102, 1102, 1102, 1102, 1102, 1102, 1102, 1102, 1102, 1102, 1102, 1102, 1102, 1102, 1102, 1102, 1102, 1102, 1102, 1102, 1102, 1102, 1102, 1102, 1102, 1102, 1102, 1102, 1102, 1102, 1102, 1102, 1102, 1102, 1102, 1102, 1102, 1102, 1102, 1102, 1102, 1102, 1102, 1102, 1102, 1102, 1102, 1102, 1102, 1102, 1102, 1102, 1102, 1102, 1102, 1102, 1102, 1102, 1102, 1102, 1102, 1102, 1102, 1102, 1102
1102, 1102, 1102, 1102, 1102, 1102, 1102, 1102, 1102, 1102, 1102, 1102, 1102, 1102, 1102, 1102, 1102, 1102, 1102, 1102, 1102, 1102, 1102, 1102, 1102, 1102, 1102, 1102, 1102, 1102, 1102, 1102, 1102, 1102, 1102, 1102, 1102, 1102, 1102, 1102, 1102, 1102, 1102, 1102, 1102, 1102, 1102, 1102, 1102, 1102, 1102, 1102, 1102, 1102, 1102, 1102, 1102, 1102, 1102, 1102, 1102, 1102, 1102, 1102, 1102, 1102, 1102, 1102, 1102, 1102, 1102, 1102, 1102, 1102, 1102, 1102, 1102, 1102, 1102, 1102
1102, 1102, 1102, 1102, 1102, 1102, 1102, 1102, 1102, 1102, 1102, 1102, 1102, 1102, 1102, 1102, 1102, 1102, 1102, 1102, 1102, 1102, 1102, 1102, 1102, 1102, 1102, 1102, 1102, 1102, 1102, 1102, 1102, 1102, 1102, 1102, 1102, 1102, 1102, 1102, 1102, 1102, 1102, 1102, 1102, 1102, 1102, 1102, 1102, 1102, 1102, 1102, 1102, 1102, 1102, 1102, 1102, 1102, 1102, 1102, 1102, 1102, 1102, 1102, 1102, 1102, 1102, 1102, 1102, 1102, 1102, 1102, 1102, 1102, 1102, 1102, 1102, 1102, 1102, 1102
1102, 1102, 1102, 1102, 1102, 1102, 1102, 1102, 1102, 1102, 1102, 1102, 1102, 1102, 1102, 1102, 1102, 1102, 1102, 1102, 1102, 1102, 1102, 1102, 1102, 1102, 1102, 1102, 1102, 1102, 1102, 1102, 1102, 1102, 1102, 1102, 1102, 1102, 1102, 1102, 1102, 1102, 1102, 1102, 1102, 1102, 1102, 1102, 1102, 1102, 1102, 1102, 1102, 1102, 1102, 1102, 1102, 1102, 1102, 1102, 1102, 1102, 1102, 1102, 1102, 1102, 1102, 1102, 1102, 1102, 1102, 1102, 1102, 1102, 1102, 1102, 1102, 1102, 1102, 1102
1102, 1102, 1102, 1102, 1102, 1102, 1102, 1102, 1102, 1102, 1102, 1102, 1102, 1102, 1102, 1102, 1102, 1102, 1102, 1102, 1102, 1102, 1102, 1102, 1102, 1102, 1102, 1102, 1102, 1102, 1102, 1102, 1102, 1102, 1102, 1102, 1102, 1102, 1102, 1102, 1102, 1102, 1102, 1102, 1102, 1102, 1102, 1102, 1102, 1102, 1102, 1102, 1102, 1102, 1102, 1102, 1102, 1102, 1102, 1102, 1102, 1102, 1102, 1102, 1102, 1102, 1102, 1102, 1102, 1102, 1102, 1102, 1102, 1102, 1102, 1102, 1102, 1102, 1102, 1102
1102, 1102, 1102, 1102, 1102, 1102, 1102, 1102, 1102, 1102, 1102, 1102, 1102, 1102, 1102, 1102, 1102, 1102, 1102, 1102, 1102, 1102, 1102, 1102, 1102, 1102, 1102, 1102, 1102, 1102, 1102, 1102, 1102, 1102, 1102, 1102, 1102, 1102, 1102, 1102, 1102, 1102, 1102, 1102, 1102, 1102, 1102, 1102, 1102, 1102, 1102, 1102, 1102, 1102, 1102, 1102, 1102, 1102, 1102, 1102, 1102, 1102, 1102, 1102, 1102, 1102, 1102, 1102, 1102, 1102, 1102, 1102, 1102, 1102, 1102, 1102, 1102, 1102, 1102, 1102
1102, 1102, 1102, 1102, 1102, 1102, 1102, 1102, 1102, 1102, 1102, 1102, 1102, 1102, 1102, 1102, 1102, 1102, 1102, 1102, 1102, 1102, 1102, 1102, 1102, 1102, 1102, 1102, 1102, 1102, 1102, 1102, 1102, 1102, 1102, 1102, 1102, 1102, 1102, 1102, 1102, 1102, 1102, 1102, 1102, 1102, 1102, 1102, 1102, 1102, 1102, 1102, 1102, 1102, 1102, 1102, 1102, 1102, 1102, 1102, 1102, 1102, 1102, 1102, 1102, 1102, 1102, 1102, 1102, 1102, 1102, 1102, 1102, 1102, 1102, 1102, 1102, 1102, 1102, 1102
1102, 1102, 1102, 1102, 1102, 1102, 1102, 1102, 1102, 1102, 1102, 1102, 1102, 1102, 1102, 1102, 1102, 1102, 1102, 1102, 1102, 1102, 1102, 1102, 1102, 1102, 1102, 1102, 1102, 1102, 1102, 1102, 1102, 1102, 1102, 1102, 1102, 1102, 1102, 1102, 1102, 1102, 1102, 1102, 1102, 1102, 1102, 1102, 1102, 1102, 1102, 1102, 1102, 1102, 1102, 1102, 1102, 1102, 1102, 1102, 1102, 1102, 1102, 1102, 1102, 1102, 1102, 1102, 1102, 1102, 1102, 1102, 1102, 1102, 1102, 1102, 1102, 1102, 1102, 1102
1102, 1102, 1102, 1102, 1102, 1102, 1102, 1102, 1102, 1102, 1102, 1102, 1102, 1102, 1102, 1102, 1102, 1102, 1102, 1102, 1102, 1102, 1102, 1102, 1102, 1102, 1102, 1073, 1073, 1073, 1073, 1073, 1102, 1102, 1102, 1102, 1102, 1102, 1102, 1102, 1102, 1102, 1102, 1102, 1102, 1102, 1102, 1102, 1102, 1102, 1102, 1102, 1102, 1102, 1102, 1102, 1102, 1102, 1102, 1102, 1102, 1102, 1102, 1102, 1102, 1102, 1102, 1102, 1102, 1102, 1102, 1102, 1102, 1102, 1102, 1102, 1102, 1102, 1102, 1102
1102, 1102, 1102, 1102, 1102, 1102, 1102, 1102, 1102, 1102, 1102, 1102, 1102, 1102, 1102, 1102, 1102, 1102, 1102, 1073, 1073, 1102, 1102, 1102, 1102, 1102, 1102, 1073, 1073, 1073, 1136, 1073, 1102, 1102, 1102, 1102, 1102, 1102, 1102, 1102, 1102, 1102, 1102, 1102, 1102, 1102, 1102, 1102, 1102, 1102, 1102, 1102, 1102, 1102, 1102, 1102, 1102, 1102, 1102, 1102, 1102, 1102, 1102, 1102, 1102, 1102, 1102, 1102, 1102, 1102, 1102, 1102, 1102, 1102, 1102, 1102, 1102, 1102, 1102, 1102
1102, 1102, 1102, 1102, 1102, 1102, 1102, 1102, 1102, 1102, 1102, 1102, 1102, 1102, 1102, 1102, 1102, 1102, 1102, 1102, 1073, 1102, 1102, 1102, 1102, 1102, 1102, 1102, 1073, 1073, 1073, 1073, 1102, 1102, 1102, 1102, 1102, 1102, 1102, 1102, 1102, 1102, 1102, 1102, 1102, 1102, 1102, 1102, 1102, 1102, 1102, 1102, 1102, 1102, 1102, 1102, 1102, 1102, 1102, 1102, 1102, 1102, 1102, 1102, 1102, 1102, 1102, 1102, 1102, 1102, 1102, 1102, 1102, 1102, 1102, 1102, 1102, 1102, 1102, 1102
1102, 1102, 1102, 1102, 1102, 1102, 1102, 1102, 1102, 1102, 1102, 1102, 1102, 1102, 1102, 1089, 1090, 1090, 1053, 1053, 1091, 1091, 1091, 1091, 1091, 1091, 1091, 1091, 1091, 1091, 1091, 1091, 1091, 1091, 1091, 1091, 1091, 1091, 1091, 1091, 1091, 1091, 1091, 1095, 1095, 1091, 1091, 1091, 1091, 1091, 1091, 1091, 1091, 1091, 1091, 1091, 1091, 1091, 1091, 1091, 1091, 1091, 1091, 1091, 1091, 1091, 1091, 1091, 1091, 1091, 1091, 1100, 1102, 1102, 1102, 1102, 1102, 1102, 1102, 1102
1102, 1102, 1102, 1102, 1102, 1102, 1102, 1102, 1102, 1102, 1102, 1102, 1102, 1102, 1102, 1071, 34, 35, 1052, 1052, 1, 2, 697, 697, 1053, 1053, 7, 8, 9, 10, 11, 12, 13, 14, 15, 16, 17, 18, 19, 10, 11, 12, 13, 413, 413, 16, 17, 18, 0, 1, 2, 0, 1, 2, 3, 4, 5, 6, 7, 8, 1028, 1053, 11, 12, 13, 14, 15, 16, 17, 18, 19, 1074, 1102, 1102, 1102, 1102, 1102, 1102, 1102, 1102
1102, 1102, 1102, 1102, 1102, 1102, 1102, 1102, 1102, 1102, 1102, 1102, 1102, 1102, 1102, 1071, 66, 67, 68, 32, 33, 34, 697, 697, 1053, 1053, 39, 40, 41, 42, 43, 44, 45, 46, 47, 48, 49, 50, 51, 42, 43, 44, 45, 413, 413, 48, 49, 50, 32, 33, 34, 32, 33, 34, 35, 36, 37, 38, 39, 1028, 1028, 1053, 43, 44, 45, 46, 47, 48, 49, 50, 51, 1074, 1102, 1102, 1102, 1102, 1102, 1102, 1102, 1102
1102, 1102, 1102, 1102, 1102, 1102, 1102, 1102, 1102, 1102, 1102, 1102, 1102, 1102, 1102, 1071, 98, 99, 100, 64, 65, 66, 697, 697, 1053, 1053, 71, 72, 73, 74, 75, 76, 77, 78, 79, 80, 81, 82, 83, 74, 75, 76, 77, 78, 79, 80, 81, 82, 64, 65, 66, 64, 65, 66, 67, 68, 69, 70, 71, 1028, 1028, 1028, 75, 76, 77, 78, 79, 80, 81, 82, 83, 1074, 1102, 1102, 1102, 1102, 1102, 1102, 1102, 1102
1102, 1102, 1102, 1102, 1102, 1102, 1102, 1102, 1102, 1102, 1102, 1102, 1102, 1102, 1102, 1071, 0, 1, 2, 96, 97, 98, 697, 697, 1053, 1053, 103, 104, 105, 106, 107, 108, 109, 110, 111, 112, 113, 114, 115, 106, 107, 108, 109, 110, 111, 112, 113, 114, 96, 97, 98, 96, 97, 98, 99, 100, 101, 102, 103, 104, 1028, 1028, 107, 108, 109, 110, 111, 112, 113, 114, 115, 1074, 1105, 1102, 1102, 1102, 1102, 1102, 1102, 1102
1102, 1102, 1102, 1102, 1102, 1102, 1102, 1102, 1102, 1102, 1102, 1102, 1102, 1102, 1102, 1071, 32, 33, 34, 128, 129, 130, 697, 697, 1053, 1053, 135, 136, 137, 138, 139, 140, 141, 142, 143, 144, 145, 146, 147, 138, 139, 140, 141, 142, 143, 144, 145, 146, 128, 129, 130, 128, 129, 130, 131, 132, 133, 134, 135, 136, 137, 138, 139, 140, 141, 142, 143, 144, 145, 146, 147, 1074, 1105, 1102, 1102, 1102, 1102, 1102, 1102, 1102
1102, 1102, 1102, 1102, 1102, 1102, 1102, 1102, 1102, 1102, 1102, 1102, 1102, 1102, 1102, 1071, 64, 65, 66, 160, 161, 162, 697, 697, 1053, 1053, 167, 168, 169, 170, 171, 172, 173, 174, 175, 176, 177, 178, 179, 170, 171, 172, 173, 174, 175, 176, 177, 178, 160, 1053, 1053, 160, 161, 162, 163, 164, 165, 166, 167, 168, 169, 170, 171, 172, 173, 174, 175, 176, 177, 178, 179, 1106, 1105, 1102, 1102, 1102, 1102, 1102, 1102, 1102
1102, 1102, 1102, 1102, 1102, 1102, 1102, 1102, 1102, 1102, 1102, 1102, 1102, 1102, 1102, 1071, 96, 97, 98, 192, 193, 194, 697, 697, 1053, 1053, 199, 200, 201, 202, 203, 204, 205, 206, 207, 208, 209, 210, 211, 202, 203, 204, 205, 206, 207, 208, 209, 210, 192, 1053, 1053, 192, 193, 194, 195, 196, 197, 198, 199, 200, 201, 202, 203, 204, 205, 206, 207, 208, 209, 210, 211, 1106, 1105, 1102, 1102, 1102, 1102, 1102, 1102, 1102
1102, 1102, 1102, 1102, 1102, 1102, 1102, 1102, 1102, 1102, 1102, 1102, 1102, 1102, 1102, 1071, 128, 129, 130, 224, 225, 226, 227, 228, 229, 230, 231, 232, 233, 234, 235, 236, 237, 238, 239, 240, 241, 242, 243, 234, 235, 236, 237, 238, 239, 240, 241, 242, 224, 1053, 1053, 224, 225, 226, 227, 228, 229, 230, 231, 232, 233, 234, 235, 236, 237, 238, 239, 240, 241, 242, 243, 1106, 1102, 1102, 1102, 1102, 1102, 1102, 1102, 1102
1102, 1102, 1102, 1102, 1102, 1102, 1102, 1102, 1102, 1102, 1102, 1102, 1102, 1102, 1102, 1071, 160, 161, 162, 256, 257, 258, 259, 260, 261, 262, 263, 264, 265, 266, 267, 268, 269, 270, 271, 272, 273, 274, 275, 266, 267, 268, 269, 270, 271, 272, 273, 274, 256, 1053, 1053, 1053, 1053, 1053, 1053, 1053, 1053, 1053, 1053, 1053, 1053, 1053, 1053, 1053, 1053, 268, 268, 272, 273, 274, 275, 1106, 1102, 1102, 1102, 1102, 1102, 1102, 1102, 1102
1102, 1102, 1102, 1102, 1102, 1102, 1102, 1102, 1102, 1102, 1102, 1102, 1102, 1102, 1102, 1071, 192, 193, 194, 288, 289, 290, 291, 292, 293, 294, 295, 296, 297, 298, 299, 300, 301, 302, 303, 304, 305, 306, 307, 298, 299, 300, 301, 302, 0, 1, 2, 3, 4, 1053, 1053, 1053, 1053, 1053, 1053, 1053, 1053, 1053, 1053, 1053, 1053, 1053, 1053, 1053, 1053, 268, 268, 23, 24, 306, 307, 1106, 1105, 1102, 1102, 1102, 1102, 1102, 1102, 1102
1102, 1102, 1102, 1102, 1102, 1102, 1102, 1102, 1102, 1102, 1102, 1102, 1102, 1102, 1102, 1071, 224, 225, 226, 320, 321, 322, 323, 324, 325, 326, 327, 328, 329, 330, 331, 332, 333, 334, 335, 336, 337, 338, 339, 330, 331, 332, 333, 334, 32, 33, 34, 35, 36, 1053, 1053, 39, 40, 41, 42, 43, 44, 45, 46, 47, 48, 49, 50, 1053, 1053, 268, 268, 55, 56, 338, 339, 1106, 1105, 1102, 1102, 1102, 1102, 1102, 1102, 1102
1102, 1102, 1102, 1102, 1102, 1102, 1102, 1102, 1102, 1102, 1102, 1102, 1102, 1102, 1102, 1071, 256, 257, 258, 352, 353, 354, 355, 356, 357, 358, 359, 360, 361, 362, 363, 364, 365, 366, 367, 368, 369, 370, 371, 362, 363, 364, 365, 366, 64, 65, 66, 67, 68, 1053, 1053, 71, 72, 73, 74, 75, 76, 77, 78, 79, 80, 81, 82, 1053, 1053, 268, 268, 87, 88, 370, 371, 1106, 1105, 1102, 1102, 1102, 1102, 1102, 1102, 1102
1102, 1102, 1102, 1102, 1102, 1102, 1102, 1102, 1102, 1102, 1102, 1102, 1102, 1102, 1102, 1071, 288, 289, 290, 384, 385, 386, 387, 388, 389, 390, 391, 392, 393, 394, 395, 396, 397, 398, 399, 400, 401, 402, 403, 394, 395, 396, 397, 398, 96, 97, 98, 99, 100, 1053, 1053, 103, 104, 105, 106, 107, 108, 109, 110, 111, 112, 113, 114, 115, 116, 117, 118, 119, 120, 402, 403, 1106, 1105, 1102, 1102, 1102, 1102, 1102, 1102, 1102
1102, 1102, 1102, 1102, 1102, 1102, 1102, 1102, 1102, 1102, 1102, 1102, 1102, 1102, 1102, 1071, 320, 321, 322, 416, 417, 418, 419, 420, 1053, 1053, 423, 424, 425, 426, 268, 268, 1053, 1053, 1053, 1053, 268, 268, 435, 426, 427, 316, 316, 430, 128, 129, 130, 131, 1053, 1053, 1053, 135, 136, 137, 138, 139, 140, 141, 142, 508, 508, 302, 146, 147, 148, 149, 150, 151, 152, 434, 435, 1106, 1102, 1102, 1102, 1102, 1102, 1102, 1102, 1102
1102, 1102, 1102, 1102, 1102, 1102, 1102, 1102, 1102, 1102, 1102, 1102, 1102, 1102, 1102, 1071, 352, 353, 354, 448, 449, 450, 451, 452, 1053, 1053, 0, 1, 2, 3, 268, 268, 1053, 1053, 1053, 1053, 268, 268, 221, 221, 14, 316, 316, 17, 18, 19, 316, 316, 1053, 1053, 24, 5, 6, 7, 8, 9, 10, 11, 12, 508, 508, 302, 16, 17, 18, 19, 20, 21, 22, 23, 24, 1106, 1102, 1102, 1102, 1102, 1102, 1102, 1102, 1102
1102, 1102, 1102, 1102, 1102, 1102, 1102, 1102, 1102, 1102, 1102, 1102, 1102, 1102, 1102, 1071, 384, 385, 386, 0, 1, 2, 697, 697, 1053, 1053, 0, 1, 2, 3, 221, 221, 221, 221, 221, 377, 377, 221, 221, 221, 14, 15, 16, 17, 18, 286, 316, 316, 1053, 1053, 4, 5, 6, 7, 8, 9, 10, 11, 508, 508, 302, 302, 302, 17, 18, 19, 20, 21, 22, 23, 24, 1106, 1102, 1102, 1102, 1102, 1102, 1102, 1102, 1102
1102, 1102, 1102, 1102, 1102, 1102, 1102, 1102, 1102, 1102, 1102, 1102, 1102, 1102, 1102, 1071, 416, 417, 418, 32, 33, 34, 697, 697, 1053, 1053, 32, 33, 34, 35, 36, 37, 38, 39, 40, 377, 377, 43, 44, 45, 46, 47, 633, 633, 50, 286, 1053, 1053, 1053, 1053, 36, 37, 38, 39, 40, 41, 42, 43, 508, 508, 302, 302, 302, 49, 50, 51, 52, 53, 54, 55, 56, 1106, 1102, 1102, 1102, 1102, 1102, 1102, 1102, 1102
1102, 1102, 1102, 1102, 1102, 1102, 1102, 1102, 1102, 1102, 1102, 1102, 1102, 1102, 1102, 1071, 448, 449, 450, 64, 65, 66, 697, 697, 277, 277, 64, 65, 66, 67, 68, 69, 70, 71, 72, 73, 74, 75, 76, 77, 78, 79, 633, 633, 82, 286, 1053, 1053, 1053, 1053, 316, 316, 70, 71, 72, 73, 74, 75, 1053, 1053, 508, 508, 302, 81, 82, 83, 84, 85, 86, 87, 88, 1106, 1102, 1102, 1102, 1102, 1102, 1102, 1102, 1102
1102, 1102, 1102, 1102, 1102, 1102, 1102, 1102, 1102, 1102, 1102, 1102, 1102, 1102, 1102, 1071, 0, 1, 2, 96, 97, 98, 697, 697, 277, 277, 96, 97, 98, 99, 100, 101, 102, 103, 104, 105, 106, 107, 108, 109, 110, 111, 1053, 1053, 1053, 1053, 286, 97, 98, 99, 1053, 1053, 316, 103, 104, 105, 106, 107, 1053, 1053, 508, 508, 302, 113, 114, 115, 116, 117, 118, 119, 120, 1138, 1102, 1102, 1102, 1102, 1102, 1102, 1102, 1102
1102, 1102, 1102, 1102, 1102, 1102, 1102, 1102, 1102, 1102, 1102, 1102, 1102, 1102, 1102, 1071, 32, 33, 34, 128, 129, 130, 131, 184, 221, 221, 128, 129, 130, 131, 132, 133, 134, 135, 136, 137, 138, 139, 341, 341, 142, 143, 1053, 1053, 1053, 1053, 286, 129, 130, 131, 1053, 1053, 316, 135, 136, 137, 138, 139, 140, 141, 1053, 1053, 144, 145, 146, 147, 148, 149, 150, 151, 152, 1138, 1102, 1102, 1102, 1102, 1102, 1102, 1102, 1102
1102, 1102, 1102, 1102, 1102, 1102, 1102, 1102, 1102, 1102, 1102, 1102, 1102, 1102, 1102, 1071, 64, 65, 66, 67, 68, 69, 70, 184, 184, 73, 160, 161, 162, 163, 164, 165, 166, 167, 168, 169, 1053, 171, 341, 341, 174, 175, 1053, 1053, 178, 179, 160, 286, 286, 163, 164, 165, 166, 167, 168, 169, 170, 171, 172, 173, 1053, 1053, 176, 177, 178, 179, 180, 181, 182, 183, 184, 1138, 1102, 1102, 1102, 1102, 1102, 1102, 1102, 1102
1102, 1102, 1102, 1102, 1102, 1102, 1034, 1102, 1102, 1102, 1102, 1102, 1102, 1102, 1102, 1071, 1053, 1053, 98, 99, 100, 101, 697, 697, 1053, 1053, 1053, 1053, 1053, 1053, 1053, 408, 198, 199, 200, 201, 1053, 203, 1053, 1053, 1053, 1053, 1053, 1053, 210, 211, 192, 286, 286, 195, 196, 197, 198, 199, 200, 201, 202, 203, 204, 205, 1053, 1053, 208, 209, 210, 211, 212, 213, 214, 215, 216, 1138, 1102, 1102, 1102, 1102, 1102, 1102, 1102, 1102
1102, 1102, 1102, 1102, 1102, 1102, 1102, 1102, 1102, 1102, 1102, 1102, 1102, 1102, 1102, 1071, 128, 129, 130, 131, 132, 133, 697, 697, 1053, 1053, 1053, 1053, 1053, 1053, 1053, 408, 230, 231, 1028, 233, 1053, 235, 1053, 1053, 1053, 1053, 1053, 1053, 242, 243, 224, 225, 226, 227, 228, 229, 230, 231, 232, 233, 234, 235, 236, 237, 1053, 1053, 240, 241, 242, 243, 244, 245, 246, 247, 248, 1138, 1102, 1102, 1102, 1102, 1102, 1102, 1102, 1102
1102, 1102, 1102, 1102, 1102, 1102, 1102, 1102, 1102, 1102, 1102, 1102, 1102, 1102, 1102, 1071, 148, 149, 150, 151, 152, 153, 213, 214, 215, 216, 256, 257, 258, 259, 260, 261, 262, 1028, 1028, 1028, 1053, 1053, 268, 269, 270, 271, 272, 273, 274, 275, 256, 257, 258, 259, 260, 261, 262, 263, 264, 265, 266, 267, 268, 269, 1053, 1053, 272, 273, 274, 275, 276, 277, 278, 279, 280, 1138, 1102, 1102, 1102, 1102, 1102, 1102, 1102, 1102
1102, 1102, 1102, 1102, 1102, 1102, 1102, 1102, 1102, 1102, 1102, 1102, 1102, 1102, 1102, 1071, 180, 181, 182, 183, 184, 185, 245, 246, 247, 248, 288, 289, 290, 291, 292, 1028, 1028, 1028, 1028, 1028, 1028, 1028, 300, 301, 302, 303, 304, 305, 306, 307, 288, 289, 290, 291, 292, 293, 294, 295, 296, 297, 298, 299, 300, 301, 1053, 1053, 304, 305, 306, 307, 308, 309, 310, 311, 312, 1138, 1102, 1102, 1102, 1102, 1102, 1102, 1102, 1102
1102, 1102, 1102, 1102, 1102, 1102, 1102, 1102, 1102, 1102, 1102, 1102, 1102, 1102, 1102, 1071, 212, 213, 214, 215, 216, 217, 136, 265, 266, 267, 320, 321, 322, 407, 433, 433, 433, 1028, 1028, 1028, 407, 407, 332, 333, 334, 335, 336, 337, 338, 339, 320, 321, 322, 323, 324, 325, 326, 327, 328, 329, 330, 331, 332, 333, 1053, 1053, 336, 337, 338, 339, 340, 341, 342, 343, 344, 1138, 1102, 1102, 1102, 1102, 1102, 1102, 1102, 1102
1102, 1102, 1102, 1102, 1102, 1102, 1102, 1102, 1102, 1102, 1102, 1102, 1102, 1102, 1102, 1071, 244, 245, 246, 247, 248, 249, 168, 297, 298, 299, 352, 353, 354, 355, 1028, 1028, 407, 433, 433, 433, 433, 433, 433, 365, 366, 367, 368, 369, 370, 371, 352, 353, 354, 355, 356, 357, 358, 359, 360, 361, 362, 363, 364, 365, 1053, 1053, 368, 369, 370, 371, 372, 373, 374, 375, 376, 1138, 1102, 1102, 1102, 1102, 1102, 1102, 1102, 1102
1102, 1102, 1102, 1102, 1102, 1102, 1102, 1102, 1102, 1102, 1102, 1102, 1102, 1102, 1102, 1071, 276, 277, 278, 279, 280, 281, 200, 329, 330, 331, 384, 385, 386, 1028, 1028, 1028, 1028, 1028, 1028, 1028, 1028, 1028, 1028, 397, 398, 399, 400, 401, 402, 403, 384, 385, 386, 387, 388, 389, 390, 391, 392, 393, 394, 395, 396, 397, 1053, 1053, 400, 401, 402, 403, 404, 405, 406, 407, 408, 1138, 1102, 1102, 1102, 1102, 1102, 1102, 1102, 1102
1102, 1102, 1102, 1102, 1102, 1102, 1102, 1102, 1102, 1102, 1102, 1102, 1102, 1102, 1102, 1071, 308, 309, 310, 311, 312, 313, 314, 315, 0, 0, 416, 417, 418, 1028, 1028, 1028, 1028, 1028, 1028, 1028, 1028, 1028, 210, 429, 430, 431, 432, 433, 434, 435, 416, 417, 418, 419, 420, 421, 422, 423, 424, 425, 426, 427, 428, 429, 1053, 1053, 432, 433, 434, 435, 436, 437, 438, 439, 440, 1138, 1102, 1102, 1102, 1102, 1102, 1102, 1102, 1102
1102, 1102, 1102, 1102, 1102, 1102, 1102, 1102, 1102, 1102, 1102, 1102, 1102, 1102, 1102, 1071, 169, 170, 171, 172, 173, 174, 346, 347, 0, 0, 448, 449, 1028, 1028, 1028, 1028, 1028, 1028, 1028, 1028, 1028, 1028, 1028, 210, 462, 463, 464, 465, 466, 467, 448, 449, 450, 451, 452, 453, 454, 455, 456, 457, 458, 459, 460, 461, 1053, 1053, 464, 465, 466, 467, 468, 469, 470, 471, 472, 1138, 1102, 1102, 1102, 1102, 1102, 1102, 1102, 1102
1102, 1102, 1102, 1102, 1102, 1102, 1102, 1102, 1102, 1102, 1102, 1102, 1102, 1102, 1102, 1071, 169, 170, 171, 172, 173, 174, 169, 170, 171, 172, 173, 174, 169, 1028, 1028, 1028, 1028, 1028, 1028, 1028, 1028, 1028, 1028, 1028, 201, 202, 203, 204, 205, 206, 169, 169, 170, 171, 172, 173, 174, 201, 202, 203, 204, 205, 206, 169, 170, 171, 172, 173, 174, 201, 202, 203, 204, 205, 206, 1074, 1102, 1102, 1102, 1102, 1102, 1102, 1102, 1102
1102, 1102, 1102, 1102, 1102, 1102, 1102, 1102, 1102, 1102, 1102, 1102, 1102, 1102, 1102, 1071, 201, 202, 203, 204, 205, 206, 201, 202, 203, 204, 205, 206, 201, 1028, 1028, 1028, 1028, 1028, 1028, 1028, 1028, 1028, 173, 174, 201, 202, 203, 204, 205, 206, 169, 169, 170, 171, 172, 173, 174, 201, 202, 203, 204, 205, 206, 169, 170, 171, 172, 173, 174, 201, 202, 203, 204, 205, 206, 1074, 1102, 1102, 1102, 1102, 1102, 1102, 1102, 1102
1102, 1102, 1102, 1102, 1102, 1102, 1102, 1102, 1102, 1102, 1102, 1102, 1102, 1102, 1102, 1057, 1062, 1062, 1062, 1062, 1062, 1062, 1062, 1062, 1062, 1062, 1062, 1062, 1062, 1062, 1062, 1062, 1062, 1062, 1062, 1062, 1062, 1062, 1062, 1062, 1062, 1062, 1062, 1062, 1062, 1062, 1062, 1062, 1062, 1062, 1062, 1062, 1062, 1062, 1062, 1062, 1062, 1062, 1062, 1062, 1062, 1062, 1062, 1062, 1062, 1062, 1062, 1062, 1062, 1062, 1062, 1068, 1102, 1102, 1102, 1102, 1102, 1102, 1102, 1102
1102, 1102, 1102, 1102, 1102, 1102, 1102, 1102, 1102, 1102, 1102, 1102, 1102, 1102, 1102, 1102, 1102, 1102, 1102, 1102, 1102, 1102, 1102, 1102, 1102, 1102, 1102, 1102, 1102, 1102, 1102, 1102, 1102, 1102, 1102, 1102, 1102, 1102, 1105, 1105, 1105, 1105, 1105, 1105, 1105, 1105, 1105, 1105, 1102, 1102, 1102, 1102, 1102, 1102, 1102, 1102, 1102, 1102, 1102, 1102, 1102, 1102, 1102, 1102, 1102, 1102, 1102, 1102, 1102, 1102, 1102, 1102, 1102, 1102, 1102, 1102, 1102, 1102, 1102, 1102
1102, 1102, 1102, 1102, 1102, 1102, 1102, 1102, 1102, 1102, 1102, 1102, 1102, 1102, 1102, 1102, 1102, 1102, 1102, 1102, 1102, 1102, 1102, 1102, 1102, 1102, 1102, 1102, 1102, 1102, 1102, 1102, 1102, 1102, 1102, 1102, 1102, 1102, 1102, 1102, 1102, 1102, 1102, 1102, 1102, 1102, 1102, 1102, 1102, 1102, 1102, 1102, 1102, 1102, 1102, 1102, 1102, 1102, 1102, 1102, 1102, 1102, 1102, 1102, 1102, 1102, 1102, 1102, 1102, 1102, 1102, 1102, 1102, 1102, 1102, 1102, 1102, 1102, 1102, 1102
1102, 1102, 1102, 1102, 1102, 1102, 1102, 1102, 1102, 1102, 1102, 1102, 1102, 1102, 1102, 1102, 1102, 1102, 1102, 1102, 1102, 1102, 1102, 1102, 1102, 1102, 1102, 1102, 1102, 1102, 1102, 1102, 1102, 1102, 1102, 1102, 1102, 1102, 1102, 1102, 1102, 1102, 1102, 1102, 1102, 1102, 1102, 1102, 1102, 1102, 1102, 1102, 1102, 1102, 1102, 1102, 1102, 1102, 1102, 1102, 1102, 1102, 1102, 1102, 1102, 1102, 1102, 1102, 1102, 1102, 1102, 1102, 1102, 1102, 1102, 1102, 1102, 1102, 1102, 1102
1102, 1102, 1102, 1102, 1102, 1102, 1102, 1102, 1102, 1102, 1102, 1102, 1102, 1102, 1102, 1102, 1102, 1102, 1102, 1102, 1102, 1102, 1102, 1102, 1102, 1102, 1102, 1102, 1102, 1102, 1102, 1102, 1102, 1102, 1102, 1102, 1102, 1102, 1102, 1102, 1102, 1102, 1102, 1102, 1102, 1102, 1102, 1102, 1102, 1102, 1102, 1102, 1102, 1102, 1102, 1102, 1102, 1102, 1102, 1102, 1102, 1102, 1102, 1102, 1102, 1102, 1102, 1102, 1102, 1102, 1102, 1102, 1102, 1102, 1102, 1102, 1102, 1102, 1102, 1102
1102, 1102, 1102, 1102, 1102, 1102, 1102, 1102, 1102, 1102, 1102, 1102, 1102, 1102, 1102, 1102, 1102, 1102, 1102, 1102, 1102, 1102, 1102, 1102, 1102, 1102, 1102, 1102, 1102, 1102, 1102, 1102, 1102, 1102, 1102, 1102, 1102, 1102, 1102, 1102, 1102, 1102, 1102, 1102, 1102, 1102, 1102, 1102, 1102, 1102, 1102, 1102, 1102, 1102, 1102, 1102, 1102, 1102, 1102, 1102, 1102, 1102, 1102, 1102, 1102, 1102, 1102, 1102, 1102, 1102, 1102, 1102, 1102, 1102, 1102, 1102, 1102, 1102, 1102, 1102
1102, 1102, 1102, 1102, 1102, 1102, 1102, 1102, 1102, 1102, 1102, 1102, 1102, 1102, 1102, 1102, 1102, 1102, 1102, 1102, 1102, 1102, 1102, 1102, 1102, 1102, 1102, 1102, 1102, 1102, 1102, 1102, 1102, 1102, 1102, 1102, 1102, 1102, 1102, 1102, 1102, 1102, 1102, 1102, 1102, 1102, 1102, 1102, 1102, 1102, 1102, 1102, 1102, 1102, 1102, 1102, 1102, 1102, 1102, 1102, 1102, 1102, 1102, 1102, 1102, 1102, 1102, 1102, 1102, 1102, 1102, 1102, 1102, 1102, 1102, 1102, 1102, 1102, 1102, 1102
1102, 1102, 1102, 1102, 1102, 1102, 1102, 1102, 1102, 1102, 1102, 1102, 1102, 1102, 1102, 1102, 1102, 1102, 1102, 1102, 1102, 1102, 1102, 1102, 1102, 1102, 1102, 1102, 1102, 1102, 1102, 1102, 1102, 1102, 1102, 1102, 1102, 1102, 1102, 1102, 1102, 1102, 1102, 1102, 1102, 1102, 1102, 1102, 1102, 1102, 1102, 1102, 1102, 1102, 1102, 1102, 1102, 1102, 1102, 1102, 1102, 1102, 1102, 1102, 1102, 1102, 1102, 1102, 1102, 1102, 1102, 1102, 1102, 1102, 1102, 1102, 1102, 1102, 1102, 1102
1102, 1102, 1102, 1102, 1102, 1102, 1102, 1102, 1102, 1102, 1102, 1102, 1102, 1102, 1102, 1102, 1102, 1102, 1102, 1102, 1102, 1102, 1102, 1102, 1102, 1102, 1102, 1102, 1102, 1102, 1102, 1102, 1102, 1102, 1102, 1102, 1102, 1102, 1102, 1102, 1102, 1102, 1102, 1102, 1102, 1102, 1102, 1102, 1102, 1102, 1102, 1102, 1102, 1102, 1102, 1102, 1102, 1102, 1102, 1102, 1102, 1102, 1102, 1102, 1102, 1102, 1102, 1102, 1102, 1102, 1102, 1102, 1102, 1102, 1102, 1102, 1102, 1102, 1102, 1102
1102, 1102, 1102, 1102, 1102, 1102, 1102, 1102, 1102, 1102, 1102, 1102, 1102, 1102, 1102, 1102, 1102, 1102, 1102, 1102, 1102, 1102, 1102, 1102, 1102, 1102, 1102, 1102, 1102, 1102, 1102, 1102, 1102, 1102, 1102, 1102, 1102, 1102, 1102, 1102, 1102, 1102, 1102, 1102, 1102, 1102, 1102, 1102, 1102, 1102, 1102, 1102, 1102, 1102, 1102, 1102, 1102, 1102, 1102, 1102, 1102, 1102, 1102, 1102, 1102, 1102, 1102, 1102, 1102, 1102, 1102, 1102, 1102, 1102, 1102, 1102, 1102, 1102, 1102, 1102
1102, 1102, 1102, 1102, 1102, 1102, 1102, 1102, 1102, 1102, 1102, 1102, 1102, 1102, 1102, 1102, 1102, 1102, 1102, 1102, 1102, 1102, 1102, 1102, 1102, 1102, 1102, 1102, 1102, 1102, 1102, 1102, 1102, 1102, 1102, 1102, 1102, 1102, 1102, 1102, 1102, 1102, 1102, 1102, 1102, 1102, 1102, 1102, 1102, 1102, 1102, 1102, 1102, 1102, 1102, 1102, 1102, 1102, 1102, 1102, 1102, 1102, 1102, 1102, 1102, 1102, 1102, 1102, 1102, 1102, 1102, 1102, 1102, 1102, 1102, 1102, 1102, 1102, 1102, 1102
1102, 1102, 1102, 1102, 1102, 1102, 1102, 1102, 1102, 1102, 1102, 1102, 1102, 1102, 1102, 1102, 1102, 1102, 1102, 1102, 1102, 1102, 1102, 1102, 1102, 1102, 1102, 1102, 1102, 1102, 1102, 1102, 1102, 1102, 1102, 1102, 1102, 1102, 1102, 1102, 1102, 1102, 1102, 1102, 1102, 1102, 1102, 1102, 1102, 1102, 1102, 1102, 1102, 1102, 1102, 1102, 1102, 1102, 1102, 1102, 1102, 1102, 1102, 1102, 1102, 1102, 1102, 1102, 1102, 1102, 1102, 1102, 1102, 1102, 1102, 1102, 1102, 1102, 1102, 1102
1102, 1102, 1102, 1102, 1102, 1102, 1102, 1102, 1102, 1102, 1102, 1102, 1102, 1102, 1102, 1102, 1102, 1102, 1102, 1102, 1102, 1102, 1102, 1102, 1102, 1102, 1102, 1102, 1102, 1102, 1102, 1102, 1102, 1102, 1102, 1102, 1102, 1102, 1102, 1102, 1102, 1102, 1102, 1102, 1102, 1102, 1102, 1102, 1102, 1102, 1102, 1102, 1102, 1102, 1102, 1102, 1102, 1102, 1102, 1102, 1102, 1102, 1102, 1102, 1102, 1102, 1102, 1102, 1102, 1102, 1102, 1102, 1102, 1102, 1102, 1102, 1102, 1102, 1102, 1102
