1089, 1094, 1094, 1094, 1094, 1094, 1094, 1094, 1094, 1094, 1094, 1094, 1094, 1093, 1093, 1093, 1093, 1053, 1053, 1093, 1093, 1093, 1094, 1094, 1094, 1094, 1094, 1094, 1094, 1094, 1094, 1094, 1094, 1094, 1094, 1094, 1094, 1094, 1094, 1100, 1165, 1165, 1165, 1165, 1165, 1165, 1165, 1165, 1165, 1165, 1165, 1165, 1165, 1165, 1165, 1165, 1165, 1165, 1165, 1165, 1165, 1165, 1165, 1165, 1165, 1165, 1165, 1165, 1165, 1165, 1165, 1165, 1165, 1165, 1165, 1165, 1165, 1165, 1165, 1165
1103, 0, 0, 0, 0, 0, 0, 0, 0, 0, 0, 0, 0, 0, 0, 0, 0, 1052, 1052, 0, 0, 0, 0, 0, 0, 0, 0, 0, 0, 0, 0, 0, 0, 0, 0, 0, 0, 0, 0, 1106, 1165, 1165, 1165, 1165, 1165, 1165, 1165, 1165, 1165, 1165, 1165, 1165, 1165, 1165, 1165, 1165, 1165, 1165, 1165, 1165, 1165, 1165, 1165, 1165, 1165, 1165, 1165, 1165, 1165, 1165, 1165, 1165, 1165, 1165, 1165, 1165, 1165, 1165, 1165, 1165
1103, 0, 0, 0, 0, 0, 0, 0, 0, 0, 0, 0, 0, 0, 0, 0, 0, 0, 0, 0, 0, 0, 0, 0, 0, 0, 0, 0, 0, 0, 0, 0, 0, 0, 0, 0, 0, 0, 0, 1106, 1165, 1165, 1165, 1165, 1165, 1165, 1165, 1165, 1165, 1165, 1165, 1165, 1165, 1165, 1165, 1165, 1165, 1165, 1165, 1165, 1165, 1165, 1165, 1165, 1165, 1165, 1165, 1165, 1165, 1165, 1165, 1165, 1165, 1165, 1165, 1165, 1165, 1165, 1165, 1165
1103, 0, 1, 2, 3, 4, 5, 6, 7, 8, 9, 10, 11, 12, 13, 14, 15, 0, 1, 2, 3, 4, 5, 6, 7, 8, 9, 10, 11, 12, 13, 14, 15, 0, 0, 0, 0, 0, 0, 1106, 1165, 1165, 1165, 1165, 1165, 1165, 1165, 1165, 1165, 1165, 1165, 1165, 1165, 1165, 1165, 1165, 1165, 1165, 1165, 1165, 1165, 1165, 1165, 1165, 1165, 1165, 1165, 1165, 1165, 1165, 1165, 1165, 1165, 1165, 1165, 1165, 1165, 1165, 1165, 1165
1103, 32, 33, 34, 35, 36, 37, 38, 39, 40, 41, 42, 43, 44, 45, 46, 47, 32, 33, 34, 35, 36, 37, 38, 39, 40, 41, 42, 43, 44, 45, 46, 47, 0, 0, 0, 1, 2, 3, 1106, 1165, 1165, 1165, 1165, 1165, 1165, 1165, 1165, 1165, 1165, 1165, 1165, 1165, 1165, 1165, 1165, 1165, 1165, 1165, 1165, 1165, 1165, 1165, 1165, 1165, 1165, 1165, 1165, 1165, 1165, 1165, 1165, 1165, 1165, 1165, 1165, 1165, 1165, 1165, 1165
1103, 64, 65, 66, 67, 68, 69, 70, 71, 72, 73, 74, 75, 76, 77, 78, 79, 64, 65, 66, 67, 68, 69, 70, 71, 72, 73, 74, 75, 76, 77, 78, 79, 0, 0, 32, 33, 34, 35, 1106, 1165, 1165, 1165, 1165, 1165, 1165, 1165, 1165, 1165, 1165, 1165, 1165, 1165, 1165, 1165, 1165, 1165, 1165, 1165, 1165, 1165, 1165, 1165, 1165, 1165, 1165, 1165, 1165, 1165, 1165, 1165, 1165, 1165, 1165, 1165, 1165, 1165, 1165, 1165, 1165
1103, 96, 97, 98, 99, 100, 101, 102, 103, 104, 105, 106, 107, 108, 109, 110, 111, 96, 97, 98, 99, 100, 101, 102, 103, 104, 105, 106, 107, 108, 109, 110, 111, 0, 0, 64, 65, 66, 67, 1106, 1165, 1165, 1165, 1165, 1165, 1165, 1165, 1165, 1165, 1165, 1165, 1165, 1165, 1165, 1165, 1165, 1165, 1165, 1165, 1165, 1165, 1165, 1165, 1165, 1165, 1165, 1165, 1165, 1165, 1165, 1165, 1165, 1165, 1165, 1165, 1165, 1165, 1165, 1165, 1165
1103, 128, 129, 130, 131, 132, 133, 134, 135, 136, 137, 138, 139, 140, 141, 142, 143, 128, 129, 130, 131, 132, 133, 134, 135, 136, 137, 138, 139, 140, 141, 142, 143, 0, 0, 96, 97, 98, 99, 1106, 1165, 1165, 1165, 1165, 1165, 1165, 1165, 1165, 1165, 1165, 1165, 1165, 1165, 1165, 1165, 1165, 1165, 1165, 1165, 1165, 1165, 1165, 1165, 1165, 1165, 1165, 1165, 1165, 1165, 1165, 1165, 1165, 1165, 1165, 1165, 1165, 1165, 1165, 1165, 1165
1103, 160, 161, 162, 163, 164, 165, 166, 167, 168, 169, 170, 171, 172, 173, 174, 175, 160, 161, 162, 163, 164, 165, 166, 167, 168, 169, 170, 171, 172, 173, 174, 175, 0, 134, 128, 129, 130, 131, 1106, 1165, 1165, 1165, 1165, 1165, 1165, 1165, 1165, 1165, 1165, 1165, 1165, 1165, 1165, 1165, 1165, 1165, 1165, 1165, 1165, 1165, 1165, 1165, 1165, 1165, 1165, 1165, 1165, 1165, 1165, 1165, 1165, 1165, 1165, 1165, 1165, 1165, 1165, 1165, 1165
1103, 192, 193, 194, 195, 196, 197, 198, 199, 200, 201, 202, 203, 204, 205, 206, 207, 192, 193, 194, 195, 956, 957, 198, 199, 200, 201, 202, 203, 204, 205, 206, 207, 144, 166, 160, 161, 162, 163, 1106, 1165, 1165, 1165, 1165, 1165, 1165, 1165, 1165, 1165, 1165, 1165, 1165, 1165, 1165, 1165, 1165, 1165, 1165, 1165, 1165, 1165, 1165, 1165, 1165, 1165, 1165, 1165, 1165, 1165, 1165, 1165, 1165, 1165, 1165, 1165, 1165, 1165, 1165, 1165, 1165
1103, 224, 225, 226, 227, 228, 229, 230, 231, 232, 233, 234, 235, 236, 237, 238, 239, 224, 225, 226, 227, 988, 989, 230, 231, 232, 233, 234, 235, 236, 237, 238, 239, 176, 198, 192, 193, 194, 195, 1106, 1165, 1165, 1165, 1165, 1165, 1165, 1165, 1165, 1165, 1165, 1165, 1165, 1165, 1165, 1165, 1165, 1165, 1165, 1165, 1165, 1165, 1165, 1165, 1165, 1165, 1165, 1165, 1165, 1165, 1165, 1165, 1165, 1165, 1165, 1165, 1165, 1165, 1165, 1165, 1165
1103, 256, 257, 258, 259, 260, 261, 262, 263, 264, 265, 266, 267, 268, 269, 270, 271, 256, 257, 258, 259, 260, 261, 262, 263, 264, 265, 266, 267, 268, 269, 270, 271, 208, 230, 224, 225, 226, 227, 1106, 1165, 1165, 1165, 1165, 1165, 1165, 1165, 1165, 1165, 1165, 1165, 1165, 1165, 1165, 1165, 1165, 1165, 1165, 1165, 1165, 1165, 1165, 1165, 1165, 1165, 1165, 1165, 1165, 1165, 1165, 1165, 1165, 1165, 1165, 1165, 1165, 1165, 1165, 1165, 1165
1103, 288, 289, 290, 291, 292, 293, 294, 295, 296, 297, 298, 299, 300, 301, 302, 303, 288, 289, 290, 291, 292, 293, 294, 295, 296, 297, 298, 299, 300, 301, 302, 303, 240, 262, 256, 257, 258, 259, 1106, 1165, 1165, 1165, 1165, 1165, 1165, 1165, 1165, 1165, 1165, 1165, 1165, 1165, 1165, 1165, 1165, 1165, 1165, 1165, 1165, 1165, 1165, 1165, 1165, 1165, 1165, 1165, 1165, 1165, 1165, 1165, 1165, 1165, 1165, 1165, 1165, 1165, 1165, 1165, 1165
1103, 320, 321, 322, 323, 324, 325, 326, 327, 328, 329, 330, 331, 332, 333, 334, 335, 320, 321, 322, 323, 324, 325, 326, 327, 328, 329, 330, 331, 332, 333, 334, 335, 272, 294, 288, 289, 290, 291, 1106, 1165, 1165, 1165, 1165, 1165, 1165, 1165, 1165, 1165, 1165, 1165, 1165, 1165, 1165, 1165, 1165, 1165, 1165, 1165, 1165, 1165, 1165, 1165, 1165, 1165, 1165, 1165, 1165, 1165, 1165, 1165, 1165, 1165, 1165, 1165, 1165, 1165, 1165, 1165, 1165
1103, 352, 353, 354, 355, 356, 357, 358, 359, 360, 361, 362, 363, 364, 365, 366, 367, 352, 353, 354, 355, 356, 357, 358, 359, 360, 361, 362, 363, 364, 365, 366, 367, 304, 326, 320, 321, 322, 323, 1106, 1165, 1165, 1165, 1165, 1165, 1165, 1165, 1165, 1165, 1165, 1165, 1165, 1165, 1165, 1165, 1165, 1165, 1165, 1165, 1165, 1165, 1165, 1165, 1165, 1165, 1165, 1165, 1165, 1165, 1165, 1165, 1165, 1165, 1165, 1165, 1165, 1165, 1165, 1165, 1165
1103, 384, 385, 386, 387, 388, 389, 390, 956, 957, 393, 394, 395, 396, 397, 398, 399, 384, 385, 386, 387, 388, 389, 390, 391, 392, 393, 394, 395, 396, 397, 398, 399, 336, 358, 352, 353, 354, 355, 1106, 1165, 1165, 1165, 1165, 1165, 1165, 1165, 1165, 1165, 1165, 1165, 1165, 1165, 1165, 1165, 1165, 1165, 1165, 1165, 1165, 1165, 1165, 1165, 1165, 1165, 1165, 1165, 1165, 1165, 1165, 1165, 1165, 1165, 1165, 1165, 1165, 1165, 1165, 1165, 1165
1103, 416, 417, 418, 419, 420, 421, 422, 988, 989, 425, 426, 427, 428, 429, 430, 431, 416, 417, 418, 419, 420, 421, 422, 423, 424, 425, 426, 427, 428, 429, 430, 431, 368, 390, 384, 385, 386, 387, 1106, 1165, 1165, 1165, 1165, 1165, 1165, 1165, 1165, 1165, 1165, 1165, 1165, 1165, 1165, 1165, 1165, 1165, 1165, 1165, 1165, 1165, 1165, 1165, 1165, 1165, 1165, 1165, 1165, 1165, 1165, 1165, 1165, 1165, 1165, 1165, 1165, 1165, 1165, 1165, 1165
1103, 448, 449, 450, 451, 452, 453, 454, 455, 456, 457, 458, 459, 460, 461, 462, 463, 448, 449, 450, 451, 452, 453, 454, 455, 456, 457, 458, 459, 460, 461, 462, 463, 145, 422, 416, 417, 418, 419, 1106, 1165, 1165, 1165, 1165, 1165, 1165, 1165, 1165, 1165, 1165, 1165, 1165, 1165, 1165, 1165, 1165, 1165, 1165, 1165, 1165, 1165, 1165, 1165, 1165, 1165, 1165, 1165, 1165, 1165, 1165, 1165, 1165, 1165, 1165, 1165, 1165, 1165, 1165, 1165, 1165
1103, 480, 481, 482, 483, 484, 485, 486, 487, 488, 489, 490, 491, 492, 493, 494, 495, 480, 481, 482, 483, 484, 485, 486, 487, 488, 489, 490, 491, 492, 493, 494, 495, 177, 454, 448, 449, 450, 451, 1106, 1165, 1165, 1165, 1165, 1165, 1165, 1165, 1165, 1165, 1165, 1165, 1165, 1165, 1165, 1165, 1165, 1165, 1165, 1165, 1165, 1165, 1165, 1165, 1165, 1165, 1165, 1165, 1165, 1165, 1165, 1165, 1165, 1165, 1165, 1165, 1165, 1165, 1165, 1165, 1165
1103, 0, 1, 2, 3, 4, 5, 6, 7, 8, 9, 10, 11, 12, 956, 957, 15, 32, 33, 34, 35, 36, 37, 38, 39, 40, 41, 203, 204, 205, 206, 207, 208, 209, 486, 480, 481, 482, 483, 1106, 1165, 1165, 1165, 1165, 1165, 1165, 1165, 1165, 1165, 1165, 1165, 1165, 1165, 1165, 1165, 1165, 1165, 1165, 1165, 1165, 1165, 1165, 1165, 1165, 1165, 1165, 1165, 1165, 1165, 1165, 1165, 1165, 1165, 1165, 1165, 1165, 1165, 1165, 1165, 1165
1103, 42, 43, 44, 45, 46, 47, 64, 65, 66, 67, 68, 69, 70, 988, 989, 394, 394, 394, 76, 77, 78, 79, 96, 97, 98, 99, 235, 236, 0, 1, 2, 3, 4, 5, 6, 7, 8, 9, 1106, 1165, 1165, 1165, 1165, 1165, 1165, 1165, 1165, 1165, 1165, 1165, 1165, 1165, 1165, 1165, 1165, 1165, 1165, 1165, 1165, 1165, 1165, 1165, 1165, 1165, 1165, 1165, 1165, 1165, 1165, 1165, 1165, 1165, 1165, 1165, 1165, 1165, 1165, 1165, 1165
1103, 100, 101, 102, 103, 104, 105, 106, 107, 108, 109, 110, 111, 128, 129, 130, 131, 132, 133, 134, 135, 136, 137, 138, 139, 140, 141, 267, 268, 42, 43, 44, 45, 46, 47, 64, 65, 66, 67, 1106, 1165, 1165, 1165, 1165, 1165, 1165, 1165, 1165, 1165, 1165, 1165, 1165, 1165, 1165, 1165, 1165, 1165, 1165, 1165, 1165, 1165, 1165, 1165, 1165, 1165, 1165, 1165, 1165, 1165, 1165, 1165, 1165, 1165, 1165, 1165, 1165, 1165, 1165, 1165, 1165
1103, 142, 143, 160, 161, 162, 163, 164, 165, 166, 167, 168, 169, 170, 171, 172, 173, 174, 175, 192, 193, 194, 195, 196, 197, 198, 199, 299, 300, 956, 957, 102, 103, 104, 105, 106, 107, 108, 109, 1106, 1165, 1165, 1165, 1165, 1165, 1165, 1165, 1165, 1165, 1165, 1165, 1165, 1165, 1165, 1165, 1165, 1165, 1165, 1165, 1165, 1165, 1165, 1165, 1165, 1165, 1165, 1165, 1165, 1165, 1165, 1165, 1165, 1165, 1165, 1165, 1165, 1165, 1165, 1165, 1165
1103, 200, 201, 202, 203, 204, 205, 206, 207, 224, 225, 226, 227, 228, 229, 230, 231, 232, 233, 234, 235, 236, 237, 238, 239, 256, 257, 331, 332, 988, 989, 160, 161, 162, 163, 164, 165, 166, 167, 1106, 1165, 1165, 1165, 1165, 1165, 1165, 1165, 1165, 1165, 1165, 1165, 1165, 1165, 1165, 1165, 1165, 1165, 1165, 1165, 1165, 1165, 1165, 1165, 1165, 1165, 1165, 1165, 1165, 1165, 1165, 1165, 1165, 1165, 1165, 1165, 1165, 1165, 1165, 1165, 1165
1103, 258, 259, 260, 261, 262, 263, 264, 265, 266, 267, 268, 269, 270, 271, 288, 289, 290, 291, 292, 293, 294, 295, 296, 297, 298, 299, 363, 364, 200, 201, 202, 203, 204, 205, 206, 207, 224, 225, 1106, 1165, 1165, 1165, 1165, 1165, 1165, 1165, 1165, 1165, 1165, 1165, 1165, 1165, 1165, 1165, 1165, 1165, 1165, 1165, 1165, 1165, 1165, 1165, 1165, 1165, 1165, 1165, 1165, 1165, 1165, 1165, 1165, 1165, 1165, 1165, 1165, 1165, 1165, 1165, 1165
1103, 300, 301, 302, 303, 320, 321, 322, 323, 324, 325, 326, 327, 328, 329, 330, 331, 332, 333, 334, 335, 352, 353, 354, 355, 356, 357, 395, 396, 258, 259, 260, 261, 262, 263, 264, 265, 266, 267, 1106, 1165, 1165, 1165, 1165, 1165, 1165, 1165, 1165, 1165, 1165, 1165, 1165, 1165, 1165, 1165, 1165, 1165, 1165, 1165, 1165, 1165, 1165, 1165, 1165, 1165, 1165, 1165, 1165, 1165, 1165, 1165, 1165, 1165, 1165, 1165, 1165, 1165, 1165, 1165, 1165
1103, 358, 359, 360, 361, 362, 363, 364, 365, 366, 367, 384, 385, 386, 387, 388, 389, 390, 391, 392, 393, 394, 395, 396, 397, 398, 399, 427, 428, 300, 301, 302, 303, 320, 321, 322, 323, 324, 325, 1106, 1165, 1165, 1165, 1165, 1165, 1165, 1165, 1165, 1165, 1165, 1165, 1165, 1165, 1165, 1165, 1165, 1165, 1165, 1165, 1165, 1165, 1165, 1165, 1165, 1165, 1165, 1165, 1165, 1165, 1165, 1165, 1165, 1165, 1165, 1165, 1165, 1165, 1165, 1165, 1165
1103, 416, 417, 418, 419, 420, 421, 422, 423, 424, 425, 426, 427, 428, 429, 430, 431, 448, 449, 450, 451, 452, 453, 454, 455, 456, 457, 135, 136, 358, 359, 360, 361, 362, 363, 364, 365, 366, 367, 1106, 1165, 1165, 1165, 1165, 1165, 1165, 1165, 1165, 1165, 1165, 1165, 1165, 1165, 1165, 1165, 1165, 1165, 1165, 1165, 1165, 1165, 1165, 1165, 1165, 1165, 1165, 1165, 1165, 1165, 1165, 1165, 1165, 1165, 1165, 1165, 1165, 1165, 1165, 1165, 1165
1103, 458, 459, 460, 461, 462, 463, 480, 481, 482, 483, 484, 485, 486, 487, 488, 489, 490, 491, 492, 493, 494, 495, 0, 1, 2, 3, 167, 168, 416, 417, 418, 419, 420, 421, 422, 423, 424, 425, 1106, 1165, 1165, 1165, 1165, 1165, 1165, 1165, 1165, 1165, 1165, 1165, 1165, 1165, 1165, 1165, 1165, 1165, 1165, 1165, 1165, 1165, 1165, 1165, 1165, 1165, 1165, 1165, 1165, 1165, 1165, 1165, 1165, 1165, 1165, 1165, 1165, 1165, 1165, 1165, 1165
1103, 4, 5, 6, 7, 8, 9, 10, 11, 12, 13, 14, 15, 32, 33, 34, 35, 36, 37, 38, 39, 40, 41, 42, 43, 44, 45, 199, 200, 458, 459, 460, 461, 462, 463, 480, 481, 482, 483, 1106, 1165, 1165, 1165, 1165, 1165, 1165, 1165, 1165, 1165, 1165, 1165, 1165, 1165, 1165, 1165, 1165, 1165, 1165, 1165, 1165, 1165, 1165, 1165, 1165, 1165, 1165, 1165, 1165, 1165, 1165, 1165, 1165, 1165, 1165, 1165, 1165, 1165, 1165, 1165, 1165
1103, 46, 47, 64, 65, 66, 67, 68, 69, 70, 71, 72, 73, 74, 75, 76, 77, 78, 79, 96, 97, 98, 99, 100, 101, 102, 103, 231, 232, 4, 5, 6, 7, 8, 9, 10, 11, 12, 13, 1106, 1165, 1165, 1165, 1165, 1165, 1165, 1165, 1165, 1165, 1165, 1165, 1165, 1165, 1165, 1165, 1165, 1165, 1165, 1165, 1165, 1165, 1165, 1165, 1165, 1165, 1165, 1165, 1165, 1165, 1165, 1165, 1165, 1165, 1165, 1165, 1165, 1165, 1165, 1165, 1165
1103, 104, 105, 106, 107, 108, 109, 110, 111, 128, 129, 130, 131, 132, 133, 134, 135, 136, 137, 138, 139, 140, 141, 142, 143, 160, 161, 263, 264, 46, 47, 64, 65, 66, 67, 68, 69, 70, 71, 1106, 1165, 1165, 1165, 1165, 1165, 1165, 1165, 1165, 1165, 1165, 1165, 1165, 1165, 1165, 1165, 1165, 1165, 1165, 1165, 1165, 1165, 1165, 1165, 1165, 1165, 1165, 1165, 1165, 1165, 1165, 1165, 1165, 1165, 1165, 1165, 1165, 1165, 1165, 1165, 1165
1103, 162, 163, 164, 165, 166, 167, 168, 169, 170, 171, 172, 173, 174, 175, 192, 193, 194, 195, 196, 197, 198, 199, 200, 201, 202, 203, 295, 296, 104, 105, 106, 107, 108, 109, 110, 111, 128, 129, 1106, 1165, 1165, 1165, 1165, 1165, 1165, 1165, 1165, 1165, 1165, 1165, 1165, 1165, 1165, 1165, 1165, 1165, 1165, 1165, 1165, 1165, 1165, 1165, 1165, 1165, 1165, 1165, 1165, 1165, 1165, 1165, 1165, 1165, 1165, 1165, 1165, 1165, 1165, 1165, 1165
1103, 204, 205, 206, 207, 224, 225, 226, 227, 228, 229, 230, 231, 232, 233, 234, 235, 236, 237, 238, 239, 256, 257, 258, 259, 260, 261, 327, 328, 162, 163, 164, 165, 166, 167, 168, 169, 170, 171, 1106, 1165, 1165, 1165, 1165, 1165, 1165, 1165, 1165, 1165, 1165, 1165, 1165, 1165, 1165, 1165, 1165, 1165, 1165, 1165, 1165, 1165, 1165, 1165, 1165, 1165, 1165, 1165, 1165, 1165, 1165, 1165, 1165, 1165, 1165, 1165, 1165, 1165, 1165, 1165, 1165
1103, 262, 263, 264, 265, 266, 267, 268, 269, 270, 271, 288, 289, 290, 291, 292, 293, 294, 295, 296, 297, 298, 299, 300, 301, 302, 956, 957, 360, 204, 205, 206, 207, 224, 225, 226, 227, 228, 229, 1106, 1165, 1165, 1165, 1165, 1165, 1165, 1165, 1165, 1165, 1165, 1165, 1165, 1165, 1165, 1165, 1165, 1165, 1165, 1165, 1165, 1165, 1165, 1165, 1165, 1165, 1165, 1165, 1165, 1165, 1165, 1165, 1165, 1165, 1165, 1165, 1165, 1165, 1165, 1165, 1165
1103, 320, 321, 322, 323, 324, 325, 326, 327, 328, 329, 330, 331, 332, 333, 334, 335, 352, 353, 354, 355, 356, 357, 358, 359, 360, 988, 989, 142, 262, 263, 264, 265, 266, 267, 268, 269, 270, 271, 1106, 1165, 1165, 1165, 1165, 1165, 1165, 1165, 1165, 1165, 1165, 1165, 1165, 1165, 1165, 1165, 1165, 1165, 1165, 1165, 1165, 1165, 1165, 1165, 1165, 1165, 1165, 1165, 1165, 1165, 1165, 1165, 1165, 1165, 1165, 1165, 1165, 1165, 1165, 1165, 1165
1103, 362, 363, 364, 365, 366, 367, 384, 385, 386, 387, 388, 389, 390, 391, 392, 393, 394, 395, 396, 397, 398, 399, 416, 417, 418, 419, 177, 174, 320, 321, 322, 323, 324, 325, 326, 327, 328, 329, 1106, 1165, 1165, 1165, 1165, 1165, 1165, 1165, 1165, 1165, 1165, 1165, 1165, 1165, 1165, 1165, 1165, 1165, 1165, 1165, 1165, 1165, 1165, 1165, 1165, 1165, 1165, 1165, 1165, 1165, 1165, 1165, 1165, 1165, 1165, 1165, 1165, 1165, 1165, 1165, 1165
1103, 420, 421, 422, 423, 424, 425, 426, 427, 428, 429, 430, 431, 448, 449, 450, 451, 452, 453, 454, 455, 456, 457, 458, 459, 460, 461, 209, 206, 362, 363, 364, 365, 366, 367, 384, 385, 386, 387, 1106, 1165, 1165, 1165, 1165, 1165, 1165, 1165, 1165, 1165, 1165, 1165, 1165, 1165, 1165, 1165, 1165, 1165, 1165, 1165, 1165, 1165, 1165, 1165, 1165, 1165, 1165, 1165, 1165, 1165, 1165, 1165, 1165, 1165, 1165, 1165, 1165, 1165, 1165, 1165, 1165
1103, 462, 463, 480, 481, 482, 483, 484, 485, 486, 487, 488, 489, 490, 491, 492, 493, 494, 495, 0, 1, 2, 3, 4, 5, 6, 7, 241, 238, 420, 421, 422, 423, 424, 425, 426, 427, 428, 429, 1106, 1165, 1165, 1165, 1165, 1165, 1165, 1165, 1165, 1165, 1165, 1165, 1165, 1165, 1165, 1165, 1165, 1165, 1165, 1165, 1165, 1165, 1165, 1165, 1165, 1165, 1165, 1165, 1165, 1165, 1165, 1165, 1165, 1165, 1165, 1165, 1165, 1165, 1165, 1165, 1165
1103, 8, 9, 10, 11, 12, 13, 14, 15, 32, 33, 34, 35, 36, 37, 38, 39, 40, 41, 956, 957, 44, 45, 46, 47, 64, 65, 273, 270, 462, 463, 480, 481, 482, 483, 484, 485, 486, 487, 1106, 1165, 1165, 1165, 1165, 1165, 1165, 1165, 1165, 1165, 1165, 1165, 1165, 1165, 1165, 1165, 1165, 1165, 1165, 1165, 1165, 1165, 1165, 1165, 1165, 1165, 1165, 1165, 1165, 1165, 1165, 1165, 1165, 1165, 1165, 1165, 1165, 1165, 1165, 1165, 1165
1103, 66, 67, 68, 69, 70, 71, 72, 73, 74, 75, 76, 77, 78, 79, 96, 97, 98, 99, 988, 989, 102, 103, 104, 105, 106, 107, 305, 302, 8, 9, 10, 11, 12, 13, 14, 15, 32, 33, 1106, 1165, 1165, 1165, 1165, 1165, 1165, 1165, 1165, 1165, 1165, 1165, 1165, 1165, 1165, 1165, 1165, 1165, 1165, 1165, 1165, 1165, 1165, 1165, 1165, 1165, 1165, 1165, 1165, 1165, 1165, 1165, 1165, 1165, 1165, 1165, 1165, 1165, 1165, 1165, 1165
1103, 108, 109, 110, 111, 128, 129, 130, 131, 132, 133, 134, 135, 136, 137, 138, 139, 140, 141, 142, 143, 160, 161, 162, 163, 164, 165, 337, 334, 66, 67, 68, 69, 70, 71, 72, 73, 74, 75, 1106, 1165, 1165, 1165, 1165, 1165, 1165, 1165, 1165, 1165, 1165, 1165, 1165, 1165, 1165, 1165, 1165, 1165, 1165, 1165, 1165, 1165, 1165, 1165, 1165, 1165, 1165, 1165, 1165, 1165, 1165, 1165, 1165, 1165, 1165, 1165, 1165, 1165, 1165, 1165, 1165
1103, 166, 167, 168, 169, 170, 956, 957, 956, 957, 956, 957, 193, 194, 195, 196, 197, 198, 199, 200, 201, 202, 203, 204, 205, 206, 207, 369, 366, 108, 109, 110, 111, 128, 129, 130, 131, 132, 133, 1106, 1165, 1165, 1165, 1165, 1165, 1165, 1165, 1165, 1165, 1165, 1165, 1165, 1165, 1165, 1165, 1165, 1165, 1165, 1165, 1165, 1165, 1165, 1165, 1165, 1165, 1165, 1165, 1165, 1165, 1165, 1165, 1165, 1165, 1165, 1165, 1165, 1165, 1165, 1165, 1165
1103, 224, 225, 226, 227, 228, 988, 989, 988, 989, 988, 989, 235, 236, 237, 238, 239, 256, 257, 258, 259, 260, 261, 262, 263, 264, 265, 401, 398, 166, 167, 168, 169, 170, 171, 172, 173, 174, 175, 1106, 1165, 1165, 1165, 1165, 1165, 1165, 1165, 1165, 1165, 1165, 1165, 1165, 1165, 1165, 1165, 1165, 1165, 1165, 1165, 1165, 1165, 1165, 1165, 1165, 1165, 1165, 1165, 1165, 1165, 1165, 1165, 1165, 1165, 1165, 1165, 1165, 1165, 1165, 1165, 1165
1103, 266, 267, 268, 269, 270, 271, 288, 289, 290, 291, 292, 293, 294, 295, 296, 297, 298, 299, 300, 301, 302, 303, 320, 0, 1, 2, 3, 4, 5, 6, 7, 8, 9, 10, 11, 12, 13, 14, 1106, 1165, 1165, 1165, 1165, 1165, 1165, 1165, 1165, 1165, 1165, 1165, 1165, 1165, 1165, 1165, 1165, 1165, 1165, 1165, 1165, 1165, 1165, 1165, 1165, 1165, 1165, 1165, 1165, 1165, 1165, 1165, 1165, 1165, 1165, 1165, 1165, 1165, 1165, 1165, 1165
1103, 1, 2, 3, 4, 5, 6, 7, 8, 9, 10, 11, 12, 13, 14, 15, 32, 33, 34, 35, 36, 37, 38, 39, 42, 43, 44, 45, 46, 47, 64, 65, 66, 67, 68, 69, 70, 71, 72, 1106, 1165, 1165, 1165, 1165, 1165, 1165, 1165, 1165, 1165, 1165, 1165, 1165, 1165, 1165, 1165, 1165, 1165, 1165, 1165, 1165, 1165, 1165, 1165, 1165, 1165, 1165, 1165, 1165, 1165, 1165, 1165, 1165, 1165, 1165, 1165, 1165, 1165, 1165, 1165, 1165
1103, 43, 44, 45, 46, 47, 64, 65, 66, 67, 68, 69, 70, 71, 72, 73, 74, 75, 76, 77, 78, 79, 96, 97, 100, 101, 102, 103, 104, 105, 106, 107, 108, 109, 110, 111, 128, 129, 130, 1106, 1165, 1165, 1165, 1165, 1165, 1165, 1165, 1165, 1165, 1165, 1165, 1165, 1165, 1165, 1165, 1165, 1165, 1165, 1165, 1165, 1165, 1165, 1165, 1165, 1165, 1165, 1165, 1165, 1165, 1165, 1165, 1165, 1165, 1165, 1165, 1165, 1165, 1165, 1165, 1165
1103, 101, 102, 103, 104, 105, 106, 107, 108, 109, 110, 111, 128, 129, 130, 131, 132, 133, 134, 135, 136, 137, 138, 139, 142, 143, 160, 161, 162, 163, 164, 165, 166, 167, 168, 169, 170, 171, 172, 1106, 1165, 1165, 1165, 1165, 1165, 1165, 1165, 1165, 1165, 1165, 1165, 1165, 1165, 1165, 1165, 1165, 1165, 1165, 1165, 1165, 1165, 1165, 1165, 1165, 1165, 1165, 1165, 1165, 1165, 1165, 1165, 1165, 1165, 1165, 1165, 1165, 1165, 1165, 1165, 1165
1103, 143, 160, 161, 162, 163, 164, 165, 166, 167, 168, 169, 170, 171, 172, 173, 174, 175, 192, 193, 194, 195, 196, 197, 200, 201, 202, 203, 204, 205, 206, 207, 224, 225, 226, 227, 228, 229, 230, 1106, 1165, 1165, 1165, 1165, 1165, 1165, 1165, 1165, 1165, 1165, 1165, 1165, 1165, 1165, 1165, 1165, 1165, 1165, 1165, 1165, 1165, 1165, 1165, 1165, 1165, 1165, 1165, 1165, 1165, 1165, 1165, 1165, 1165, 1165, 1165, 1165, 1165, 1165, 1165, 1165
1103, 201, 202, 203, 204, 205, 206, 207, 224, 225, 226, 227, 228, 229, 230, 231, 232, 233, 234, 235, 236, 237, 238, 239, 258, 259, 260, 261, 262, 263, 264, 265, 266, 267, 268, 269, 270, 271, 288, 1106, 1165, 1165, 1165, 1165, 1165, 1165, 1165, 1165, 1165, 1165, 1165, 1165, 1165, 1165, 1165, 1165, 1165, 1165, 1165, 1165, 1165, 1165, 1165, 1165, 1165, 1165, 1165, 1165, 1165, 1165, 1165, 1165, 1165, 1165, 1165, 1165, 1165, 1165, 1165, 1165
1103, 259, 260, 261, 262, 956, 957, 265, 266, 267, 268, 269, 270, 271, 288, 289, 290, 291, 292, 293, 294, 295, 296, 297, 300, 301, 302, 303, 320, 321, 322, 323, 324, 325, 326, 327, 328, 329, 330, 1106, 1165, 1165, 1165, 1165, 1165, 1165, 1165, 1165, 1165, 1165, 1165, 1165, 1165, 1165, 1165, 1165, 1165, 1165, 1165, 1165, 1165, 1165, 1165, 1165, 1165, 1165, 1165, 1165, 1165, 1165, 1165, 1165, 1165, 1165, 1165, 1165, 1165, 1165, 1165, 1165
1103, 301, 302, 303, 320, 988, 989, 323, 324, 325, 326, 327, 328, 329, 330, 331, 332, 333, 334, 335, 352, 353, 354, 355, 358, 359, 360, 361, 362, 363, 364, 365, 366, 367, 384, 385, 386, 387, 388, 1106, 1165, 1165, 1165, 1165, 1165, 1165, 1165, 1165, 1165, 1165, 1165, 1165, 1165, 1165, 1165, 1165, 1165, 1165, 1165, 1165, 1165, 1165, 1165, 1165, 1165, 1165, 1165, 1165, 1165, 1165, 1165, 1165, 1165, 1165, 1165, 1165, 1165, 1165, 1165, 1165
1103, 359, 360, 361, 362, 363, 364, 365, 366, 367, 384, 385, 386, 387, 388, 389, 390, 391, 392, 393, 394, 395, 396, 397, 416, 417, 956, 957, 420, 956, 957, 956, 957, 956, 957, 427, 428, 429, 430, 1106, 1165, 1165, 1165, 1165, 1165, 1165, 1165, 1165, 1165, 1165, 1165, 1165, 1165, 1165, 1165, 1165, 1165, 1165, 1165, 1165, 1165, 1165, 1165, 1165, 1165, 1165, 1165, 1165, 1165, 1165, 1165, 1165, 1165, 1165, 1165, 1165, 1165, 1165, 1165, 1165
1103, 417, 418, 419, 420, 421, 422, 423, 424, 425, 426, 427, 428, 429, 430, 431, 448, 449, 450, 451, 452, 453, 454, 455, 458, 459, 988, 989, 462, 988, 989, 988, 989, 988, 989, 485, 486, 487, 488, 1106, 1165, 1165, 1165, 1165, 1165, 1165, 1165, 1165, 1165, 1165, 1165, 1165, 1165, 1165, 1165, 1165, 1165, 1165, 1165, 1165, 1165, 1165, 1165, 1165, 1165, 1165, 1165, 1165, 1165, 1165, 1165, 1165, 1165, 1165, 1165, 1165, 1165, 1165, 1165, 1165
1103, 459, 460, 461, 462, 463, 480, 481, 482, 483, 484, 485, 486, 487, 488, 489, 490, 491, 492, 493, 494, 495, 0, 1, 4, 5, 6, 7, 8, 9, 10, 11, 12, 13, 14, 15, 32, 33, 34, 1106, 1165, 1165, 1165, 1165, 1165, 1165, 1165, 1165, 1165, 1165, 1165, 1165, 1165, 1165, 1165, 1165, 1165, 1165, 1165, 1165, 1165, 1165, 1165, 1165, 1165, 1165, 1165, 1165, 1165, 1165, 1165, 1165, 1165, 1165, 1165, 1165, 1165, 1165, 1165, 1165
1103, 5, 6, 7, 8, 9, 10, 11, 12, 13, 14, 15, 32, 33, 34, 35, 36, 37, 38, 39, 40, 41, 42, 43, 46, 47, 64, 65, 66, 67, 68, 69, 70, 71, 72, 73, 74, 75, 76, 1106, 1165, 1165, 1165, 1165, 1165, 1165, 1165, 1165, 1165, 1165, 1165, 1165, 1165, 1165, 1165, 1165, 1165, 1165, 1165, 1165, 1165, 1165, 1165, 1165, 1165, 1165, 1165, 1165, 1165, 1165, 1165, 1165, 1165, 1165, 1165, 1165, 1165, 1165, 1165, 1165
1103, 47, 64, 65, 66, 67, 68, 69, 70, 71, 72, 73, 74, 75, 76, 77, 78, 79, 96, 97, 98, 99, 100, 101, 102, 103, 0, 0, 0, 0, 0, 0, 0, 0, 0, 0, 0, 0, 0, 1106, 1165, 1165, 1165, 1165, 1165, 1165, 1165, 1165, 1165, 1165, 1165, 1165, 1165, 1165, 1165, 1165, 1165, 1165, 1165, 1165, 1165, 1165, 1165, 1165, 1165, 1165, 1165, 1165, 1165, 1165, 1165, 1165, 1165, 1165, 1165, 1165, 1165, 1165, 1165, 1165
1103, 0, 0, 0, 0, 0, 0, 0, 0, 0, 0, 0, 0, 0, 0, 942, 942, 942, 0, 0, 0, 0, 0, 0, 0, 0, 0, 0, 0, 0, 0, 0, 0, 0, 0, 0, 0, 0, 0, 1106, 1165, 1165, 1165, 1165, 1165, 1165, 1165, 1165, 1165, 1165, 1165, 1165, 1165, 1165, 1165, 1165, 1165, 1165, 1165, 1165, 1165, 1165, 1165, 1165, 1165, 1165, 1165, 1165, 1165, 1165, 1165, 1165, 1165, 1165, 1165, 1165, 1165, 1165, 1165, 1165
1103, 0, 0, 0, 0, 0, 0, 0, 0, 0, 0, 0, 0, 0, 942, 942, 942, 942, 0, 0, 0, 0, 0, 0, 0, 0, 0, 0, 0, 0, 0, 0, 1052, 1052, 0, 0, 0, 0, 0, 1106, 1165, 1165, 1165, 1165, 1165, 1165, 1165, 1165, 1165, 1165, 1165, 1165, 1165, 1165, 1165, 1165, 1165, 1165, 1165, 1165, 1165, 1165, 1165, 1165, 1165, 1165, 1165, 1165, 1165, 1165, 1165, 1165, 1165, 1165, 1165, 1165, 1165, 1165, 1165, 1165
1057, 1063, 1063, 1063, 1063, 1063, 1063, 1063, 1063, 1063, 1063, 1063, 1063, 1063, 1063, 1062, 1062, 1062, 1063, 1063, 1063, 1063, 1063, 1063, 1063, 1063, 1063, 1063, 1063, 1063, 1063, 1063, 1053, 1053, 1063, 1063, 1063, 1063, 1063, 1068, 1165, 1165, 1165, 1165, 1165, 1165, 1165, 1165, 1165, 1165, 1165, 1165, 1165, 1165, 1165, 1165, 1165, 1165, 1165, 1165, 1165, 1165, 1165, 1165, 1165, 1165, 1165, 1165, 1165, 1165, 1165, 1165, 1165, 1165, 1165, 1165, 1165, 1165, 1165, 1165
