1168, 1168, 1168, 1168, 1168, 1168, 1168, 1168, 1168, 1168, 1168, 1168, 1168, 1168, 1168, 1168, 1168, 1168, 1168, 1168, 1168, 1168, 1168, 1168, 1168, 1168, 1168, 1168, 1168, 1168, 1168, 1168, 1168, 1168, 1168, 1168, 1168, 1168, 1168, 1168, 1168, 1168, 1165, 1165, 1165, 1165, 1165, 1165, 1165, 1165, 1165, 1165, 1165, 1165, 1165, 1165, 1165, 1165, 1165, 1165, 1165, 1165, 1165, 1165, 1165, 1165, 1165, 1165, 1165, 1165, 1165, 1165, 1165, 1165, 1165, 1165, 1165, 1165, 1165, 1165
1168, 1168, 1168, 1168, 1168, 1168, 1168, 1168, 1168, 1168, 1168, 1168, 1168, 1168, 1168, 1168, 1168, 1168, 1168, 1168, 1168, 1168, 1168, 1168, 1168, 1168, 1168, 1168, 1168, 1168, 1168, 1168, 1168, 1168, 1168, 1168, 1168, 1168, 1168, 1168, 1168, 1168, 1165, 1165, 1165, 1165, 1165, 1165, 1165, 1165, 1165, 1165, 1165, 1165, 1165, 1165, 1165, 1165, 1165, 1165, 1165, 1165, 1165, 1165, 1165, 1165, 1165, 1165, 1165, 1165, 1165, 1165, 1165, 1165, 1165, 1165, 1165, 1165, 1165, 1165
1168, 1168, 1168, 1168, 1168, 1168, 1168, 1168, 1168, 1168, 1168, 1168, 1168, 1168, 1168, 1168, 1168, 1168, 1168, 1168, 1168, 1168, 1168, 1168, 1168, 1168, 1168, 1168, 1168, 1168, 1168, 1168, 1168, 1168, 1168, 1168, 1168, 1168, 1168, 1168, 1168, 1168, 1165, 1165, 1165, 1165, 1165, 1165, 1165, 1165, 1165, 1165, 1165, 1165, 1165, 1165, 1165, 1165, 1165, 1165, 1165, 1165, 1165, 1165, 1165, 1165, 1165, 1165, 1165, 1165, 1165, 1165, 1165, 1165, 1165, 1165, 1165, 1165, 1165, 1165
1168, 1168, 1168, 1168, 1168, 1168, 1168, 1168, 1168, 1168, 1168, 1168, 1168, 1168, 1168, 1168, 1168, 1168, 1168, 1168, 1168, 1168, 1168, 1168, 1168, 1168, 1168, 1168, 1168, 1168, 1168, 1168, 1168, 1168, 1168, 1168, 1168, 1168, 1168, 1168, 1168, 1168, 1165, 1165, 1165, 1165, 1165, 1165, 1165, 1165, 1165, 1165, 1165, 1165, 1165, 1165, 1165, 1165, 1165, 1165, 1165, 1165, 1165, 1165, 1165, 1139, 1165, 1165, 1165, 1165, 1165, 1165, 1165, 1165, 1165, 1165, 1165, 1165, 1165, 1165
1168, 1168, 1168, 1168, 1168, 1168, 1168, 1168, 1168, 1168, 1168, 1168, 1168, 1168, 1168, 1168, 1168, 1168, 1168, 1168, 1168, 1168, 1168, 1168, 1168, 1168, 1168, 1168, 1168, 1168, 1168, 1168, 1168, 1168, 1168, 1168, 1168, 1168, 1168, 1168, 1168, 1168, 1165, 1165, 1165, 1165, 1165, 1165, 1165, 1165, 1165, 1165, 1165, 1165, 1165, 1165, 1165, 1165, 1165, 1165, 1165, 1165, 1165, 1165, 1165, 1139, 1165, 1165, 1165, 1165, 1165, 1165, 1165, 1165, 1165, 1165, 1165, 1165, 1165, 1165
1168, 1168, 1168, 1168, 1168, 1168, 1168, 1168, 1168, 1168, 1168, 1168, 1168, 1168, 1168, 1168, 1168, 1168, 1168, 1168, 1089, 1093, 1093, 1093, 1093, 1093, 1093, 1093, 1093, 1093, 1093, 1093, 1093, 1093, 1093, 1093, 1093, 1093, 1093, 1093, 1093, 1093, 1094, 1095, 1096, 1093, 1094, 1095, 1096, 1093, 1094, 1095, 1096, 1093, 1094, 1095, 1096, 1093, 1094, 1095, 1096, 1093, 1094, 1095, 1096, 1100, 1165, 1165, 1165, 1165, 1165, 1165, 1165, 1165, 1165, 1165, 1165, 1165, 1165, 1165
1168, 1168, 1168, 1168, 1168, 1168, 1168, 1168, 1168, 1168, 1168, 1168, 1168, 1168, 1168, 1168, 1168, 1168, 1168, 1168, 1103, 110, 110, 102, 115, 116, 117, 118, 119, 108, 109, 110, 111, 0, 0, 64, 65, 66, 67, 11, 12, 13, 14, 15, 1053, 1053, 117, 118, 119, 15, 16, 17, 18, 1053, 1052, 1052, 1053, 23, 24, 25, 43, 44, 45, 1053, 245, 1138, 1165, 1165, 1165, 1165, 1165, 1165, 1165, 1165, 1165, 1165, 1165, 1165, 1165, 1165
1168, 1168, 1168, 1168, 1168, 1168, 1168, 1168, 1168, 1168, 1168, 1168, 1168, 1168, 1168, 1168, 1168, 1168, 1168, 1168, 1135, 142, 142, 134, 147, 148, 149, 150, 151, 140, 141, 142, 143, 0, 0, 96, 97, 98, 99, 48, 49, 50, 51, 52, 1053, 1053, 149, 150, 151, 244, 245, 244, 245, 1053, 1053, 1053, 1053, 244, 245, 245, 244, 245, 244, 1053, 277, 1074, 1165, 1165, 1165, 1165, 1165, 1165, 1165, 1165, 1165, 1165, 1165, 1165, 1165, 1165
1168, 1168, 1168, 1168, 1168, 1168, 1168, 1168, 1168, 1168, 1168, 1168, 1168, 1168, 1168, 1168, 1168, 1168, 1168, 1168, 1071, 174, 174, 166, 179, 180, 181, 182, 183, 172, 173, 174, 175, 0, 134, 128, 129, 130, 131, 85, 86, 87, 88, 89, 1053, 1053, 181, 182, 183, 276, 277, 276, 277, 276, 277, 276, 277, 276, 277, 277, 276, 277, 276, 1053, 121, 1106, 1165, 1165, 1165, 1165, 1165, 1165, 1165, 1165, 1165, 1165, 1165, 1165, 1165, 1165
1168, 1168, 1168, 1168, 1168, 1168, 1168, 1168, 1168, 1168, 1168, 1168, 1168, 1168, 1168, 1168, 1168, 1168, 1168, 1168, 1103, 206, 206, 198, 211, 212, 213, 214, 215, 204, 205, 206, 207, 144, 166, 160, 161, 162, 163, 139, 140, 141, 142, 143, 1053, 1053, 213, 214, 215, 143, 144, 145, 146, 147, 148, 149, 150, 151, 152, 153, 171, 172, 173, 1053, 175, 1138, 1165, 1165, 1165, 1165, 1165, 1165, 1165, 1165, 1165, 1165, 1165, 1165, 1165, 1165
1168, 1168, 1168, 1168, 1168, 1168, 1168, 1168, 1168, 1168, 1168, 1168, 1168, 1168, 1168, 1168, 1168, 1168, 1168, 1168, 1135, 238, 238, 230, 243, 244, 245, 246, 247, 236, 237, 238, 239, 176, 198, 192, 193, 194, 195, 176, 177, 178, 179, 180, 1053, 1053, 245, 246, 247, 180, 181, 182, 183, 184, 185, 203, 204, 205, 206, 207, 208, 209, 210, 211, 212, 1074, 1165, 1165, 1165, 1165, 1165, 1165, 1165, 1165, 1165, 1165, 1165, 1165, 1165, 1165
1168, 1168, 1168, 1168, 1168, 1168, 1168, 1168, 1168, 1168, 1168, 1168, 1168, 1168, 1168, 1168, 1168, 1168, 1168, 1168, 1071, 270, 270, 262, 263, 264, 265, 266, 267, 268, 269, 270, 271, 208, 230, 224, 225, 226, 227, 213, 214, 215, 216, 217, 1053, 1053, 214, 215, 216, 217, 235, 236, 237, 238, 239, 240, 241, 242, 243, 244, 245, 246, 247, 248, 249, 1106, 1165, 1165, 1165, 1165, 1165, 1165, 1165, 1165, 1165, 1165, 1165, 1165, 1165, 1165
1168, 1168, 1168, 1168, 1168, 1168, 1168, 1168, 1168, 1168, 1168, 1168, 1168, 1168, 1168, 1168, 1168, 1168, 1168, 1168, 1103, 110, 110, 294, 295, 296, 297, 298, 299, 300, 301, 302, 303, 240, 262, 256, 257, 258, 259, 267, 268, 269, 270, 271, 1053, 1053, 268, 269, 270, 271, 272, 273, 274, 275, 276, 277, 278, 279, 280, 281, 299, 300, 301, 302, 303, 1138, 1165, 1165, 1165, 1165, 1165, 1165, 1165, 1165, 1165, 1165, 1165, 1165, 1165, 1165
1168, 1168, 1168, 1168, 1168, 1168, 1168, 1168, 1168, 1168, 1168, 1168, 1168, 1168, 1168, 1168, 1168, 1168, 1168, 1168, 1135, 142, 142, 326, 327, 328, 329, 330, 331, 332, 333, 334, 335, 272, 294, 288, 289, 290, 291, 304, 305, 306, 307, 308, 1053, 1053, 305, 306, 307, 308, 309, 310, 311, 312, 313, 331, 332, 333, 334, 335, 336, 337, 338, 339, 340, 1074, 1165, 1165, 1165, 1165, 1165, 1165, 1165, 1165, 1165, 1165, 1165, 1165, 1165, 1165
1168, 1168, 1168, 1168, 1168, 1168, 1168, 1168, 1168, 1168, 1168, 1168, 1168, 1168, 1168, 1168, 1168, 1168, 1168, 1168, 1071, 174, 174, 358, 359, 360, 361, 362, 363, 364, 365, 366, 367, 304, 326, 320, 321, 322, 323, 341, 342, 343, 344, 345, 1053, 1053, 342, 343, 344, 345, 363, 364, 365, 366, 367, 368, 369, 370, 371, 372, 373, 374, 375, 376, 377, 1106, 1165, 1165, 1165, 1165, 1165, 1165, 1165, 1165, 1165, 1165, 1165, 1165, 1165, 1165
1168, 1168, 1168, 1168, 1168, 1168, 1168, 1168, 1168, 1168, 1168, 1168, 1168, 1168, 1168, 1168, 1168, 1168, 1168, 1168, 1103, 206, 206, 390, 391, 392, 393, 394, 395, 396, 397, 398, 399, 336, 358, 352, 353, 354, 355, 395, 396, 397, 398, 399, 1053, 1053, 396, 397, 398, 399, 400, 401, 402, 403, 404, 405, 406, 407, 408, 409, 427, 428, 429, 430, 431, 1074, 1165, 1165, 1165, 1165, 1165, 1165, 1165, 1165, 1165, 1165, 1165, 1165, 1165, 1165
1168, 1168, 1168, 1168, 1168, 1168, 1168, 1168, 1168, 1168, 1168, 1168, 1168, 1168, 1168, 1168, 1168, 1168, 1168, 1168, 1135, 238, 238, 422, 423, 424, 425, 426, 427, 428, 429, 430, 431, 368, 390, 384, 385, 386, 387, 432, 433, 434, 435, 436, 1053, 1053, 433, 434, 435, 436, 437, 438, 439, 440, 441, 459, 460, 461, 462, 463, 464, 465, 466, 467, 468, 1106, 1165, 1165, 1165, 1165, 1165, 1165, 1165, 1165, 1165, 1165, 1165, 1165, 1165, 1165
1168, 1168, 1168, 1168, 1168, 1168, 1168, 1168, 1168, 1168, 1168, 1168, 1168, 1168, 1168, 1168, 1168, 1168, 1168, 1168, 1071, 270, 270, 454, 455, 456, 457, 458, 459, 460, 461, 462, 463, 145, 422, 416, 417, 418, 419, 469, 470, 471, 472, 473, 1053, 1053, 470, 471, 472, 473, 11, 12, 13, 14, 15, 16, 17, 18, 19, 20, 21, 22, 23, 24, 25, 1138, 1165, 1165, 1165, 1165, 1165, 1165, 1165, 1165, 1165, 1165, 1165, 1165, 1165, 1165
1168, 1168, 1168, 1168, 1168, 1168, 1168, 1168, 1168, 1168, 1168, 1168, 1168, 1168, 1168, 1168, 1168, 1168, 1168, 1168, 1103, 110, 110, 486, 487, 488, 489, 490, 491, 492, 493, 494, 495, 177, 454, 448, 449, 450, 451, 43, 44, 45, 46, 47, 48, 43, 44, 45, 46, 47, 48, 49, 50, 51, 52, 53, 54, 55, 56, 57, 75, 76, 77, 78, 79, 1074, 1165, 1165, 1165, 1165, 1165, 1165, 1165, 1165, 1165, 1165, 1165, 1165, 1165, 1165
1168, 1168, 1168, 1168, 1168, 1168, 1168, 1168, 1168, 1168, 1168, 1168, 1168, 1168, 1168, 1168, 1168, 1168, 1168, 1168, 1135, 142, 142, 38, 39, 40, 41, 203, 204, 205, 206, 207, 208, 209, 486, 480, 481, 482, 483, 80, 81, 82, 83, 84, 85, 80, 81, 82, 83, 84, 85, 86, 87, 88, 89, 107, 108, 109, 110, 111, 112, 113, 114, 115, 116, 1106, 1165, 1165, 1165, 1165, 1165, 1165, 1165, 1165, 1165, 1165, 1165, 1165, 1165, 1165
1168, 1168, 1168, 1168, 1168, 1168, 1168, 1168, 1168, 1168, 1168, 1168, 1168, 1168, 1168, 1168, 1168, 1168, 1168, 1168, 1071, 174, 174, 117, 118, 119, 115, 116, 117, 118, 119, 116, 117, 118, 119, 115, 116, 117, 118, 119, 118, 119, 120, 121, 139, 117, 118, 119, 120, 121, 139, 140, 141, 142, 143, 144, 145, 146, 147, 148, 149, 150, 151, 152, 153, 1138, 1165, 1165, 1165, 1165, 1165, 1165, 1165, 1165, 1165, 1165, 1165, 1165, 1165, 1165
1168, 1168, 1168, 1168, 1168, 1168, 1168, 1168, 1168, 1168, 1168, 1168, 1168, 1168, 1168, 1168, 1168, 1168, 1168, 1168, 1103, 206, 206, 149, 150, 151, 147, 148, 149, 150, 151, 148, 149, 150, 151, 147, 148, 149, 150, 151, 172, 173, 174, 175, 176, 171, 172, 173, 174, 175, 176, 177, 178, 179, 180, 181, 182, 183, 184, 185, 203, 204, 205, 331, 331, 1074, 1165, 1165, 1165, 1165, 1165, 1165, 1165, 1165, 1165, 1165, 1165, 1165, 1165, 1165
1168, 1168, 1168, 1168, 1168, 1168, 1168, 1168, 1168, 1168, 1168, 1168, 1168, 1168, 1168, 1168, 1168, 1168, 1168, 1168, 1135, 238, 238, 181, 182, 183, 179, 180, 181, 182, 183, 180, 181, 182, 183, 179, 180, 181, 182, 183, 118, 119, 211, 212, 213, 208, 209, 210, 211, 212, 213, 214, 215, 216, 217, 235, 236, 237, 238, 239, 240, 241, 242, 331, 331, 1106, 1165, 1165, 1165, 1165, 1165, 1165, 1165, 1165, 1165, 1165, 1165, 1165, 1165, 1165
1168, 1168, 1168, 1168, 1168, 1168, 1168, 1168, 1168, 1168, 1168, 1168, 1168, 1168, 1168, 1168, 1168, 1168, 1168, 1168, 1071, 270, 270, 213, 214, 215, 211, 212, 213, 214, 215, 212, 213, 214, 215, 211, 212, 213, 214, 215, 150, 151, 248, 249, 267, 245, 246, 247, 248, 249, 267, 268, 269, 270, 271, 272, 115, 116, 117, 118, 119, 278, 279, 232, 233, 1138, 1165, 1165, 1165, 1165, 1165, 1165, 1165, 1165, 1165, 1165, 1165, 1165, 1165, 1165
1168, 1168, 1168, 1168, 1168, 1168, 1168, 1168, 1168, 1168, 1168, 1168, 1168, 1168, 1168, 1168, 1168, 1168, 1168, 1168, 1103, 110, 110, 245, 246, 247, 243, 244, 245, 246, 247, 244, 245, 246, 247, 243, 244, 245, 246, 247, 182, 183, 302, 303, 304, 299, 300, 301, 302, 303, 304, 305, 306, 307, 308, 309, 147, 148, 149, 150, 115, 116, 117, 118, 119, 1074, 1165, 1165, 1165, 1165, 1165, 1165, 1165, 1165, 1165, 1165, 1165, 1165, 1165, 1165
1168, 1168, 1168, 1168, 1168, 1168, 1168, 1168, 1168, 1168, 1168, 1168, 1168, 1168, 1168, 1168, 1168, 1168, 1168, 1168, 1135, 142, 142, 354, 355, 356, 357, 395, 396, 258, 259, 260, 261, 262, 263, 264, 265, 211, 212, 213, 214, 215, 339, 340, 341, 336, 1026, 1026, 1026, 340, 1026, 1026, 343, 1026, 1026, 363, 179, 180, 181, 182, 147, 148, 149, 331, 331, 1106, 1165, 1165, 1165, 1165, 1165, 1165, 1165, 1165, 1165, 1165, 1165, 1165, 1165, 1165
1168, 1168, 1168, 1168, 1168, 1168, 1168, 1168, 1168, 1168, 1168, 1168, 1168, 1168, 1168, 1168, 1168, 1168, 1168, 1168, 1071, 110, 174, 396, 397, 398, 399, 427, 428, 300, 301, 302, 303, 320, 321, 322, 323, 243, 244, 245, 246, 247, 14, 15, 16, 176, 177, 178, 179, 180, 181, 182, 183, 184, 185, 203, 211, 212, 213, 214, 179, 180, 181, 331, 331, 1138, 1165, 1165, 1165, 1165, 1165, 1165, 1165, 1165, 1165, 1165, 1165, 1165, 1165, 1165
1168, 1168, 1168, 1168, 1168, 1168, 1168, 1168, 1168, 1168, 1168, 1168, 1168, 1168, 1168, 1168, 1168, 1168, 1168, 1168, 1103, 142, 206, 454, 455, 456, 457, 1027, 1027, 358, 1027, 1027, 361, 362, 1027, 1027, 365, 366, 1027, 1027, 49, 50, 51, 52, 53, 213, 214, 215, 216, 217, 235, 236, 237, 238, 239, 240, 243, 244, 245, 246, 211, 212, 213, 331, 331, 1074, 1165, 1165, 1165, 1165, 1165, 1165, 1165, 1165, 1165, 1165, 1165, 1165, 1165, 1165
1168, 1168, 1168, 1168, 1168, 1168, 1168, 1168, 1168, 1168, 1168, 1168, 1168, 1168, 1168, 1168, 1168, 1168, 1168, 1168, 1135, 174, 238, 0, 1, 2, 3, 167, 168, 416, 417, 418, 419, 420, 421, 422, 423, 424, 425, 85, 86, 87, 88, 89, 107, 267, 268, 269, 270, 271, 272, 273, 274, 275, 276, 277, 278, 279, 243, 244, 243, 244, 245, 331, 331, 1106, 1165, 1165, 1165, 1165, 1165, 1165, 1165, 1165, 1165, 1165, 1165, 1165, 1165, 1165
1168, 1168, 1168, 1168, 1168, 1168, 1168, 1168, 1168, 1168, 1168, 1168, 1168, 1168, 1168, 1168, 1168, 1168, 1168, 1168, 1071, 206, 270, 42, 43, 44, 45, 199, 200, 458, 459, 460, 461, 462, 463, 480, 481, 482, 483, 139, 140, 141, 142, 143, 144, 304, 305, 306, 307, 308, 309, 310, 311, 312, 313, 331, 332, 333, 334, 335, 115, 116, 117, 118, 119, 1138, 1165, 1165, 1165, 1165, 1165, 1165, 1165, 1165, 1165, 1165, 1165, 1165, 1165, 1165
1168, 1168, 1168, 1168, 1168, 1168, 1168, 1168, 1168, 1168, 1168, 1168, 1168, 1168, 1168, 1168, 1168, 1168, 1168, 1168, 1103, 238, 110, 100, 101, 102, 103, 231, 232, 4, 5, 6, 7, 8, 9, 10, 11, 12, 13, 176, 177, 178, 179, 180, 181, 341, 342, 343, 344, 345, 363, 364, 365, 366, 367, 368, 369, 370, 371, 372, 147, 148, 149, 150, 151, 1074, 1165, 1165, 1165, 1165, 1165, 1165, 1165, 1165, 1165, 1165, 1165, 1165, 1165, 1165
1168, 1168, 1168, 1168, 1168, 1168, 1168, 1168, 1168, 1168, 1168, 1168, 1168, 1168, 1168, 1168, 1168, 1168, 1168, 1168, 1135, 270, 141, 142, 143, 160, 161, 263, 264, 46, 47, 64, 65, 66, 67, 68, 69, 70, 71, 213, 214, 215, 216, 217, 235, 395, 396, 397, 398, 399, 400, 401, 402, 403, 404, 405, 406, 407, 408, 409, 179, 180, 181, 331, 331, 1106, 1165, 1165, 1165, 1165, 1165, 1165, 1165, 1165, 1165, 1165, 1165, 1165, 1165, 1165
1168, 1168, 1168, 1168, 1168, 1168, 1168, 1168, 1168, 1168, 1168, 1168, 1168, 1168, 1168, 1168, 1168, 1168, 1168, 1168, 1071, 110, 199, 200, 201, 202, 203, 295, 296, 104, 105, 106, 107, 108, 109, 110, 111, 128, 129, 267, 268, 269, 270, 271, 272, 432, 433, 434, 435, 436, 437, 438, 439, 440, 441, 459, 460, 461, 462, 463, 211, 212, 213, 331, 331, 1138, 1165, 1165, 1165, 1165, 1165, 1165, 1165, 1165, 1165, 1165, 1165, 1165, 1165, 1165
1168, 1168, 1168, 1168, 1168, 1168, 1168, 1168, 1168, 1168, 1168, 1168, 1168, 1168, 1168, 1168, 1168, 1168, 1168, 1168, 1103, 142, 257, 258, 259, 260, 261, 327, 328, 162, 163, 164, 165, 166, 167, 168, 169, 170, 171, 304, 305, 306, 307, 308, 309, 469, 470, 471, 472, 473, 11, 12, 13, 14, 15, 16, 17, 18, 19, 20, 243, 244, 245, 331, 331, 1074, 1165, 1165, 1165, 1165, 1165, 1165, 1165, 1165, 1165, 1165, 1165, 1165, 1165, 1165
1168, 1168, 1168, 1168, 1168, 1168, 1168, 1168, 1168, 1168, 1168, 1168, 1168, 1168, 1168, 1168, 1168, 1168, 1168, 1168, 1135, 174, 299, 300, 301, 302, 956, 957, 360, 204, 205, 206, 207, 224, 225, 226, 227, 228, 229, 341, 342, 343, 344, 345, 363, 43, 44, 45, 46, 47, 48, 49, 50, 51, 52, 53, 54, 55, 56, 57, 75, 76, 77, 331, 331, 1106, 1165, 1165, 1165, 1165, 1165, 1165, 1165, 1165, 1165, 1165, 1165, 1165, 1165, 1165
1168, 1168, 1168, 1168, 1168, 1168, 1168, 1168, 1168, 1168, 1168, 1168, 1168, 1168, 1168, 1168, 1168, 1168, 1168, 1168, 1071, 206, 357, 358, 359, 360, 988, 989, 142, 262, 263, 264, 265, 266, 267, 268, 269, 270, 271, 395, 396, 397, 398, 399, 400, 80, 1026, 1026, 1026, 84, 1026, 1026, 87, 1026, 1026, 107, 108, 109, 110, 111, 112, 113, 114, 115, 116, 1138, 1165, 1165, 1165, 1165, 1165, 1165, 1165, 1165, 1165, 1165, 1165, 1165, 1165, 1165
1168, 1168, 1168, 1168, 1168, 1168, 1168, 1168, 1168, 1168, 1168, 1168, 1168, 1168, 1168, 1168, 1168, 1168, 1168, 1168, 1103, 238, 399, 416, 417, 418, 419, 177, 174, 320, 321, 322, 323, 324, 325, 326, 327, 328, 329, 432, 433, 434, 435, 436, 437, 117, 118, 119, 120, 121, 139, 140, 141, 142, 143, 144, 145, 146, 147, 148, 149, 150, 151, 152, 153, 1074, 1165, 1165, 1165, 1165, 1165, 1165, 1165, 1165, 1165, 1165, 1165, 1165, 1165, 1165
1168, 1168, 1168, 1168, 1168, 1168, 1168, 1168, 1168, 1168, 1168, 1168, 1168, 1168, 1168, 1168, 1168, 1168, 1168, 1168, 1135, 270, 457, 458, 459, 460, 461, 209, 206, 362, 363, 364, 365, 366, 367, 384, 385, 386, 387, 469, 470, 471, 472, 473, 11, 171, 172, 173, 174, 175, 176, 177, 178, 179, 180, 181, 182, 183, 184, 185, 203, 204, 205, 331, 331, 1106, 1165, 1165, 1165, 1165, 1165, 1165, 1165, 1165, 1165, 1165, 1165, 1165, 1165, 1165
1168, 1168, 1168, 1168, 1168, 1168, 1168, 1168, 1168, 1168, 1168, 1168, 1168, 1168, 1168, 1168, 1168, 1168, 1168, 1168, 1071, 110, 3, 4, 5, 6, 7, 241, 238, 420, 421, 422, 423, 424, 425, 426, 427, 428, 429, 43, 44, 45, 46, 47, 48, 208, 209, 210, 211, 212, 213, 214, 215, 216, 217, 235, 236, 237, 238, 239, 240, 241, 242, 331, 331, 1138, 1165, 1165, 1165, 1165, 1165, 1165, 1165, 1165, 1165, 1165, 1165, 1165, 1165, 1165
1168, 1168, 1168, 1168, 1168, 1168, 1168, 1168, 1168, 1168, 1168, 1168, 1168, 1168, 1168, 1168, 1168, 1168, 1168, 1168, 1103, 142, 45, 46, 47, 64, 65, 273, 270, 462, 463, 480, 481, 482, 483, 484, 485, 486, 487, 11, 12, 13, 14, 15, 16, 245, 246, 247, 248, 249, 267, 268, 269, 270, 271, 272, 273, 274, 275, 276, 277, 278, 279, 331, 331, 1074, 1165, 1165, 1165, 1165, 1165, 1165, 1165, 1165, 1165, 1165, 1165, 1165, 1165, 1165
1168, 1168, 1168, 1168, 1168, 1168, 1168, 1168, 1168, 1168, 1168, 1168, 1168, 1168, 1168, 1168, 1168, 1168, 1168, 1168, 1135, 174, 103, 104, 105, 106, 107, 305, 302, 8, 9, 10, 11, 12, 13, 14, 15, 32, 33, 48, 49, 50, 51, 52, 53, 299, 300, 301, 302, 303, 304, 305, 306, 307, 308, 309, 310, 311, 312, 313, 331, 332, 333, 331, 331, 1106, 1165, 1165, 1165, 1165, 1165, 1165, 1165, 1165, 1165, 1165, 1165, 1165, 1165, 1165
1168, 1168, 1168, 1168, 1168, 1168, 1168, 1168, 1168, 1168, 1168, 1168, 1168, 1168, 1168, 1168, 1168, 1168, 1168, 1168, 1071, 206, 161, 162, 163, 164, 165, 1027, 1027, 66, 1027, 1027, 69, 1027, 1027, 72, 73, 1027, 1027, 85, 86, 87, 88, 89, 107, 336, 337, 338, 339, 340, 341, 342, 343, 344, 345, 363, 364, 365, 366, 367, 368, 369, 370, 371, 372, 1138, 1165, 1165, 1165, 1165, 1165, 1165, 1165, 1165, 1165, 1165, 1165, 1165, 1165, 1165
1168, 1168, 1168, 1168, 1168, 1168, 1168, 1168, 1168, 1168, 1168, 1168, 1168, 1168, 1168, 1168, 1168, 1168, 1168, 1168, 1103, 238, 203, 204, 205, 206, 207, 369, 366, 108, 109, 110, 111, 128, 129, 130, 131, 132, 133, 139, 140, 141, 142, 143, 144, 139, 140, 141, 142, 143, 144, 145, 146, 147, 148, 149, 150, 151, 152, 153, 171, 172, 173, 174, 175, 1074, 1165, 1165, 1165, 1165, 1165, 1165, 1165, 1165, 1165, 1165, 1165, 1165, 1165, 1165
1168, 1168, 1168, 1168, 1168, 1168, 1168, 1168, 1168, 1168, 1168, 1168, 1168, 1168, 1168, 1168, 1168, 1168, 1168, 1168, 1135, 270, 261, 262, 263, 264, 265, 401, 398, 166, 167, 168, 169, 170, 171, 172, 173, 174, 175, 176, 177, 178, 179, 180, 181, 176, 177, 178, 179, 180, 181, 182, 183, 184, 185, 203, 204, 205, 206, 207, 208, 209, 210, 211, 212, 1106, 1165, 1165, 1165, 1165, 1165, 1165, 1165, 1165, 1165, 1165, 1165, 1165, 1165, 1165
1168, 1168, 1168, 1168, 1168, 1168, 1168, 1168, 1168, 1168, 1168, 1168, 1168, 1168, 1168, 1168, 1168, 1168, 1168, 1168, 1071, 110, 303, 320, 0, 1, 2, 3, 4, 5, 6, 7, 8, 9, 10, 11, 12, 13, 14, 213, 214, 215, 216, 217, 235, 213, 214, 215, 216, 217, 235, 236, 237, 238, 239, 240, 241, 242, 243, 244, 245, 246, 247, 248, 249, 1138, 1165, 1165, 1165, 1165, 1165, 1165, 1165, 1165, 1165, 1165, 1165, 1165, 1165, 1165
1168, 1168, 1168, 1168, 1168, 1168, 1168, 1168, 1168, 1168, 1168, 1168, 1168, 1168, 1168, 1168, 1168, 1168, 1168, 1168, 1071, 142, 116, 117, 118, 119, 116, 117, 118, 119, 115, 116, 117, 118, 119, 117, 118, 119, 72, 267, 268, 269, 270, 271, 272, 267, 268, 269, 270, 271, 272, 273, 274, 275, 276, 277, 278, 279, 280, 281, 299, 300, 301, 302, 303, 1074, 1165, 1165, 1165, 1165, 1165, 1165, 1165, 1165, 1165, 1165, 1165, 1165, 1165, 1165
1168, 1168, 1168, 1168, 1168, 1168, 1168, 1168, 1168, 1168, 1168, 1168, 1168, 1168, 1168, 1168, 1168, 1168, 1168, 1168, 1103, 174, 148, 149, 150, 151, 148, 149, 150, 151, 147, 148, 149, 150, 151, 149, 150, 151, 117, 118, 119, 306, 307, 308, 309, 304, 305, 306, 307, 308, 309, 310, 311, 312, 313, 331, 332, 333, 334, 335, 336, 337, 338, 339, 340, 1106, 1165, 1165, 1165, 1165, 1165, 1165, 1165, 1165, 1165, 1165, 1165, 1165, 1165, 1165
1168, 1168, 1168, 1168, 1168, 1168, 1168, 1168, 1168, 1168, 1168, 1168, 1168, 1168, 1168, 1168, 1168, 1168, 1168, 1168, 1135, 206, 180, 181, 182, 183, 180, 181, 182, 183, 179, 180, 181, 182, 183, 181, 182, 183, 149, 150, 151, 343, 344, 345, 1053, 1053, 342, 343, 344, 345, 363, 364, 365, 366, 367, 368, 369, 370, 371, 372, 373, 374, 375, 376, 377, 1138, 1165, 1165, 1165, 1165, 1165, 1165, 1165, 1165, 1165, 1165, 1165, 1165, 1165, 1165
1168, 1168, 1168, 1168, 1168, 1168, 1168, 1168, 1168, 1168, 1168, 1168, 1168, 1168, 1168, 1168, 1168, 1168, 1168, 1168, 1071, 238, 212, 213, 214, 215, 212, 213, 214, 215, 211, 212, 213, 214, 215, 213, 214, 215, 181, 182, 183, 397, 398, 399, 1053, 1053, 396, 397, 398, 399, 400, 401, 402, 403, 404, 405, 406, 407, 408, 409, 427, 428, 429, 430, 431, 1074, 1165, 1165, 1165, 1165, 1165, 1165, 1165, 1165, 1165, 1165, 1165, 1165, 1165, 1165
1168, 1168, 1168, 1168, 1168, 1168, 1168, 1168, 1168, 1168, 1168, 1168, 1168, 1168, 1168, 1168, 1168, 1168, 1168, 1168, 1103, 270, 244, 245, 246, 247, 244, 245, 246, 247, 243, 244, 245, 246, 247, 245, 246, 247, 213, 214, 215, 434, 435, 436, 1053, 1053, 433, 434, 435, 436, 437, 438, 439, 440, 441, 459, 460, 461, 462, 463, 464, 465, 466, 467, 468, 1106, 1165, 1165, 1165, 1165, 1165, 1165, 1165, 1165, 1165, 1165, 1165, 1165, 1165, 1165
1168, 1168, 1168, 1168, 1168, 1168, 1168, 1168, 1168, 1168, 1168, 1168, 1168, 1168, 1168, 1168, 1168, 1168, 1168, 1168, 1135, 110, 296, 297, 300, 301, 302, 303, 320, 321, 322, 323, 324, 325, 326, 327, 243, 244, 245, 246, 247, 471, 472, 473, 1053, 1053, 470, 471, 472, 473, 11, 12, 13, 14, 15, 16, 17, 18, 19, 20, 21, 22, 23, 24, 25, 1138, 1165, 1165, 1165, 1165, 1165, 1165, 1165, 1165, 1165, 1165, 1165, 1165, 1165, 1165
1168, 1168, 1168, 1168, 1168, 1168, 1168, 1168, 1168, 1168, 1168, 1168, 1168, 1168, 1168, 1168, 1168, 1168, 1168, 1168, 1071, 266, 354, 355, 358, 359, 360, 361, 362, 363, 364, 365, 366, 367, 384, 385, 386, 387, 388, 43, 44, 45, 46, 47, 1053, 1053, 44, 45, 46, 47, 48, 49, 50, 51, 52, 53, 54, 55, 56, 57, 75, 76, 77, 78, 79, 1074, 1165, 1165, 1165, 1165, 1165, 1165, 1165, 1165, 1165, 1165, 1165, 1165, 1165, 1165
1168, 1168, 1168, 1168, 1168, 1168, 1168, 1168, 1168, 1168, 1168, 1168, 1168, 1168, 1168, 1168, 1168, 1168, 1168, 1168, 1103, 266, 396, 397, 416, 417, 956, 957, 420, 956, 957, 956, 957, 956, 957, 427, 428, 429, 430, 80, 81, 82, 83, 84, 1053, 1053, 81, 82, 83, 84, 85, 86, 87, 88, 89, 107, 108, 109, 110, 111, 112, 113, 114, 115, 116, 1106, 1165, 1165, 1165, 1165, 1165, 1165, 1165, 1165, 1165, 1165, 1165, 1165, 1165, 1165
1168, 1168, 1168, 1168, 1168, 1168, 1168, 1168, 1168, 1168, 1168, 1168, 1168, 1168, 1168, 1168, 1168, 1168, 1168, 1168, 1135, 266, 1053, 455, 458, 459, 988, 989, 462, 988, 989, 988, 989, 988, 989, 485, 486, 487, 488, 117, 118, 119, 120, 121, 1053, 1053, 115, 116, 117, 118, 119, 140, 141, 142, 143, 144, 145, 146, 147, 148, 149, 150, 151, 152, 153, 1138, 1165, 1165, 1165, 1165, 1165, 1165, 1165, 1165, 1165, 1165, 1165, 1165, 1165, 1165
1168, 1168, 1168, 1168, 1168, 1168, 1168, 1168, 1168, 1168, 1168, 1168, 1168, 1168, 1168, 1168, 1168, 1168, 1168, 1168, 1071, 266, 1053, 1, 4, 5, 6, 7, 8, 9, 10, 11, 12, 13, 14, 15, 32, 33, 34, 171, 172, 173, 174, 175, 1053, 1053, 115, 116, 117, 118, 119, 177, 178, 179, 180, 181, 182, 183, 184, 185, 203, 204, 205, 206, 207, 1074, 1165, 1165, 1165, 1165, 1165, 1165, 1165, 1165, 1165, 1165, 1165, 1165, 1165, 1165
1168, 1168, 1168, 1168, 1168, 1168, 1168, 1168, 1168, 1168, 1168, 1168, 1168, 1168, 1168, 1168, 1168, 1168, 1168, 1168, 1103, 266, 1053, 43, 46, 47, 64, 65, 66, 67, 68, 69, 70, 71, 72, 73, 74, 75, 76, 208, 209, 210, 211, 212, 1053, 1053, 147, 148, 149, 150, 151, 214, 215, 216, 217, 235, 236, 237, 238, 239, 240, 241, 242, 243, 244, 1106, 1165, 1165, 1165, 1165, 1165, 1165, 1165, 1165, 1165, 1165, 1165, 1165, 1165, 1165
1168, 1168, 1168, 1168, 1168, 1168, 1168, 1168, 1168, 1168, 1168, 1168, 1168, 1168, 1168, 1168, 1168, 1168, 1168, 1168, 1135, 266, 1053, 101, 102, 103, 0, 0, 0, 0, 0, 245, 0, 0, 0, 0, 0, 0, 0, 245, 246, 247, 248, 249, 1053, 1053, 179, 180, 181, 182, 183, 268, 269, 270, 271, 272, 273, 274, 275, 276, 277, 278, 279, 280, 281, 1138, 1165, 1165, 1165, 1165, 1165, 1165, 1165, 1165, 1165, 1165, 1165, 1165, 1165, 1165
1168, 1168, 1168, 1168, 1168, 1168, 1168, 1168, 1168, 1168, 1168, 1168, 1168, 1168, 1168, 1168, 1168, 1168, 1168, 1168, 1103, 266, 1053, 0, 0, 0, 0, 0, 0, 0, 0, 0, 245, 0, 0, 0, 245, 0, 0, 299, 300, 301, 302, 303, 1053, 1053, 211, 212, 213, 214, 215, 305, 306, 307, 308, 1053, 1053, 1053, 1053, 313, 331, 332, 333, 334, 335, 1074, 1165, 1165, 1165, 1165, 1165, 1165, 1165, 1165, 1165, 1165, 1165, 1165, 1165, 1165
1168, 1168, 1168, 1168, 1168, 1168, 1168, 1168, 1168, 1168, 1168, 1168, 1168, 1168, 1168, 1168, 1168, 1168, 1168, 1168, 1103, 266, 1053, 976, 976, 0, 0, 0, 0, 0, 0, 0, 406, 406, 0, 0, 0, 0, 0, 336, 337, 338, 339, 340, 1053, 1053, 243, 244, 245, 246, 247, 342, 343, 344, 345, 1053, 1052, 1052, 1053, 367, 368, 369, 370, 371, 372, 1106, 1165, 1165, 1165, 1165, 1165, 1165, 1165, 1165, 1165, 1165, 1165, 1165, 1165, 1165
1168, 1168, 1168, 1168, 1168, 1168, 1168, 1168, 1168, 1168, 1168, 1168, 1168, 1168, 1168, 1168, 1168, 1168, 1168, 1168, 1057, 1064, 1065, 1066, 1063, 1064, 1063, 1064, 1065, 1066, 1063, 1064, 1065, 1066, 1063, 1064, 1065, 1066, 1063, 1064, 1065, 1066, 1063, 1064, 1065, 1066, 1063, 1064, 1065, 1066, 1063, 1064, 1065, 1066, 1063, 1064, 1065, 1066, 1063, 1064, 1065, 1066, 1063, 1064, 1065, 1068, 1165, 1165, 1165, 1165, 1165, 1165, 1165, 1165, 1165, 1165, 1165, 1165, 1165, 1165
