1121, 1121, 1121, 1121, 1121, 1121, 1121, 1121, 1121, 1121, 1121, 1121, 1121, 1121, 1121, 1121, 1121, 1121, 1121, 1121, 1121, 1121, 1121, 1121, 1121, 1121, 1121, 1121, 1121, 1121, 1121, 1121, 1121, 1121, 1121, 1121, 1121, 1121, 1121, 1121, 1121, 1121, 1121, 1121, 1121, 1121, 1121, 1121, 1121, 1121, 1121, 1121, 1121, 1121, 1121, 1121, 1121, 1121, 1121, 1121, 1121, 1121, 1121, 1121, 1121, 1121, 1121, 1121, 1121, 1121, 1121, 1121, 1121, 1121, 1121, 1121, 1121, 1121, 1121, 1121
1121, 1121, 1121, 1121, 1121, 1121, 1121, 1121, 1121, 1121, 1121, 1121, 1121, 1121, 1121, 1121, 1121, 1121, 1121, 1121, 1121, 1121, 1121, 1121, 1121, 1121, 1121, 1121, 1121, 1121, 1121, 1121, 1121, 1121, 1121, 1121, 1121, 1121, 1121, 1121, 1121, 1121, 1121, 1121, 1121, 1121, 1121, 1121, 1121, 1121, 1121, 1121, 1121, 1121, 1121, 1121, 1121, 1121, 1121, 1121, 1121, 1121, 1121, 1121, 1121, 1121, 1121, 1121, 1121, 1121, 1121, 1121, 1121, 1121, 1121, 1121, 1121, 1121, 1121, 1121
1121, 1121, 1121, 1121, 1121, 1121, 1121, 1121, 1121, 1121, 1121, 1121, 1121, 1121, 1121, 1121, 1121, 1121, 1121, 1121, 1121, 1121, 1121, 1121, 1121, 1121, 1121, 1121, 1121, 1121, 1121, 1121, 1121, 1121, 1121, 1121, 1121, 1121, 1121, 1121, 1121, 1121, 1121, 1121, 1121, 1121, 1121, 1121, 1121, 1121, 1121, 1121, 1121, 1121, 1121, 1121, 1121, 1121, 1121, 1121, 1121, 1121, 1121, 1121, 1121, 1121, 1121, 1121, 1121, 1121, 1121, 1121, 1121, 1121, 1121, 1121, 1121, 1121, 1121, 1121
1121, 1121, 1121, 1121, 1121, 1121, 1121, 1121, 1121, 1121, 1121, 1121, 1121, 1121, 1121, 1121, 1121, 1121, 1121, 1121, 1121, 1121, 1121, 1121, 1121, 1121, 1121, 1121, 1121, 1121, 1121, 1121, 1121, 1121, 1121, 1121, 1121, 1121, 1121, 1121, 1121, 1121, 1121, 1121, 1121, 1121, 1121, 1121, 1121, 1121, 1121, 1121, 1121, 1121, 1121, 1121, 1121, 1121, 1121, 1121, 1121, 1121, 1121, 1121, 1121, 1121, 1121, 1121, 1121, 1121, 1121, 1121, 1121, 1121, 1121, 1121, 1121, 1121, 1121, 1121
1121, 1121, 1121, 1121, 1121, 1121, 1121, 1121, 1121, 1121, 1121, 1121, 1121, 1121, 1121, 1121, 1121, 1121, 1121, 1121, 1121, 1121, 1121, 1121, 1121, 1121, 1121, 1121, 1121, 1121, 1121, 1121, 1121, 1121, 1121, 1121, 1121, 1121, 1121, 1121, 1121, 1121, 1121, 1121, 1121, 1121, 1121, 1121, 1121, 1121, 1121, 1121, 1121, 1121, 1121, 1121, 1121, 1121, 1121, 1121, 1121, 1121, 1121, 1121, 1121, 1121, 1121, 1121, 1121, 1121, 1121, 1121, 1121, 1121, 1121, 1121, 1121, 1121, 1121, 1121
1121, 1121, 1121, 1121, 1121, 1121, 1121, 1121, 1121, 1121, 1121, 1121, 1121, 1121, 1121, 1121, 1121, 1121, 1121, 1121, 1121, 1121, 1121, 1121, 1121, 1121, 1121, 1121, 1121, 1121, 1121, 1121, 1121, 1121, 1121, 1121, 1121, 1121, 1121, 1121, 1121, 1121, 1121, 1121, 1121, 1121, 1121, 1121, 1121, 1121, 1121, 1121, 1121, 1121, 1121, 1121, 1121, 1121, 1121, 1121, 1121, 1121, 1121, 1121, 1121, 1121, 1121, 1121, 1121, 1121, 1121, 1121, 1121, 1121, 1121, 1121, 1121, 1121, 1121, 1121
1121, 1121, 1121, 1121, 1121, 1121, 1121, 1121, 1121, 1121, 1121, 1121, 1121, 1121, 1121, 1121, 1121, 1121, 1121, 1121, 1121, 1121, 1121, 1121, 1121, 1121, 1121, 1121, 1121, 1121, 1121, 1121, 1121, 1121, 1121, 1121, 1121, 1121, 1121, 1121, 1121, 1121, 1121, 1121, 1121, 1121, 1121, 1121, 1121, 1121, 1121, 1121, 1121, 1121, 1121, 1121, 1121, 1121, 1121, 1121, 1121, 1121, 1121, 1121, 1121, 1121, 1121, 1121, 1121, 1121, 1121, 1121, 1121, 1121, 1121, 1121, 1121, 1121, 1121, 1121
1121, 1121, 1121, 1121, 1121, 1121, 1121, 1121, 1121, 1121, 1121, 1121, 1121, 1121, 1121, 1121, 1121, 1121, 1121, 1121, 1121, 1121, 1121, 1121, 1121, 1121, 1121, 1121, 1121, 1121, 1121, 1121, 1121, 1121, 1121, 1121, 1121, 1121, 1121, 1121, 1121, 1121, 1121, 1121, 1121, 1121, 1121, 1121, 1121, 1121, 1121, 1121, 1121, 1121, 1121, 1121, 1121, 1121, 1121, 1121, 1121, 1121, 1121, 1121, 1121, 1121, 1121, 1121, 1121, 1121, 1121, 1121, 1121, 1121, 1121, 1121, 1121, 1121, 1121, 1121
1121, 1121, 1121, 1121, 1121, 1121, 1121, 1121, 1121, 1121, 1121, 1121, 1121, 1121, 1121, 1121, 1121, 1121, 1121, 1089, 1094, 1095, 1096, 1097, 1094, 1095, 1096, 1097, 1094, 1095, 1096, 1097, 1094, 1095, 1096, 1097, 1094, 1095, 1096, 1097, 1094, 1095, 1096, 1097, 1094, 1095, 1096, 1097, 1094, 1095, 1096, 1097, 1094, 1095, 1096, 1097, 1094, 1095, 1096, 1097, 1094, 1095, 1100, 1121, 1121, 1121, 1121, 1121, 1121, 1121, 1121, 1121, 1121, 1121, 1121, 1121, 1121, 1121, 1121, 1121
1120, 1120, 1120, 1120, 1120, 1120, 1120, 1120, 1120, 1120, 1120, 1120, 1120, 1120, 1120, 1120, 1120, 1120, 1120, 1071, 147, 148, 149, 211, 212, 213, 214, 215, 0, 0, 0, 0, 0, 0, 0, 0, 0, 1052, 1052, 232, 147, 0, 0, 0, 0, 0, 0, 0, 0, 0, 0, 0, 0, 0, 0, 211, 212, 213, 214, 215, 150, 0, 1106, 1120, 1120, 1120, 1120, 1120, 1120, 1120, 1120, 1120, 1120, 1120, 1120, 1120, 1120, 1120, 1120, 1120
1120, 1120, 1120, 1120, 1120, 1120, 1120, 1120, 1120, 1120, 1120, 1120, 1120, 1120, 1120, 1120, 1120, 1120, 1120, 1103, 151, 179, 180, 243, 244, 245, 246, 247, 215, 216, 217, 218, 219, 0, 0, 0, 0, 0, 0, 232, 147, 0, 0, 0, 172, 173, 172, 173, 174, 175, 176, 177, 178, 179, 0, 243, 244, 245, 246, 247, 181, 0, 1138, 1120, 1120, 1120, 1120, 1120, 1120, 1120, 1120, 1120, 1120, 1120, 1120, 1120, 1120, 1120, 1120, 1120
1120, 1120, 1120, 1120, 1120, 1120, 1120, 1120, 1120, 1120, 1120, 1120, 1120, 1120, 1120, 1120, 1120, 1120, 1120, 1135, 182, 183, 211, 275, 276, 277, 278, 279, 247, 248, 249, 250, 251, 0, 0, 0, 0, 0, 0, 0, 0, 0, 0, 0, 204, 205, 204, 205, 206, 207, 208, 209, 210, 211, 0, 275, 276, 277, 278, 279, 212, 0, 1074, 1120, 1120, 1120, 1120, 1120, 1120, 1120, 1120, 1120, 1120, 1120, 1120, 1120, 1120, 1120, 1120, 1120
1120, 1120, 1120, 1120, 1120, 1120, 1120, 1120, 1120, 1120, 1120, 1120, 1120, 1120, 1120, 1120, 1120, 1120, 1120, 1071, 213, 214, 215, 307, 308, 309, 310, 311, 279, 280, 281, 282, 283, 0, 0, 0, 0, 0, 0, 0, 0, 0, 0, 0, 236, 237, 236, 237, 238, 239, 240, 241, 242, 243, 0, 307, 308, 309, 310, 311, 149, 150, 1106, 1120, 1120, 1120, 1120, 1120, 1120, 1120, 1120, 1120, 1120, 1120, 1120, 1120, 1120, 1120, 1120, 1120
1120, 1120, 1120, 1120, 1120, 1120, 1120, 1120, 1120, 1120, 1120, 1120, 1120, 1120, 1120, 1120, 1120, 1120, 1120, 1103, 244, 245, 246, 211, 212, 213, 214, 215, 311, 212, 213, 214, 215, 216, 217, 218, 219, 0, 0, 0, 0, 0, 0, 0, 268, 269, 268, 269, 270, 271, 272, 273, 274, 275, 0, 339, 340, 341, 342, 343, 180, 181, 1138, 1120, 1120, 1120, 1120, 1120, 1120, 1120, 1120, 1120, 1120, 1120, 1120, 1120, 1120, 1120, 1120, 1120
1120, 1120, 1120, 1120, 1120, 1120, 1120, 1120, 1120, 1120, 1120, 1120, 1120, 1120, 1120, 1120, 1120, 1120, 1120, 1135, 275, 276, 277, 243, 244, 245, 246, 247, 343, 244, 245, 246, 247, 248, 249, 212, 213, 214, 215, 216, 217, 218, 219, 0, 300, 301, 300, 301, 302, 303, 304, 305, 306, 307, 0, 339, 340, 341, 342, 343, 211, 212, 1074, 1120, 1120, 1120, 1120, 1120, 1120, 1120, 1120, 1120, 1120, 1120, 1120, 1120, 1120, 1120, 1120, 1120
1120, 1120, 1120, 1120, 1120, 1120, 1120, 1120, 1120, 1120, 1120, 1120, 1120, 1120, 1120, 1120, 1120, 1120, 1120, 1071, 279, 147, 148, 275, 276, 277, 278, 279, 375, 276, 277, 1053, 1053, 1053, 1053, 1053, 1053, 1053, 1053, 1053, 1053, 1053, 1053, 1053, 1053, 1053, 1053, 1053, 1053, 1053, 1053, 337, 338, 339, 0, 339, 340, 341, 342, 343, 215, 243, 1106, 1120, 1120, 1120, 1120, 1120, 1120, 1120, 1120, 1120, 1120, 1120, 1120, 1120, 1120, 1120, 1120, 1120
1120, 1120, 1120, 1120, 1120, 1120, 1120, 1120, 1120, 1120, 1120, 1120, 1120, 1120, 1120, 1120, 1120, 1120, 1120, 1103, 150, 151, 179, 307, 308, 309, 310, 311, 407, 308, 309, 310, 311, 312, 313, 276, 277, 278, 279, 280, 281, 282, 283, 0, 364, 365, 364, 365, 366, 367, 368, 369, 370, 371, 0, 243, 244, 245, 246, 247, 246, 247, 1138, 1120, 1120, 1120, 1120, 1120, 1120, 1120, 1120, 1120, 1120, 1120, 1120, 1120, 1120, 1120, 1120, 1120
1120, 1120, 1120, 1120, 1120, 1120, 1120, 1120, 1120, 1120, 1120, 1120, 1120, 1120, 1120, 1120, 1120, 1120, 1120, 1071, 181, 182, 183, 339, 340, 341, 342, 343, 439, 340, 341, 342, 343, 344, 345, 308, 309, 310, 311, 312, 313, 314, 315, 0, 396, 397, 396, 397, 398, 399, 400, 401, 402, 403, 0, 275, 276, 277, 278, 279, 277, 278, 1074, 1120, 1120, 1120, 1120, 1120, 1120, 1120, 1120, 1120, 1120, 1120, 1120, 1120, 1120, 1120, 1120, 1120
1120, 1120, 1120, 1120, 1120, 1120, 1120, 1120, 1120, 1120, 1120, 1120, 1120, 1120, 1120, 1120, 1120, 1120, 1120, 1103, 212, 213, 214, 211, 212, 213, 214, 215, 0, 372, 373, 374, 375, 376, 377, 340, 341, 342, 343, 344, 345, 346, 347, 0, 308, 309, 310, 311, 312, 313, 314, 315, 0, 0, 0, 307, 308, 309, 310, 311, 148, 149, 1106, 1120, 1120, 1120, 1120, 1120, 1120, 1120, 1120, 1120, 1120, 1120, 1120, 1120, 1120, 1120, 1120, 1120
1120, 1120, 1120, 1120, 1120, 1120, 1120, 1120, 1120, 1120, 1120, 1120, 1120, 1120, 1120, 1120, 1120, 1120, 1120, 1135, 243, 244, 245, 243, 244, 245, 246, 247, 0, 404, 405, 406, 407, 408, 409, 372, 373, 374, 375, 376, 377, 378, 379, 0, 340, 341, 342, 343, 344, 345, 346, 347, 0, 0, 0, 339, 340, 341, 342, 343, 179, 180, 1138, 1120, 1120, 1120, 1120, 1120, 1120, 1120, 1120, 1120, 1120, 1120, 1120, 1120, 1120, 1120, 1120, 1120
1120, 1120, 1120, 1120, 1120, 1120, 1120, 1120, 1120, 1120, 1120, 1120, 1120, 1120, 1120, 1120, 1120, 1120, 1120, 1071, 247, 275, 276, 275, 276, 277, 278, 279, 0, 436, 437, 438, 439, 440, 441, 404, 405, 406, 407, 408, 409, 410, 411, 0, 372, 373, 374, 375, 376, 377, 378, 379, 0, 0, 0, 211, 212, 213, 214, 215, 183, 211, 1074, 1120, 1120, 1120, 1120, 1120, 1120, 1120, 1120, 1120, 1120, 1120, 1120, 1120, 1120, 1120, 1120, 1120
1120, 1120, 1120, 1120, 1120, 1120, 1120, 1120, 1120, 1120, 1120, 1120, 1120, 1120, 1120, 1120, 1120, 1120, 1120, 1103, 278, 279, 1053, 1053, 1053, 1053, 1053, 1053, 1053, 1053, 1053, 1053, 1053, 1053, 1053, 1053, 1053, 1053, 1053, 1053, 1053, 1053, 443, 0, 404, 405, 406, 407, 408, 409, 410, 411, 0, 0, 0, 243, 244, 245, 246, 247, 214, 215, 1106, 1120, 1120, 1120, 1120, 1120, 1120, 1120, 1120, 1120, 1120, 1120, 1120, 1120, 1120, 1120, 1120, 1120
1120, 1120, 1120, 1120, 1120, 1120, 1120, 1120, 1120, 1120, 1120, 1120, 1120, 1120, 1120, 1120, 1120, 1120, 1120, 1135, 149, 150, 151, 339, 340, 341, 342, 343, 0, 0, 0, 0, 0, 0, 0, 0, 212, 213, 214, 215, 216, 217, 218, 219, 436, 437, 438, 439, 440, 441, 442, 443, 0, 0, 0, 275, 276, 277, 278, 279, 245, 246, 1138, 1120, 1120, 1120, 1120, 1120, 1120, 1120, 1120, 1120, 1120, 1120, 1120, 1120, 1120, 1120, 1120, 1120
1120, 1120, 1120, 1120, 1120, 1120, 1120, 1120, 1120, 1120, 1120, 1120, 1120, 1120, 1120, 1120, 1120, 1120, 1120, 1071, 180, 181, 182, 211, 212, 213, 214, 215, 0, 0, 172, 173, 174, 175, 176, 177, 178, 179, 246, 247, 248, 249, 250, 251, 0, 0, 0, 0, 0, 0, 0, 0, 0, 0, 0, 307, 308, 309, 310, 311, 276, 277, 1074, 1120, 1120, 1120, 1120, 1120, 1120, 1120, 1120, 1120, 1120, 1120, 1120, 1120, 1120, 1120, 1120, 1120
1120, 1120, 1120, 1120, 1120, 1120, 1120, 1120, 1120, 1120, 1120, 1120, 1120, 1120, 1120, 1120, 1120, 1120, 1120, 1103, 211, 212, 211, 243, 244, 245, 246, 247, 0, 0, 204, 205, 206, 207, 208, 209, 210, 211, 278, 279, 280, 281, 282, 283, 0, 0, 0, 212, 213, 214, 215, 216, 217, 218, 219, 339, 340, 341, 342, 343, 147, 148, 1106, 1120, 1120, 1120, 1120, 1120, 1120, 1120, 1120, 1120, 1120, 1120, 1120, 1120, 1120, 1120, 1120, 1120
1120, 1120, 1120, 1120, 1120, 1120, 1120, 1120, 1120, 1120, 1120, 1120, 1120, 1120, 1120, 1120, 1120, 1120, 1120, 1135, 215, 243, 243, 275, 276, 277, 278, 279, 0, 0, 236, 237, 238, 239, 240, 241, 242, 243, 310, 311, 312, 313, 314, 315, 182, 183, 214, 244, 245, 246, 247, 248, 249, 250, 251, 243, 244, 245, 246, 247, 151, 179, 1138, 1120, 1120, 1120, 1120, 1120, 1120, 1120, 1120, 1120, 1120, 1120, 1120, 1120, 1120, 1120, 1120, 1120
1120, 1120, 1120, 1120, 1120, 1120, 1120, 1120, 1120, 1120, 1120, 1120, 1120, 1120, 1120, 1139, 1139, 1139, 1139, 1071, 246, 247, 275, 307, 308, 309, 310, 311, 0, 0, 268, 269, 270, 271, 272, 273, 274, 275, 342, 343, 1053, 1053, 1053, 1053, 1053, 1053, 1053, 1053, 1053, 1053, 1053, 1053, 1053, 1053, 1053, 1053, 1053, 1053, 1053, 1053, 182, 183, 1074, 1120, 1120, 1120, 1120, 1120, 1120, 1120, 1120, 1120, 1120, 1120, 1120, 1120, 1120, 1120, 1120, 1120
1120, 1120, 1120, 1120, 1120, 1120, 1120, 1120, 1120, 1120, 1120, 1120, 1120, 1120, 1120, 1139, 1139, 1139, 1139, 1103, 277, 278, 307, 339, 340, 341, 342, 343, 0, 0, 300, 301, 302, 303, 304, 305, 306, 307, 374, 375, 376, 377, 378, 379, 218, 219, 214, 308, 309, 310, 311, 312, 313, 314, 315, 307, 308, 309, 310, 311, 213, 214, 1106, 1120, 1120, 1120, 1120, 1120, 1120, 1120, 1120, 1120, 1120, 1120, 1120, 1120, 1120, 1120, 1120, 1120
1120, 1120, 1120, 1120, 1120, 1120, 1120, 1120, 1120, 1120, 1120, 1120, 1120, 1120, 1120, 1139, 1139, 1139, 1139, 1135, 147, 148, 339, 340, 341, 342, 343, 214, 215, 216, 332, 333, 334, 335, 336, 337, 338, 339, 406, 407, 408, 409, 410, 411, 250, 251, 214, 340, 212, 213, 214, 215, 216, 217, 218, 339, 340, 341, 342, 343, 244, 245, 1138, 1120, 1120, 1120, 1120, 1120, 1120, 1120, 1120, 1120, 1120, 1120, 1120, 1120, 1120, 1120, 1120, 1120
1120, 1120, 1120, 1120, 1120, 1120, 1120, 1120, 1120, 1120, 1120, 1120, 1120, 1120, 1120, 1139, 1139, 1139, 1139, 1071, 151, 179, 180, 211, 212, 213, 214, 215, 247, 248, 364, 365, 366, 367, 368, 369, 370, 371, 438, 439, 440, 441, 442, 443, 282, 283, 214, 372, 244, 245, 246, 247, 248, 249, 250, 243, 244, 245, 246, 247, 275, 276, 1074, 1120, 1120, 1120, 1120, 1120, 1120, 1120, 1120, 1120, 1120, 1120, 1120, 1120, 1120, 1120, 1120, 1120
1120, 1120, 1120, 1120, 1120, 1120, 1120, 1120, 1120, 1120, 1120, 1120, 1120, 1120, 1120, 1139, 1139, 1139, 1139, 1103, 182, 231, 232, 233, 234, 235, 231, 232, 233, 234, 235, 231, 232, 233, 234, 235, 231, 232, 233, 234, 235, 311, 312, 313, 314, 315, 214, 404, 276, 277, 278, 279, 280, 281, 282, 275, 276, 277, 278, 279, 279, 147, 1106, 1120, 1120, 1120, 1120, 1120, 1120, 1120, 1120, 1120, 1120, 1167, 1167, 1167, 1167, 1120, 1120, 1120
1120, 1120, 1120, 1120, 1120, 1120, 1120, 1120, 1120, 1120, 1120, 1120, 1120, 1120, 1120, 1139, 1139, 1139, 1139, 1135, 213, 214, 215, 275, 276, 277, 278, 279, 311, 312, 313, 314, 315, 315, 172, 173, 174, 175, 176, 177, 178, 179, 344, 345, 346, 347, 214, 436, 308, 309, 310, 311, 312, 313, 314, 307, 308, 309, 310, 311, 150, 151, 1138, 1120, 1120, 1120, 1120, 1120, 1120, 1120, 1120, 1120, 1120, 1167, 1167, 1167, 1167, 1167, 1167, 1167
1120, 1120, 1120, 1120, 1120, 1120, 1120, 1120, 1120, 1120, 1120, 1120, 1120, 1120, 1120, 1139, 1139, 1139, 1139, 1071, 244, 1053, 1053, 1053, 1053, 1053, 1053, 1053, 1053, 1053, 1053, 1053, 1053, 1053, 1053, 1053, 1053, 1053, 1053, 1053, 1053, 211, 376, 377, 378, 379, 214, 372, 340, 341, 342, 343, 344, 345, 346, 339, 340, 341, 342, 343, 181, 182, 1074, 1120, 1120, 1120, 1120, 1120, 1120, 1120, 1120, 1120, 1120, 1167, 1167, 1167, 1167, 1167, 1167, 1167
1120, 1120, 1120, 1120, 1120, 1120, 1120, 1120, 1120, 1120, 1120, 1120, 1120, 1120, 1120, 1139, 1139, 1139, 1139, 1103, 275, 276, 277, 211, 212, 213, 214, 215, 375, 376, 377, 378, 379, 379, 236, 237, 238, 239, 240, 241, 242, 243, 408, 409, 410, 411, 182, 404, 372, 373, 374, 375, 376, 377, 378, 211, 212, 213, 214, 215, 212, 213, 1106, 1120, 1120, 1120, 1120, 1120, 1120, 1120, 1120, 1120, 1120, 1167, 1167, 1167, 1167, 1167, 1167, 1167
1120, 1120, 1120, 1120, 1120, 1120, 1120, 1120, 1120, 1120, 1120, 1120, 1120, 1120, 1120, 1139, 1139, 1139, 1139, 1135, 279, 147, 148, 243, 244, 245, 246, 247, 407, 212, 213, 214, 215, 216, 268, 269, 270, 271, 272, 273, 274, 275, 440, 441, 442, 443, 182, 436, 404, 405, 406, 407, 408, 409, 410, 243, 244, 245, 246, 247, 243, 244, 1138, 1120, 1120, 1120, 1120, 1120, 1120, 1120, 1120, 1120, 1120, 1120, 1167, 1167, 1167, 1167, 1167, 1167
1120, 1120, 1120, 1120, 1120, 1120, 1120, 1120, 1120, 1120, 1120, 1120, 1120, 1120, 1120, 1139, 1139, 1139, 1139, 1103, 150, 151, 179, 275, 276, 277, 278, 279, 143, 144, 145, 146, 147, 143, 144, 145, 146, 147, 143, 144, 231, 232, 233, 234, 235, 231, 232, 233, 234, 235, 231, 232, 233, 234, 235, 231, 232, 233, 234, 235, 247, 275, 1106, 1120, 1120, 1120, 1120, 1120, 1120, 1120, 1120, 1120, 1120, 1120, 1167, 1167, 1167, 1167, 1167, 1167
1167, 1167, 1167, 1167, 1167, 1167, 1167, 1167, 1167, 1167, 1167, 1167, 1167, 1167, 1167, 1139, 1139, 1139, 1139, 1071, 181, 182, 211, 307, 308, 309, 310, 311, 204, 205, 206, 207, 208, 209, 210, 211, 334, 335, 336, 337, 338, 339, 0, 0, 0, 0, 0, 0, 212, 213, 214, 215, 216, 217, 218, 307, 308, 309, 310, 311, 278, 279, 1106, 1167, 1167, 1167, 1167, 1167, 1167, 1167, 1167, 1120, 1167, 1167, 1167, 1167, 1167, 1167, 1167, 1167
1167, 1167, 1167, 1167, 1167, 1167, 1167, 1167, 1167, 1167, 1167, 1167, 1167, 1167, 1167, 1139, 1139, 1139, 1139, 1071, 212, 213, 243, 339, 340, 341, 342, 343, 236, 237, 238, 239, 240, 241, 242, 243, 366, 367, 368, 369, 370, 1053, 1053, 1053, 1053, 1053, 1053, 1053, 1053, 1053, 1053, 1053, 1053, 1053, 1053, 1053, 1053, 1053, 1053, 1053, 1053, 150, 1106, 1167, 1167, 1167, 1167, 1167, 1167, 1167, 1167, 1167, 1167, 1167, 1167, 1167, 1167, 1167, 1167, 1167
1167, 1167, 1167, 1167, 1167, 1167, 1167, 1167, 1167, 1167, 1167, 1167, 1167, 1167, 1167, 1139, 1139, 1139, 1139, 1071, 243, 244, 275, 276, 277, 278, 279, 0, 268, 269, 270, 271, 272, 273, 274, 275, 398, 399, 400, 401, 402, 403, 217, 218, 219, 0, 0, 0, 276, 277, 278, 279, 280, 281, 282, 243, 244, 245, 246, 247, 180, 181, 1106, 1167, 1167, 1167, 1167, 1167, 1167, 1167, 1167, 1167, 1167, 1167, 1167, 1167, 1167, 1167, 1167, 1167
1167, 1167, 1167, 1167, 1167, 1167, 1167, 1167, 1167, 1167, 1167, 1167, 1167, 1167, 1167, 1139, 1139, 1139, 1139, 1071, 231, 232, 233, 234, 235, 231, 232, 233, 234, 235, 231, 232, 233, 234, 235, 231, 232, 233, 234, 235, 231, 232, 233, 234, 235, 231, 232, 233, 234, 235, 310, 311, 312, 313, 314, 275, 276, 277, 278, 279, 211, 212, 1106, 1167, 1167, 1167, 1167, 1167, 1167, 1167, 1167, 1167, 1167, 1167, 1167, 1167, 1167, 1167, 1167, 1167
1120, 1120, 1120, 1120, 1120, 1120, 1120, 1120, 1120, 1120, 1120, 1120, 1120, 1120, 1120, 1139, 1139, 1139, 1139, 1103, 278, 279, 339, 211, 212, 213, 214, 215, 332, 333, 334, 335, 336, 337, 338, 339, 411, 276, 277, 278, 279, 280, 281, 282, 283, 0, 0, 0, 340, 341, 342, 343, 344, 345, 346, 211, 212, 213, 214, 215, 215, 243, 1074, 1121, 1121, 1167, 1167, 1167, 1167, 1121, 1167, 1167, 1167, 1167, 1121, 1167, 1167, 1167, 1167, 1167
1120, 1120, 1120, 1120, 1120, 1120, 1120, 1120, 1120, 1120, 1120, 1120, 1120, 1120, 1120, 1139, 1139, 1139, 1139, 1135, 149, 150, 151, 243, 244, 245, 246, 247, 364, 365, 366, 367, 368, 369, 370, 371, 443, 216, 217, 218, 219, 312, 313, 314, 315, 0, 0, 0, 372, 373, 374, 375, 376, 377, 378, 243, 244, 245, 246, 247, 246, 247, 1106, 1120, 1120, 1120, 1120, 1120, 1120, 1120, 1120, 1120, 1120, 1120, 1120, 1167, 1167, 1167, 1167, 1120
1120, 1120, 1120, 1120, 1120, 1120, 1120, 1120, 1120, 1120, 1120, 1120, 1120, 1120, 1120, 1139, 1139, 1139, 1139, 1071, 180, 181, 182, 275, 276, 277, 278, 279, 175, 176, 177, 178, 179, 401, 402, 403, 251, 248, 249, 250, 251, 344, 345, 346, 347, 0, 0, 0, 404, 405, 406, 407, 408, 409, 410, 275, 276, 277, 278, 279, 0, 0, 1138, 1120, 1120, 1120, 1120, 1120, 1120, 1120, 1120, 1120, 1120, 1120, 1120, 1120, 1120, 1120, 1120, 1120
1120, 1120, 1120, 1120, 1120, 1120, 1120, 1120, 1120, 1120, 1120, 1120, 1120, 1120, 1120, 1139, 1139, 1139, 1139, 1103, 211, 212, 213, 307, 308, 309, 310, 311, 207, 208, 209, 210, 211, 280, 281, 282, 283, 280, 281, 282, 395, 395, 231, 232, 233, 234, 235, 231, 232, 233, 234, 235, 231, 232, 233, 234, 235, 231, 232, 233, 234, 235, 1074, 1120, 1120, 1120, 1120, 1120, 1120, 1120, 1120, 1120, 1120, 1120, 1120, 1120, 1120, 1120, 1120, 1120
1120, 1120, 1120, 1120, 1120, 1120, 1120, 1120, 1120, 1120, 1120, 1120, 1120, 1120, 1120, 1139, 1139, 1139, 1139, 1135, 215, 1053, 1053, 1053, 1053, 1053, 1053, 1053, 1053, 1053, 1053, 1053, 1053, 1053, 1053, 1053, 1053, 1053, 1053, 1053, 1053, 1053, 231, 232, 233, 234, 235, 231, 232, 233, 234, 235, 231, 232, 233, 234, 235, 231, 232, 233, 234, 235, 1106, 1120, 1120, 1120, 1120, 1120, 1120, 1120, 1120, 1120, 1120, 1120, 1120, 1120, 1120, 1120, 1120, 1120
1120, 1120, 1120, 1120, 1120, 1120, 1120, 1120, 1120, 1120, 1120, 1120, 1120, 1120, 1120, 1139, 1139, 1139, 1139, 1071, 246, 211, 212, 213, 214, 215, 269, 270, 271, 272, 273, 274, 275, 344, 345, 346, 347, 344, 345, 346, 347, 440, 441, 442, 443, 278, 279, 280, 281, 282, 283, 0, 0, 211, 212, 213, 214, 215, 148, 149, 150, 151, 1138, 1120, 1120, 1120, 1120, 1120, 1120, 1120, 1120, 1120, 1120, 1120, 1120, 1120, 1120, 1120, 1120, 1120
1120, 1120, 1120, 1120, 1120, 1120, 1120, 1120, 1120, 1120, 1120, 1120, 1120, 1120, 1120, 1139, 1139, 1139, 1139, 1103, 277, 243, 244, 245, 246, 247, 301, 302, 303, 304, 305, 306, 307, 376, 377, 378, 379, 376, 377, 378, 379, 0, 0, 308, 309, 310, 311, 312, 313, 314, 315, 0, 0, 243, 244, 245, 246, 247, 180, 181, 182, 183, 1074, 1120, 1120, 1120, 1120, 1120, 1120, 1120, 1120, 1120, 1120, 1120, 1120, 1120, 1120, 1120, 1120, 1120
1120, 1120, 1120, 1120, 1120, 1120, 1120, 1120, 1120, 1120, 1120, 1120, 1120, 1120, 1120, 1139, 1139, 1139, 1139, 1135, 148, 275, 276, 277, 278, 279, 333, 334, 335, 336, 337, 338, 339, 408, 409, 410, 411, 408, 409, 410, 411, 335, 336, 340, 341, 342, 343, 344, 345, 346, 347, 335, 336, 275, 276, 277, 278, 279, 212, 213, 214, 215, 1106, 1120, 1120, 1120, 1120, 1120, 1120, 1120, 1120, 1120, 1120, 1120, 1120, 1120, 1120, 1120, 1120, 1120
1120, 1120, 1120, 1120, 1120, 1120, 1120, 1120, 1120, 1120, 1120, 1120, 1120, 1120, 1120, 1139, 1139, 1139, 1139, 1071, 179, 307, 308, 309, 310, 311, 365, 366, 367, 368, 369, 370, 371, 440, 441, 442, 443, 440, 441, 442, 443, 338, 339, 372, 373, 374, 375, 376, 377, 378, 379, 0, 0, 307, 308, 309, 310, 311, 244, 245, 246, 247, 1138, 1120, 1120, 1120, 1120, 1120, 1120, 1120, 1120, 1120, 1120, 1120, 1120, 1120, 1120, 1120, 1120, 1120
1120, 1120, 1120, 1120, 1120, 1120, 1120, 1120, 1120, 1120, 1120, 1120, 1120, 1120, 1120, 1139, 1139, 1139, 1139, 1103, 183, 339, 211, 212, 213, 214, 215, 398, 399, 400, 401, 402, 403, 0, 0, 0, 0, 0, 211, 212, 213, 214, 215, 404, 405, 406, 407, 408, 409, 410, 411, 0, 0, 339, 340, 341, 342, 343, 148, 149, 150, 151, 1074, 1120, 1120, 1120, 1120, 1120, 1120, 1120, 1120, 1120, 1120, 1120, 1120, 1120, 1120, 1120, 1120, 1120
1120, 1120, 1120, 1120, 1120, 1120, 1120, 1120, 1120, 1120, 1120, 1120, 1120, 1120, 1120, 1139, 1139, 1139, 1139, 1135, 231, 231, 232, 233, 234, 235, 231, 232, 233, 234, 235, 231, 232, 233, 234, 235, 231, 232, 233, 234, 235, 246, 247, 211, 212, 213, 214, 215, 211, 212, 213, 214, 215, 211, 212, 213, 214, 215, 180, 181, 182, 183, 1106, 1120, 1120, 1120, 1120, 1120, 1120, 1120, 1120, 1120, 1120, 1120, 1120, 1120, 1120, 1120, 1120, 1120
1120, 1120, 1120, 1120, 1120, 1120, 1120, 1120, 1120, 1120, 1120, 1120, 1120, 1120, 1120, 1139, 1139, 1139, 1139, 1071, 245, 246, 275, 276, 277, 278, 279, 243, 244, 245, 246, 247, 243, 244, 245, 246, 247, 0, 275, 276, 1053, 1053, 1053, 1053, 1053, 1053, 1053, 1053, 1053, 1053, 1053, 1053, 1053, 1053, 1053, 1053, 1053, 1053, 1053, 1053, 1053, 215, 1138, 1120, 1120, 1120, 1120, 1120, 1120, 1120, 1120, 1120, 1120, 1120, 1120, 1120, 1120, 1120, 1120, 1120
1120, 1120, 1120, 1120, 1120, 1120, 1120, 1120, 1120, 1120, 1120, 1120, 1120, 1120, 1120, 1139, 1139, 1139, 1139, 1103, 276, 277, 307, 308, 309, 310, 311, 275, 276, 277, 278, 279, 275, 276, 277, 278, 279, 470, 307, 308, 309, 310, 311, 275, 276, 277, 278, 279, 275, 276, 277, 278, 279, 275, 276, 277, 278, 279, 244, 245, 246, 247, 1074, 1120, 1120, 1120, 1120, 1120, 1120, 1120, 1120, 1120, 1120, 1120, 1120, 1120, 1120, 1120, 1120, 1120
1120, 1120, 1120, 1120, 1120, 1120, 1120, 1120, 1120, 1120, 1120, 1120, 1120, 1120, 1120, 1139, 1139, 1139, 1139, 1135, 147, 148, 339, 340, 341, 342, 343, 307, 308, 309, 310, 311, 307, 308, 309, 310, 311, 0, 339, 340, 341, 342, 343, 307, 308, 309, 310, 311, 307, 308, 309, 310, 311, 307, 308, 309, 310, 311, 151, 277, 278, 279, 1106, 1120, 1120, 1120, 1120, 1120, 1120, 1120, 1120, 1120, 1120, 1120, 1120, 1120, 1120, 1120, 1120, 1120
1120, 1120, 1120, 1120, 1120, 1120, 1120, 1120, 1120, 1120, 1120, 1120, 1120, 1120, 1120, 1139, 1139, 1139, 1139, 1071, 151, 179, 180, 181, 0, 0, 0, 339, 340, 341, 342, 343, 339, 340, 341, 342, 343, 148, 149, 150, 151, 0, 147, 339, 340, 341, 342, 343, 339, 340, 341, 342, 343, 339, 340, 341, 342, 343, 183, 0, 0, 0, 1138, 1120, 1120, 1120, 1120, 1120, 1120, 1120, 1120, 1120, 1120, 1120, 1120, 1120, 1120, 1120, 1120, 1120
1120, 1120, 1120, 1120, 1120, 1120, 1120, 1120, 1120, 1120, 1120, 1120, 1120, 1120, 1120, 1139, 1139, 1139, 1139, 1103, 182, 183, 211, 212, 0, 0, 0, 0, 179, 180, 181, 182, 183, 0, 0, 0, 179, 180, 181, 182, 183, 0, 179, 180, 181, 182, 183, 0, 179, 180, 181, 182, 183, 0, 211, 212, 213, 214, 215, 0, 0, 0, 1074, 1120, 1120, 1120, 1120, 1120, 1120, 1120, 1120, 1120, 1120, 1120, 1120, 1120, 1120, 1120, 1120, 1120
1120, 1120, 1120, 1120, 1120, 1120, 1120, 1120, 1120, 1120, 1120, 1120, 1120, 1120, 1120, 1120, 1120, 1120, 1120, 1135, 213, 214, 215, 243, 0, 0, 0, 0, 211, 212, 213, 214, 215, 0, 0, 0, 211, 212, 213, 214, 215, 0, 211, 212, 213, 214, 215, 0, 211, 212, 213, 214, 215, 0, 243, 244, 245, 246, 247, 0, 0, 0, 1106, 1120, 1120, 1120, 1120, 1120, 1120, 1120, 1120, 1120, 1120, 1120, 1120, 1120, 1120, 1120, 1120, 1120
1120, 1120, 1120, 1120, 1120, 1120, 1120, 1120, 1120, 1120, 1120, 1120, 1120, 1120, 1120, 1120, 1120, 1120, 1120, 1071, 244, 245, 246, 247, 0, 0, 0, 0, 243, 244, 245, 246, 247, 0, 0, 0, 243, 244, 245, 246, 247, 0, 243, 244, 245, 246, 247, 0, 243, 244, 245, 246, 247, 0, 275, 276, 277, 278, 279, 0, 0, 0, 1138, 1120, 1120, 1120, 1120, 1120, 1120, 1120, 1120, 1120, 1120, 1120, 1120, 1120, 1120, 1120, 1120, 1120
1120, 1120, 1120, 1120, 1120, 1120, 1120, 1120, 1120, 1120, 1120, 1120, 1120, 1120, 1120, 1120, 1120, 1120, 1120, 1103, 0, 0, 0, 0, 0, 0, 0, 0, 275, 276, 277, 278, 279, 0, 0, 0, 275, 276, 277, 278, 279, 1052, 1052, 276, 277, 278, 279, 0, 275, 276, 277, 278, 279, 0, 0, 0, 0, 0, 0, 0, 0, 0, 1074, 1120, 1120, 1120, 1120, 1120, 1120, 1120, 1120, 1120, 1120, 1120, 1120, 1120, 1120, 1120, 1120, 1120
1120, 1120, 1120, 1120, 1120, 1120, 1120, 1120, 1120, 1120, 1120, 1120, 1120, 1120, 1120, 1120, 1120, 1120, 1120, 1057, 1063, 1064, 1065, 1066, 1063, 1064, 1065, 1066, 1063, 1064, 1065, 1066, 1063, 1064, 1065, 1066, 1063, 1064, 1065, 1066, 1063, 1064, 1065, 1066, 1063, 1064, 1065, 1066, 1063, 1064, 1065, 1066, 1063, 1064, 1065, 1066, 1063, 1064, 1065, 1066, 1063, 1064, 1068, 1120, 1120, 1120, 1120, 1120, 1120, 1120, 1120, 1120, 1120, 1120, 1120, 1120, 1120, 1120, 1120, 1120
