0, 0, 0, 0, 0, 0, 0, 0, 0, 0, 0, 0, 0, 0, 0, 0, 0, 0, 0, 0, 0, 0, 0, 0, 0, 0, 0, 0, 0, 0, 0, 0, 0, 0, 0, 0, 0, 0, 0, 0, 0, 0, 0, 0, 0, 0, 0, 0, 0, 0, 0, 0, 0, 0, 0, 0, 0, 0, 0, 0, 0, 0, 0, 0, 0, 0, 0, 0, 0, 0, 0, 0, 0, 0, 0, 0, 0, 0, 0, 0
0, 0, 0, 0, 0, 0, 0, 0, 0, 0, 0, 0, 0, 0, 0, 0, 0, 0, 0, 0, 0, 0, 0, 0, 0, 0, 0, 0, 0, 0, 0, 0, 0, 0, 0, 0, 0, 0, 0, 0, 0, 0, 0, 0, 0, 0, 0, 0, 0, 0, 0, 0, 0, 0, 0, 0, 0, 0, 0, 0, 0, 0, 0, 0, 0, 0, 0, 0, 0, 0, 0, 0, 0, 0, 0, 0, 0, 0, 0, 0
0, 0, 0, 0, 0, 0, 0, 0, 0, 0, 0, 0, 0, 0, 0, 0, 0, 0, 0, 0, 0, 0, 0, 0, 0, 0, 0, 0, 0, 0, 0, 0, 0, 0, 0, 0, 0, 0, 0, 0, 0, 0, 0, 0, 0, 0, 0, 0, 0, 0, 0, 0, 0, 0, 0, 0, 0, 0, 0, 0, 0, 0, 0, 0, 0, 0, 0, 0, 0, 0, 0, 0, 0, 0, 0, 0, 0, 0, 0, 0
0, 0, 0, 0, 0, 0, 0, 0, 0, 0, 0, 0, 0, 0, 0, 0, 0, 0, 0, 0, 0, 0, 0, 0, 0, 0, 0, 0, 0, 0, 0, 0, 0, 0, 0, 0, 0, 0, 0, 0, 0, 0, 0, 0, 0, 0, 0, 0, 0, 0, 0, 0, 0, 0, 0, 0, 0, 0, 0, 0, 0, 0, 0, 0, 0, 0, 0, 0, 0, 0, 0, 0, 0, 0, 0, 0, 0, 0, 0, 0
0, 0, 0, 0, 0, 0, 0, 0, 0, 0, 0, 0, 0, 0, 0, 0, 0, 0, 0, 0, 0, 0, 0, 0, 0, 0, 0, 0, 0, 0, 0, 0, 0, 0, 0, 0, 0, 0, 0, 0, 0, 0, 0, 0, 0, 0, 0, 0, 0, 0, 0, 0, 0, 0, 0, 0, 0, 0, 0, 0, 0, 0, 0, 0, 0, 0, 0, 0, 0, 0, 0, 0, 0, 0, 0, 0, 0, 0, 0, 0
0, 0, 0, 0, 0, 0, 0, 0, 0, 0, 0, 0, 0, 0, 0, 0, 0, 0, 0, 0, 0, 0, 0, 0, 0, 0, 0, 0, 0, 0, 0, 0, 0, 0, 0, 0, 0, 0, 0, 0, 0, 0, 0, 0, 0, 0, 0, 0, 0, 0, 0, 0, 0, 0, 0, 0, 0, 0, 0, 0, 0, 0, 0, 0, 0, 0, 0, 0, 0, 0, 0, 0, 0, 0, 0, 0, 0, 0, 0, 0
0, 0, 0, 0, 0, 0, 0, 0, 0, 0, 0, 0, 0, 0, 0, 0, 0, 0, 0, 0, 0, 0, 0, 0, 0, 0, 0, 0, 0, 0, 0, 0, 0, 0, 0, 0, 0, 0, 0, 0, 0, 0, 0, 0, 0, 0, 0, 0, 0, 0, 0, 0, 0, 0, 0, 0, 0, 0, 0, 0, 0, 0, 0, 0, 0, 0, 0, 0, 0, 0, 0, 0, 0, 0, 0, 0, 0, 0, 0, 0
0, 0, 0, 0, 0, 0, 0, 0, 0, 0, 0, 0, 0, 0, 0, 0, 0, 0, 0, 0, 0, 0, 0, 0, 0, 0, 0, 0, 0, 0, 0, 0, 0, 0, 0, 0, 0, 0, 0, 0, 0, 0, 0, 0, 0, 0, 0, 0, 0, 0, 0, 0, 0, 0, 0, 0, 0, 0, 0, 0, 0, 0, 0, 0, 0, 0, 0, 0, 0, 0, 0, 0, 0, 0, 0, 0, 0, 0, 0, 0
0, 0, 0, 0, 0, 0, 0, 0, 0, 0, 0, 0, 0, 0, 0, 0, 0, 0, 0, 0, 0, 0, 0, 0, 0, 0, 0, 0, 0, 0, 0, 0, 0, 0, 0, 0, 0, 0, 0, 0, 0, 0, 0, 0, 0, 0, 0, 0, 0, 0, 0, 0, 0, 0, 0, 0, 0, 0, 0, 0, 0, 0, 0, 0, 0, 0, 0, 0, 0, 0, 0, 0, 0, 0, 0, 0, 0, 0, 0, 0
0, 0, 0, 0, 0, 0, 0, 0, 0, 0, 0, 0, 0, 0, 0, 0, 0, 0, 0, 0, 0, 0, 0, 0, 0, 0, 0, 0, 0, 0, 0, 0, 0, 0, 0, 0, 0, 0, 0, 0, 0, 0, 0, 0, 0, 0, 0, 0, 0, 0, 0, 0, 0, 0, 0, 0, 0, 0, 0, 0, 0, 0, 0, 0, 0, 0, 0, 0, 0, 0, 0, 0, 0, 0, 0, 0, 0, 0, 0, 0
0, 0, 0, 0, 0, 0, 0, 0, 0, 0, 0, 0, 0, 0, 0, 0, 0, 0, 0, 0, 0, 4800, 4801, 0, 0, 0, 0, 0, 0, 0, 0, 0, 0, 0, 0, 0, 0, 0, 0, 0, 0, 0, 0, 0, 0, 0, 0, 0, 0, 0, 0, 0, 0, 0, 0, 0, 0, 4800, 4801, 0, 0, 0, 0, 0, 0, 0, 0, 0, 0, 0, 0, 0, 0, 0, 0, 0, 0, 0, 0, 0
0, 0, 0, 0, 0, 0, 0, 0, 0, 0, 0, 0, 0, 0, 0, 0, 0, 0, 0, 0, 0, 4802, 4803, 0, 0, 0, 0, 0, 0, 0, 0, 0, 0, 0, 0, 0, 0, 0, 0, 0, 0, 0, 0, 0, 0, 0, 0, 0, 0, 0, 0, 0, 0, 0, 0, 0, 0, 4802, 4803, 0, 0, 0, 0, 0, 0, 0, 0, 0, 0, 0, 0, 0, 0, 0, 0, 0, 0, 0, 0, 0
0, 0, 0, 0, 0, 0, 0, 0, 0, 0, 0, 0, 0, 0, 0, 0, 0, 0, 0, 0, 0, 4804, 4805, 0, 0, 0, 0, 0, 0, 0, 0, 0, 0, 0, 0, 0, 0, 0, 0, 0, 0, 0, 0, 0, 0, 0, 0, 0, 0, 0, 0, 0, 0, 0, 0, 0, 0, 4804, 4805, 0, 0, 0, 0, 0, 0, 0, 0, 0, 0, 0, 0, 0, 0, 0, 0, 0, 0, 0, 0, 0
0, 0, 0, 0, 0, 0, 0, 0, 0, 0, 0, 0, 0, 0, 0, 0, 0, 0, 0, 0, 0, 4806, 4807, 0, 0, 0, 0, 0, 0, 0, 0, 4800, 4801, 4800, 4801, 0, 0, 0, 0, 0, 0, 0, 0, 4800, 4801, 4800, 4801, 0, 0, 0, 0, 0, 0, 0, 0, 0, 0, 4806, 4807, 0, 0, 0, 0, 0, 0, 0, 0, 0, 0, 0, 0, 0, 0, 0, 0, 0, 0, 0, 0, 0
0, 0, 0, 0, 0, 0, 0, 0, 0, 0, 0, 0, 0, 0, 0, 0, 0, 0, 0, 0, 0, 4808, 4809, 0, 0, 0, 0, 0, 0, 0, 4800, 4801, 4803, 4800, 4801, 0, 0, 0, 0, 0, 0, 0, 0, 4800, 4801, 4802, 4800, 4801, 0, 0, 0, 0, 0, 0, 0, 0, 0, 4808, 4809, 0, 0, 0, 0, 0, 0, 0, 0, 0, 0, 0, 0, 0, 0, 0, 0, 0, 0, 0, 0, 0
0, 0, 0, 0, 0, 0, 0, 0, 0, 0, 0, 0, 0, 0, 0, 0, 0, 0, 0, 0, 0, 4810, 4811, 0, 0, 0, 0, 0, 0, 4800, 4801, 4803, 0, 4802, 4803, 0, 0, 0, 0, 0, 0, 0, 0, 4802, 4803, 0, 4802, 4800, 4801, 0, 0, 0, 0, 0, 0, 0, 0, 4810, 4811, 0, 0, 0, 0, 0, 0, 0, 0, 0, 0, 0, 0, 0, 0, 0, 0, 0, 0, 0, 0, 0
0, 0, 0, 0, 0, 0, 0, 0, 0, 0, 0, 0, 0, 0, 0, 0, 0, 0, 0, 0, 0, 4812, 4813, 0, 0, 0, 0, 4800, 4801, 4802, 4803, 0, 0, 4800, 4801, 0, 0, 0, 0, 0, 0, 0, 0, 4800, 4801, 0, 0, 4802, 4803, 4800, 4801, 0, 0, 0, 0, 0, 0, 4812, 4813, 0, 0, 0, 0, 0, 0, 0, 0, 0, 0, 0, 0, 0, 0, 0, 0, 0, 0, 0, 0, 0
0, 0, 0, 0, 0, 0, 0, 0, 0, 0, 0, 0, 0, 0, 0, 0, 0, 0, 0, 0, 0, 4814, 4815, 0, 0, 0, 0, 4802, 4803, 0, 0, 0, 0, 0, 4800, 4801, 0, 0, 0, 0, 0, 0, 4800, 4801, 0, 0, 0, 0, 0, 4802, 4803, 0, 0, 0, 0, 0, 0, 4814, 4815, 0, 0, 0, 0, 0, 0, 0, 0, 0, 0, 0, 0, 0, 0, 0, 0, 0, 0, 0, 0, 0
0, 0, 0, 0, 0, 0, 0, 0, 0, 0, 0, 0, 0, 0, 0, 0, 0, 0, 0, 0, 0, 4816, 4817, 0, 0, 0, 0, 4804, 4805, 0, 0, 0, 0, 0, 4802, 4803, 0, 0, 0, 0, 0, 0, 4802, 4803, 0, 0, 0, 0, 0, 4800, 4801, 0, 0, 0, 0, 0, 0, 4816, 4817, 0, 0, 0, 0, 0, 0, 0, 0, 0, 0, 0, 0, 0, 0, 0, 0, 0, 0, 0, 0, 0
0, 0, 0, 0, 0, 0, 0, 0, 0, 0, 0, 0, 0, 0, 0, 0, 0, 0, 0, 0, 0, 4818, 4819, 0, 0, 0, 0, 4800, 4801, 0, 0, 0, 0, 0, 0, 4800, 4801, 0, 0, 0, 0, 4800, 4801, 0, 0, 0, 0, 0, 0, 4802, 4803, 0, 0, 0, 0, 0, 0, 4818, 4819, 0, 0, 0, 0, 0, 0, 0, 0, 0, 0, 0, 0, 0, 0, 0, 0, 0, 0, 0, 0, 0
0, 0, 0, 0, 0, 0, 0, 0, 0, 0, 0, 0, 0, 0, 0, 0, 0, 0, 0, 0, 0, 4820, 4821, 0, 0, 0, 0, 4802, 4803, 0, 0, 0, 0, 0, 0, 4802, 4803, 0, 0, 0, 0, 4802, 4803, 0, 0, 0, 0, 0, 0, 4804, 4805, 0, 0, 0, 0, 0, 0, 4820, 4821, 0, 0, 0, 0, 0, 0, 0, 0, 0, 0, 0, 0, 0, 0, 0, 0, 0, 0, 0, 0, 0
0, 0, 0, 0, 0, 0, 0, 0, 0, 0, 0, 0, 0, 0, 0, 0, 0, 0, 0, 0, 0, 4822, 4823, 0, 0, 0, 0, 4804, 4805, 0, 0, 0, 0, 0, 0, 0, 4800, 4801, 0, 0, 4800, 4801, 0, 0, 0, 0, 0, 0, 0, 4806, 4807, 0, 0, 0, 0, 0, 0, 4822, 4823, 0, 0, 0, 0, 0, 0, 0, 0, 0, 0, 0, 0, 0, 0, 0, 0, 0, 0, 0, 0, 0
0, 0, 0, 0, 0, 0, 0, 0, 0, 0, 0, 0, 0, 0, 0, 0, 0, 0, 0, 0, 0, 4824, 4825, 0, 0, 0, 0, 4806, 4807, 0, 0, 0, 0, 0, 0, 0, 4802, 4803, 0, 0, 4802, 4803, 0, 0, 0, 0, 0, 0, 0, 4808, 4809, 0, 0, 0, 0, 0, 0, 4824, 4825, 0, 0, 0, 0, 0, 0, 0, 0, 0, 0, 0, 0, 0, 0, 0, 0, 0, 0, 0, 0, 0
0, 0, 0, 0, 0, 0, 0, 0, 0, 0, 0, 0, 0, 0, 0, 0, 0, 0, 0, 0, 0, 4826, 4827, 0, 0, 0, 0, 4808, 4809, 0, 0, 0, 0, 0, 0, 0, 0, 4800, 4801, 4800, 4801, 0, 0, 0, 0, 0, 0, 0, 0, 4810, 4811, 0, 0, 0, 0, 0, 0, 4826, 4827, 0, 0, 0, 0, 0, 0, 0, 0, 0, 0, 0, 0, 0, 0, 0, 0, 0, 0, 0, 0, 0
0, 0, 0, 0, 0, 0, 0, 0, 0, 0, 0, 0, 0, 0, 0, 0, 0, 0, 0, 0, 0, 4800, 4801, 0, 0, 0, 0, 4810, 4811, 4800, 4801, 0, 0, 0, 0, 0, 0, 4802, 4803, 4802, 4803, 0, 0, 0, 0, 0, 0, 4800, 4801, 4812, 4813, 4801, 0, 0, 0, 0, 0, 4800, 4801, 0, 0, 0, 0, 0, 0, 0, 0, 0, 0, 0, 0, 0, 0, 0, 0, 0, 0, 0, 0, 0
0, 0, 0, 0, 0, 0, 0, 0, 0, 0, 0, 0, 0, 0, 0, 0, 0, 0, 0, 0, 0, 4802, 4803, 0, 0, 0, 4800, 4812, 4813, 4802, 4803, 0, 0, 0, 0, 0, 0, 0, 4800, 4801, 0, 0, 0, 0, 0, 0, 0, 4800, 4801, 4814, 4815, 4803, 0, 0, 0, 0, 0, 4802, 4803, 0, 0, 0, 0, 0, 0, 0, 0, 0, 0, 0, 0, 0, 0, 0, 0, 0, 0, 0, 0, 0
0, 0, 0, 0, 0, 0, 0, 0, 0, 0, 0, 0, 0, 0, 0, 0, 0, 0, 0, 0, 0, 4804, 4805, 0, 0, 0, 4802, 4814, 4815, 4800, 4800, 4801, 0, 0, 0, 0, 0, 0, 4802, 4803, 0, 0, 0, 0, 0, 0, 4800, 4802, 4803, 0, 0, 4800, 4801, 0, 0, 0, 0, 4804, 4805, 0, 0, 0, 0, 0, 0, 0, 0, 0, 0, 0, 0, 0, 0, 0, 0, 0, 0, 0, 0, 0
0, 0, 0, 0, 0, 0, 0, 0, 0, 0, 0, 0, 0, 0, 0, 0, 0, 0, 0, 0, 0, 4806, 4807, 0, 0, 4800, 4801, 0, 0, 0, 4802, 4803, 4801, 0, 0, 0, 0, 0, 4800, 4801, 0, 0, 0, 0, 0, 4800, 4801, 4803, 0, 0, 0, 4802, 4803, 0, 0, 0, 0, 4806, 4807, 0, 0, 0, 0, 0, 0, 0, 0, 0, 0, 0, 0, 0, 0, 0, 0, 0, 0, 0, 0, 0
0, 0, 0, 0, 0, 0, 0, 0, 0, 0, 0, 0, 0, 0, 0, 0, 0, 0, 0, 0, 0, 4808, 4809, 0, 0, 4802, 4803, 0, 0, 0, 0, 4800, 4801, 0, 0, 0, 0, 4800, 4801, 4800, 4801, 0, 0, 0, 0, 4802, 4803, 0, 0, 0, 0, 4804, 4805, 0, 0, 0, 0, 4808, 4809, 0, 0, 0, 0, 0, 0, 0, 0, 0, 0, 0, 0, 0, 0, 0, 0, 0, 0, 0, 0, 0
0, 0, 0, 0, 0, 0, 0, 0, 0, 0, 0, 0, 0, 0, 0, 0, 0, 0, 0, 0, 0, 4810, 4811, 0, 0, 4804, 4805, 0, 0, 0, 0, 4802, 4803, 0, 0, 0, 0, 4802, 4803, 4802, 4803, 0, 0, 0, 0, 4804, 4805, 0, 0, 0, 0, 4806, 4807, 0, 0, 0, 0, 4810, 4811, 0, 0, 0, 0, 0, 0, 0, 0, 0, 0, 0, 0, 0, 0, 0, 0, 0, 0, 0, 0, 0
0, 0, 0, 0, 0, 0, 0, 0, 0, 0, 0, 0, 0, 0, 0, 0, 0, 0, 0, 0, 0, 4812, 4813, 0, 0, 4806, 4807, 0, 0, 0, 0, 4804, 4805, 0, 0, 0, 0, 0, 4802, 4803, 0, 0, 0, 0, 0, 4806, 4807, 0, 0, 0, 0, 4808, 4809, 0, 0, 0, 0, 4812, 4813, 0, 0, 0, 0, 0, 0, 0, 0, 0, 0, 0, 0, 0, 0, 0, 0, 0, 0, 0, 0, 0
0, 0, 0, 0, 0, 0, 0, 0, 0, 0, 0, 0, 0, 0, 0, 0, 0, 0, 0, 0, 0, 4814, 4815, 0, 0, 4800, 4801, 0, 0, 0, 0, 4806, 4807, 0, 0, 0, 0, 0, 4800, 4801, 0, 0, 0, 0, 0, 4808, 4809, 0, 0, 0, 0, 4800, 4801, 0, 0, 0, 0, 4814, 4815, 0, 0, 0, 0, 0, 0, 0, 0, 0, 0, 0, 0, 0, 0, 0, 0, 0, 0, 0, 0, 0
0, 0, 0, 0, 0, 0, 0, 0, 0, 0, 0, 0, 0, 0, 0, 0, 0, 0, 0, 0, 0, 4816, 4817, 0, 0, 4802, 4803, 0, 0, 0, 0, 4808, 4809, 0, 0, 0, 0, 0, 4802, 4803, 0, 0, 0, 0, 0, 4810, 4811, 0, 0, 0, 0, 4802, 4803, 0, 0, 0, 0, 4816, 4817, 0, 0, 0, 0, 0, 0, 0, 0, 0, 0, 0, 0, 0, 0, 0, 0, 0, 0, 0, 0, 0
0, 0, 0, 0, 0, 0, 0, 0, 0, 0, 0, 0, 0, 0, 0, 0, 0, 0, 0, 0, 0, 4818, 4819, 0, 0, 4804, 4805, 0, 0, 0, 0, 4810, 4811, 0, 0, 0, 0, 4800, 4801, 4800, 4801, 0, 0, 0, 0, 4808, 4809, 0, 0, 0, 0, 4804, 4805, 0, 0, 0, 0, 4818, 4819, 0, 0, 0, 0, 0, 0, 0, 0, 0, 0, 0, 0, 0, 0, 0, 0, 0, 0, 0, 0, 0
0, 0, 0, 0, 0, 0, 0, 0, 0, 0, 0, 0, 0, 0, 0, 0, 0, 0, 0, 0, 0, 4820, 4821, 0, 0, 4806, 4807, 0, 0, 0, 0, 4812, 4813, 0, 0, 0, 0, 4802, 4803, 4802, 4803, 0, 0, 0, 0, 4810, 4811, 0, 0, 0, 0, 4806, 4807, 0, 0, 0, 0, 4820, 4821, 0, 0, 0, 0, 0, 0, 0, 0, 0, 0, 0, 0, 0, 0, 0, 0, 0, 0, 0, 0, 0
0, 0, 0, 0, 0, 0, 0, 0, 0, 0, 0, 0, 0, 0, 0, 0, 0, 0, 0, 0, 0, 4822, 4823, 0, 0, 4808, 4809, 0, 0, 0, 0, 4814, 4815, 0, 0, 0, 4800, 4801, 0, 0, 4800, 4801, 0, 0, 0, 4812, 4813, 0, 0, 0, 0, 4808, 4809, 0, 0, 0, 0, 4822, 4823, 0, 0, 0, 0, 0, 0, 0, 0, 0, 0, 0, 0, 0, 0, 0, 0, 0, 0, 0, 0, 0
0, 0, 0, 0, 0, 0, 0, 0, 0, 0, 0, 0, 0, 0, 0, 0, 0, 0, 0, 0, 0, 4824, 4825, 0, 0, 4810, 4811, 0, 0, 0, 4800, 4801, 4803, 0, 0, 0, 4800, 4801, 0, 0, 4800, 4801, 0, 0, 0, 4814, 4815, 4801, 0, 0, 0, 4810, 4811, 0, 0, 0, 0, 4824, 4825, 0, 0, 0, 0, 0, 0, 0, 0, 0, 0, 0, 0, 0, 0, 0, 0, 0, 0, 0, 0, 0
0, 0, 0, 0, 0, 0, 0, 0, 0, 0, 0, 0, 0, 0, 0, 0, 0, 0, 0, 0, 0, 4826, 4827, 0, 0, 4812, 4813, 0, 0, 4800, 4802, 4803, 0, 0, 0, 0, 4802, 4803, 0, 0, 4802, 4803, 0, 0, 0, 0, 4802, 4800, 4801, 0, 0, 4812, 4813, 0, 0, 0, 0, 4826, 4827, 0, 0, 0, 0, 0, 0, 0, 0, 0, 0, 0, 0, 0, 0, 0, 0, 0, 0, 0, 0, 0
0, 0, 0, 0, 0, 0, 0, 0, 0, 0, 0, 0, 0, 0, 0, 0, 0, 0, 0, 0, 0, 4828, 4829, 0, 0, 4814, 4815, 4801, 4800, 4802, 4803, 0, 0, 0, 0, 0, 4800, 4801, 0, 0, 4800, 4801, 0, 0, 0, 0, 0, 4802, 4800, 4801, 4800, 4814, 4815, 0, 0, 0, 0, 4828, 4829, 0, 0, 0, 0, 0, 0, 0, 0, 0, 0, 0, 0, 0, 0, 0, 0, 0, 0, 0, 0, 0
0, 0, 0, 0, 0, 0, 0, 0, 0, 0, 0, 0, 0, 0, 0, 0, 0, 0, 0, 0, 0, 4830, 4831, 0, 0, 0, 4802, 4803, 4802, 4803, 0, 0, 0, 0, 0, 4800, 4801, 0, 0, 0, 0, 4800, 4801, 0, 0, 0, 0, 0, 4802, 4803, 4802, 4803, 0, 0, 0, 0, 0, 4830, 4831, 0, 0, 0, 0, 0, 0, 0, 0, 0, 0, 0, 0, 0, 0, 0, 0, 0, 0, 0, 0, 0
0, 0, 0, 0, 0, 0, 0, 0, 0, 0, 0, 0, 0, 0, 0, 0, 0, 0, 0, 0, 0, 4832, 4833, 0, 0, 0, 0, 4800, 4801, 0, 0, 0, 0, 0, 0, 4800, 4801, 0, 0, 0, 0, 4800, 4801, 0, 0, 0, 0, 0, 0, 4800, 4801, 0, 0, 0, 0, 0, 0, 4832, 4833, 0, 0, 0, 0, 0, 0, 0, 0, 0, 0, 0, 0, 0, 0, 0, 0, 0, 0, 0, 0, 0
0, 0, 0, 0, 0, 0, 0, 0, 0, 0, 0, 0, 0, 0, 0, 0, 0, 0, 0, 0, 0, 4834, 4835, 0, 0, 0, 0, 4802, 4803, 0, 0, 0, 0, 0, 0, 4802, 4803, 0, 0, 0, 0, 4802, 4803, 0, 0, 0, 0, 0, 0, 4802, 4803, 0, 0, 0, 0, 0, 0, 4834, 4835, 0, 0, 0, 0, 0, 0, 0, 0, 0, 0, 0, 0, 0, 0, 0, 0, 0, 0, 0, 0, 0
0, 0, 0, 0, 0, 0, 0, 0, 0, 0, 0, 0, 0, 0, 0, 0, 0, 0, 0, 0, 0, 4836, 4837, 0, 0, 0, 0, 4804, 4805, 0, 0, 0, 0, 0, 4800, 4801, 4801, 0, 0, 0, 0, 4800, 4800, 4801, 0, 0, 0, 0, 0, 4804, 4805, 0, 0, 0, 0, 0, 0, 4836, 4837, 0, 0, 0, 0, 0, 0, 0, 0, 0, 0, 0, 0, 0, 0, 0, 0, 0, 0, 0, 0, 0
0, 0, 0, 0, 0, 0, 0, 0, 0, 0, 0, 0, 0, 0, 0, 0, 0, 0, 0, 0, 0, 4838, 4839, 0, 0, 0, 0, 4806, 4807, 0, 0, 0, 0, 0, 4802, 4803, 0, 0, 0, 0, 0, 0, 4802, 4803, 0, 0, 0, 0, 0, 4806, 4807, 0, 0, 0, 0, 0, 0, 4838, 4839, 0, 0, 0, 0, 0, 0, 0, 0, 0, 0, 0, 0, 0, 0, 0, 0, 0, 0, 0, 0, 0
0, 0, 0, 0, 0, 0, 0, 0, 0, 0, 0, 0, 0, 0, 0, 0, 0, 0, 0, 0, 0, 4840, 4841, 0, 0, 0, 0, 4808, 4809, 0, 0, 0, 0, 0, 4804, 4805, 0, 0, 0, 0, 0, 0, 4804, 4805, 0, 0, 0, 0, 0, 4808, 4809, 0, 0, 0, 0, 0, 0, 4840, 4841, 0, 0, 0, 0, 0, 0, 0, 0, 0, 0, 0, 0, 0, 0, 0, 0, 0, 0, 0, 0, 0
0, 0, 0, 0, 0, 0, 0, 0, 0, 0, 0, 0, 0, 0, 0, 0, 0, 0, 0, 0, 0, 4842, 4843, 0, 0, 0, 0, 4810, 4811, 0, 0, 0, 0, 0, 4806, 4807, 0, 0, 0, 0, 0, 0, 4806, 4807, 0, 0, 0, 0, 0, 4810, 4811, 0, 0, 0, 0, 0, 0, 4842, 4843, 0, 0, 0, 0, 0, 0, 0, 0, 0, 0, 0, 0, 0, 0, 0, 0, 0, 0, 0, 0, 0
0, 0, 0, 0, 0, 0, 0, 0, 0, 0, 0, 0, 0, 0, 0, 0, 0, 0, 0, 0, 0, 4844, 4845, 0, 0, 0, 0, 4812, 4813, 0, 0, 0, 0, 0, 4808, 4809, 0, 0, 0, 0, 0, 0, 4808, 4809, 0, 0, 0, 0, 0, 4812, 4813, 0, 0, 0, 0, 0, 0, 4844, 4845, 0, 0, 0, 0, 0, 0, 0, 0, 0, 0, 0, 0, 0, 0, 0, 0, 0, 0, 0, 0, 0
0, 0, 0, 0, 0, 0, 0, 0, 0, 0, 0, 0, 0, 0, 0, 0, 0, 0, 0, 0, 0, 4846, 4847, 0, 0, 0, 0, 4814, 4815, 0, 0, 0, 0, 0, 4810, 4811, 0, 0, 0, 0, 0, 0, 4810, 4811, 0, 0, 0, 0, 0, 4814, 4815, 0, 0, 0, 0, 0, 0, 4846, 4847, 0, 0, 0, 0, 0, 0, 0, 0, 0, 0, 0, 0, 0, 0, 0, 0, 0, 0, 0, 0, 0
0, 0, 0, 0, 0, 0, 0, 0, 0, 0, 0, 0, 0, 0, 0, 0, 0, 0, 0, 0, 0, 4848, 4849, 0, 0, 0, 0, 4800, 4801, 4802, 4803, 4804, 4805, 4806, 4807, 4803, 0, 0, 0, 0, 0, 0, 4802, 4800, 4801, 4802, 4803, 4804, 4805, 4806, 4807, 0, 0, 0, 0, 0, 0, 4848, 4849, 0, 0, 0, 0, 0, 0, 0, 0, 0, 0, 0, 0, 0, 0, 0, 0, 0, 0, 0, 0, 0
0, 0, 0, 0, 0, 0, 0, 0, 0, 0, 0, 0, 0, 0, 0, 0, 0, 0, 0, 0, 0, 4850, 4851, 0, 0, 0, 0, 4808, 4809, 4810, 4811, 4812, 4813, 4814, 4815, 0, 0, 0, 0, 0, 0, 0, 0, 4808, 4809, 4810, 4811, 4812, 4813, 4814, 4815, 0, 0, 0, 0, 0, 0, 4850, 4851, 0, 0, 0, 0, 0, 0, 0, 0, 0, 0, 0, 0, 0, 0, 0, 0, 0, 0, 0, 0, 0
0, 0, 0, 0, 0, 0, 0, 0, 0, 0, 0, 0, 0, 0, 0, 0, 0, 0, 0, 0, 0, 4852, 4853, 0, 0, 0, 0, 0, 0, 0, 0, 0, 0, 0, 0, 0, 0, 0, 0, 0, 0, 0, 0, 0, 0, 0, 0, 0, 0, 0, 0, 0, 0, 0, 0, 0, 0, 4852, 4853, 0, 0, 0, 0, 0, 0, 0, 0, 0, 0, 0, 0, 0, 0, 0, 0, 0, 0, 0, 0, 0
0, 0, 0, 0, 0, 0, 0, 0, 0, 0, 0, 0, 0, 0, 0, 0, 0, 0, 0, 0, 0, 4854, 4855, 0, 0, 0, 0, 0, 0, 0, 0, 0, 0, 0, 0, 0, 0, 0, 0, 0, 0, 0, 0, 0, 0, 0, 0, 0, 0, 0, 0, 0, 0, 0, 0, 0, 0, 4854, 4855, 0, 0, 0, 0, 0, 0, 0, 0, 0, 0, 0, 0, 0, 0, 0, 0, 0, 0, 0, 0, 0
0, 0, 0, 0, 0, 0, 0, 0, 0, 0, 0, 0, 0, 0, 0, 0, 0, 0, 0, 0, 0, 4856, 4857, 4800, 4801, 4802, 4803, 4804, 4800, 4801, 4802, 4803, 4804, 4805, 4806, 4807, 4808, 4809, 4810, 4811, 4812, 4813, 4814, 4815, 4816, 4817, 4818, 4819, 4820, 4821, 4822, 4823, 4824, 4825, 4826, 4827, 4828, 4829, 4857, 0, 0, 0, 0, 0, 0, 0, 0, 0, 0, 0, 0, 0, 0, 0, 0, 0, 0, 0, 0, 0
0, 0, 0, 0, 0, 0, 0, 0, 0, 0, 0, 0, 0, 0, 0, 0, 0, 0, 0, 0, 0, 4858, 4859, 4830, 4831, 4832, 4833, 4834, 4830, 4831, 4832, 4833, 4834, 4835, 4836, 4837, 4838, 4839, 4840, 4841, 4842, 4843, 4844, 4845, 4846, 4847, 4848, 4849, 4850, 4851, 4852, 4853, 4854, 4855, 4856, 4857, 4858, 4859, 4859, 0, 0, 0, 0, 0, 0, 0, 0, 0, 0, 0, 0, 0, 0, 0, 0, 0, 0, 0, 0, 0
0, 0, 0, 0, 0, 0, 0, 0, 0, 0, 0, 0, 0, 0, 0, 0, 0, 0, 0, 0, 0, 0, 0, 0, 0, 0, 0, 0, 0, 0, 0, 0, 0, 0, 0, 0, 0, 0, 0, 0, 0, 0, 0, 0, 0, 0, 0, 0, 0, 0, 0, 0, 0, 0, 0, 0, 0, 0, 0, 0, 0, 0, 0, 0, 0, 0, 0, 0, 0, 0, 0, 0, 0, 0, 0, 0, 0, 0, 0, 0
0, 0, 0, 0, 0, 0, 0, 0, 0, 0, 0, 0, 0, 0, 0, 0, 0, 0, 0, 0, 0, 0, 0, 0, 0, 0, 0, 0, 0, 0, 0, 0, 0, 0, 0, 0, 0, 0, 0, 0, 0, 0, 0, 0, 0, 0, 0, 0, 0, 0, 0, 0, 0, 0, 0, 0, 0, 0, 0, 0, 0, 0, 0, 0, 0, 0, 0, 0, 0, 0, 0, 0, 0, 0, 0, 0, 0, 0, 0, 0
0, 0, 0, 0, 0, 0, 0, 0, 0, 0, 0, 0, 0, 0, 0, 0, 0, 0, 0, 0, 0, 0, 0, 0, 0, 0, 0, 0, 0, 0, 0, 0, 0, 0, 0, 0, 0, 0, 0, 0, 0, 0, 0, 0, 0, 0, 0, 0, 0, 0, 0, 0, 0, 0, 0, 0, 0, 0, 0, 0, 0, 0, 0, 0, 0, 0, 0, 0, 0, 0, 0, 0, 0, 0, 0, 0, 0, 0, 0, 0
0, 0, 0, 0, 0, 0, 0, 0, 0, 0, 0, 0, 0, 0, 0, 0, 0, 0, 0, 0, 0, 0, 0, 0, 0, 0, 0, 0, 0, 0, 0, 0, 0, 0, 0, 0, 0, 0, 0, 0, 0, 0, 0, 0, 0, 0, 0, 0, 0, 0, 0, 0, 0, 0, 0, 0, 0, 0, 0, 0, 0, 0, 0, 0, 0, 0, 0, 0, 0, 0, 0, 0, 0, 0, 0, 0, 0, 0, 0, 0
0, 0, 0, 0, 0, 0, 0, 0, 0, 0, 0, 0, 0, 0, 0, 0, 0, 0, 0, 0, 0, 0, 0, 0, 0, 0, 0, 0, 0, 0, 0, 0, 0, 0, 0, 0, 0, 0, 0, 0, 0, 0, 0, 0, 0, 0, 0, 0, 0, 0, 0, 0, 0, 0, 0, 0, 0, 0, 0, 0, 0, 0, 0, 0, 0, 0, 0, 0, 0, 0, 0, 0, 0, 0, 0, 0, 0, 0, 0, 0
0, 0, 0, 0, 0, 0, 0, 0, 0, 0, 0, 0, 0, 0, 0, 0, 0, 0, 0, 0, 0, 0, 0, 0, 0, 0, 0, 0, 0, 0, 0, 0, 0, 0, 0, 0, 0, 0, 0, 0, 0, 0, 0, 0, 0, 0, 0, 0, 0, 0, 0, 0, 0, 0, 0, 0, 0, 0, 0, 0, 0, 0, 0, 0, 0, 0, 0, 0, 0, 0, 0, 0, 0, 0, 0, 0, 0, 0, 0, 0
