1121, 1121, 1121, 1121, 1121, 1121, 1121, 1121, 1121, 1121, 1121, 1121, 1121, 1121, 1121, 1121, 1121, 1121, 1121, 1121, 1121, 1121, 1121, 1121, 1121, 1121, 1121, 1121, 1121, 1121, 1121, 1121, 1121, 1121, 1121, 1121, 1121, 1121, 1121, 1121, 1121, 1121, 1121, 1121, 1121, 1121, 1121, 1121, 1121, 1121, 1121, 1121, 1121, 1121, 1121, 1121, 1121, 1121, 1121, 1121, 1121, 1121, 1121, 1121, 1121, 1121, 1121, 1121, 1121, 1121, 1121, 1121, 1121, 1121, 1121, 1121, 1121, 1121, 1121, 1121
1121, 1121, 1121, 1121, 1121, 1121, 1121, 1121, 1121, 1121, 1121, 1121, 1121, 1121, 1121, 1121, 1121, 1121, 1121, 1121, 1121, 1121, 1121, 1121, 1121, 1121, 1121, 1121, 1121, 1121, 1121, 1121, 1121, 1121, 1121, 1121, 1121, 1121, 1121, 1121, 1121, 1121, 1121, 1121, 1121, 1121, 1121, 1121, 1121, 1121, 1121, 1121, 1121, 1121, 1121, 1121, 1121, 1121, 1121, 1121, 1121, 1121, 1121, 1121, 1121, 1121, 1121, 1121, 1121, 1121, 1121, 1121, 1121, 1121, 1121, 1121, 1121, 1121, 1121, 1121
1121, 1121, 1121, 1121, 1121, 1121, 1121, 1121, 1121, 1121, 1121, 1121, 1121, 1121, 1121, 1121, 1121, 1121, 1121, 1121, 1121, 1121, 1121, 1121, 1121, 1121, 1121, 1121, 1121, 1121, 1121, 1121, 1121, 1121, 1121, 1121, 1121, 1121, 1121, 1121, 1121, 1121, 1121, 1121, 1121, 1121, 1121, 1121, 1121, 1121, 1121, 1121, 1121, 1121, 1121, 1121, 1121, 1121, 1121, 1121, 1121, 1121, 1121, 1121, 1121, 1121, 1121, 1121, 1121, 1121, 1121, 1121, 1121, 1121, 1121, 1121, 1121, 1121, 1121, 1121
1121, 1121, 1121, 1121, 1121, 1121, 1121, 1121, 1121, 1121, 1121, 1121, 1121, 1121, 1121, 1121, 1121, 1121, 1121, 1121, 1121, 1121, 1121, 1121, 1121, 1121, 1121, 1121, 1121, 1121, 1121, 1121, 1121, 1121, 1121, 1121, 1121, 1121, 1121, 1121, 1121, 1121, 1121, 1121, 1121, 1121, 1121, 1121, 1121, 1121, 1121, 1121, 1121, 1121, 1121, 1121, 1121, 1121, 1121, 1121, 1121, 1121, 1121, 1121, 1121, 1121, 1121, 1121, 1121, 1121, 1121, 1121, 1121, 1121, 1121, 1121, 1121, 1121, 1121, 1121
1121, 1121, 1121, 1121, 1121, 1121, 1121, 1121, 1121, 1121, 1121, 1121, 1121, 1121, 1121, 1121, 1121, 1121, 1121, 1121, 1121, 1121, 1121, 1121, 1121, 1121, 1121, 1121, 1121, 1121, 1121, 1121, 1121, 1121, 1121, 1121, 1121, 1121, 1121, 1121, 1121, 1121, 1121, 1121, 1121, 1121, 1121, 1121, 1121, 1121, 1121, 1121, 1121, 1121, 1121, 1121, 1121, 1121, 1121, 1121, 1121, 1121, 1121, 1121, 1121, 1121, 1121, 1121, 1121, 1121, 1121, 1121, 1121, 1121, 1121, 1121, 1121, 1121, 1121, 1121
1121, 1121, 1121, 1121, 1121, 1121, 1121, 1121, 1121, 1121, 1121, 1121, 1121, 1121, 1121, 1121, 1121, 1121, 1121, 1121, 1121, 1121, 1121, 1121, 1121, 1121, 1121, 1121, 1121, 1121, 1121, 1121, 1121, 1121, 1121, 1121, 1121, 1121, 1121, 1121, 1121, 1121, 1121, 1121, 1121, 1121, 1121, 1121, 1121, 1121, 1121, 1121, 1121, 1121, 1121, 1121, 1121, 1121, 1121, 1121, 1121, 1121, 1121, 1121, 1121, 1121, 1121, 1121, 1121, 1121, 1121, 1121, 1121, 1121, 1121, 1121, 1121, 1121, 1121, 1121
1121, 1121, 1121, 1121, 1121, 1121, 1121, 1121, 1121, 1121, 1121, 1121, 1121, 1121, 1121, 1121, 1121, 1121, 1121, 1121, 1121, 1121, 1121, 1121, 1121, 1121, 1121, 1121, 1121, 1121, 1121, 1121, 1121, 1121, 1121, 1121, 1121, 1121, 1121, 1121, 1121, 1121, 1121, 1121, 1121, 1121, 1121, 1121, 1121, 1121, 1121, 1121, 1121, 1121, 1121, 1121, 1121, 1121, 1121, 1121, 1121, 1121, 1121, 1121, 1121, 1121, 1121, 1121, 1121, 1121, 1121, 1121, 1121, 1121, 1121, 1121, 1121, 1121, 1121, 1121
1121, 1121, 1121, 1121, 1121, 1121, 1121, 1121, 1121, 1121, 1121, 1121, 1121, 1121, 1121, 1121, 1121, 1121, 1121, 1121, 1121, 1121, 1121, 1121, 1121, 1121, 1121, 1121, 1121, 1121, 1121, 1121, 1121, 1121, 1121, 1121, 1121, 1121, 1121, 1121, 1121, 1121, 1121, 1121, 1121, 1121, 1121, 1121, 1121, 1121, 1121, 1121, 1121, 1121, 1121, 1121, 1121, 1121, 1121, 1121, 1121, 1121, 1121, 1121, 1121, 1121, 1121, 1121, 1121, 1121, 1121, 1121, 1121, 1121, 1121, 1121, 1121, 1121, 1121, 1121
1121, 1121, 1121, 1121, 1121, 1121, 1121, 1121, 1121, 1121, 1121, 1121, 1121, 1121, 1121, 1121, 1121, 1121, 1121, 1121, 1121, 1121, 1121, 1121, 1121, 1121, 1121, 1121, 1121, 1121, 1121, 1121, 1121, 1121, 1121, 1121, 1121, 1121, 1121, 1121, 1121, 1121, 1121, 1121, 1121, 1121, 1121, 1121, 1121, 1121, 1121, 1121, 1121, 1121, 1121, 1121, 1121, 1121, 1121, 1121, 1121, 1121, 1121, 1121, 1121, 1121, 1121, 1121, 1121, 1121, 1121, 1121, 1121, 1121, 1121, 1121, 1121, 1121, 1121, 1121
1121, 1121, 1121, 1121, 1121, 1121, 1121, 1121, 1121, 1121, 1121, 1121, 1121, 1121, 1121, 1121, 1121, 1121, 1121, 1121, 1089, 1094, 1094, 1094, 1094, 1094, 1094, 1094, 1094, 1094, 1094, 1094, 1094, 1093, 1093, 1093, 1093, 1053, 1053, 1093, 1093, 1093, 1094, 1094, 1094, 1094, 1094, 1094, 1094, 1094, 1094, 1094, 1094, 1094, 1094, 1094, 1094, 1094, 1094, 1100, 1165, 1165, 1165, 1165, 1165, 1165, 1165, 1165, 1165, 1165, 1165, 1165, 1165, 1165, 1165, 1165, 1165, 1165, 1165, 1165
1121, 1121, 1121, 1121, 1121, 1121, 1121, 1121, 1121, 1121, 1121, 1121, 1121, 1121, 1121, 1121, 1121, 1121, 1121, 1121, 1103, 1028, 1028, 1028, 1028, 1028, 1028, 1028, 1028, 1028, 1028, 1028, 1028, 1028, 1028, 1028, 1028, 1052, 1052, 1028, 1028, 1028, 1028, 1028, 1028, 1028, 1028, 1028, 1028, 1028, 1028, 1028, 1028, 1028, 1028, 1028, 1028, 1028, 1028, 1106, 1165, 1165, 1165, 1165, 1165, 1165, 1165, 1165, 1165, 1165, 1165, 1165, 1165, 1165, 1165, 1165, 1165, 1165, 1165, 1165
1121, 1121, 1121, 1121, 1121, 1121, 1121, 1121, 1121, 1121, 1121, 1121, 1121, 1121, 1121, 1121, 1121, 1121, 1121, 1121, 1103, 1028, 106, 107, 108, 109, 110, 111, 112, 113, 114, 115, 116, 117, 1028, 106, 107, 108, 109, 110, 111, 112, 113, 114, 115, 116, 117, 1028, 107, 108, 109, 110, 111, 112, 113, 114, 115, 116, 117, 1106, 1165, 1165, 1165, 1165, 1165, 1165, 1165, 1165, 1165, 1165, 1165, 1165, 1165, 1165, 1165, 1165, 1165, 1165, 1165, 1165
1121, 1121, 1121, 1121, 1121, 1121, 1121, 1121, 1121, 1121, 1121, 1121, 1121, 1121, 1121, 1121, 1121, 1121, 1121, 1121, 1103, 1028, 138, 139, 140, 141, 142, 143, 144, 145, 146, 147, 148, 149, 1028, 138, 139, 140, 141, 142, 143, 144, 145, 146, 147, 148, 149, 1028, 139, 140, 141, 142, 143, 144, 145, 146, 147, 148, 149, 1106, 1165, 1165, 1165, 1165, 1165, 1165, 1165, 1165, 1165, 1165, 1165, 1165, 1165, 1165, 1165, 1165, 1165, 1165, 1165, 1165
1121, 1121, 1121, 1121, 1121, 1121, 1121, 1121, 1121, 1121, 1121, 1121, 1121, 1121, 1121, 1121, 1121, 1121, 1121, 1121, 1103, 1028, 170, 171, 172, 173, 174, 175, 176, 177, 178, 179, 180, 181, 1028, 170, 171, 172, 173, 174, 175, 176, 177, 178, 179, 180, 181, 1028, 171, 172, 173, 174, 175, 176, 177, 178, 179, 180, 181, 1106, 1165, 1165, 1165, 1165, 1165, 1165, 1165, 1165, 1165, 1165, 1165, 1165, 1165, 1165, 1165, 1165, 1165, 1165, 1165, 1165
1121, 1121, 1121, 1121, 1121, 1121, 1121, 1121, 1121, 1121, 1121, 1121, 1121, 1121, 1121, 1121, 1121, 1121, 1121, 1121, 1103, 1028, 202, 203, 204, 205, 206, 207, 208, 209, 210, 211, 212, 213, 1028, 202, 203, 204, 205, 206, 207, 208, 209, 210, 211, 212, 213, 1028, 203, 204, 205, 206, 207, 208, 209, 210, 211, 212, 213, 1106, 1165, 1165, 1165, 1165, 1165, 1165, 1165, 1165, 1165, 1165, 1165, 1165, 1165, 1165, 1165, 1165, 1165, 1165, 1165, 1165
1121, 1121, 1121, 1121, 1121, 1121, 1121, 1121, 1121, 1121, 1121, 1121, 1121, 1121, 1121, 1121, 1121, 1121, 1121, 1121, 1103, 1028, 234, 235, 236, 237, 238, 239, 240, 241, 242, 243, 244, 245, 1028, 234, 235, 236, 237, 238, 239, 240, 241, 242, 243, 244, 245, 1028, 235, 236, 237, 238, 239, 240, 241, 242, 243, 244, 245, 1106, 1165, 1165, 1165, 1165, 1165, 1165, 1165, 1165, 1165, 1165, 1165, 1165, 1165, 1165, 1165, 1165, 1165, 1165, 1165, 1165
1121, 1121, 1121, 1121, 1121, 1121, 1121, 1121, 1121, 1121, 1121, 1121, 1121, 1121, 1121, 1121, 1121, 1121, 1121, 1121, 1103, 1028, 266, 267, 268, 269, 270, 271, 272, 273, 274, 275, 276, 277, 434, 266, 267, 268, 269, 270, 271, 272, 273, 274, 275, 276, 277, 1028, 267, 268, 269, 270, 271, 272, 273, 274, 275, 276, 277, 1106, 1165, 1165, 1165, 1165, 1165, 1165, 1165, 1165, 1165, 1165, 1165, 1165, 1165, 1165, 1165, 1165, 1165, 1165, 1165, 1165
1121, 1121, 1121, 1121, 1121, 1121, 1121, 1121, 1121, 1121, 1121, 1121, 1121, 1121, 1121, 1121, 1121, 1121, 1121, 1121, 1103, 1028, 298, 299, 300, 301, 302, 303, 304, 305, 306, 307, 308, 309, 434, 298, 299, 300, 301, 302, 303, 304, 305, 306, 307, 308, 309, 1028, 299, 300, 301, 302, 303, 304, 305, 306, 307, 308, 309, 1106, 1165, 1165, 1165, 1165, 1165, 1165, 1165, 1165, 1165, 1165, 1165, 1165, 1165, 1165, 1165, 1165, 1165, 1165, 1165, 1165
1121, 1121, 1121, 1121, 1121, 1121, 1121, 1121, 1121, 1121, 1121, 1121, 1121, 1121, 1121, 1121, 1121, 1121, 1121, 1121, 1103, 1028, 330, 331, 332, 333, 334, 335, 336, 337, 338, 339, 340, 341, 1028, 330, 331, 332, 333, 334, 335, 336, 337, 338, 339, 340, 341, 1028, 331, 332, 333, 334, 335, 336, 337, 338, 339, 340, 341, 1106, 1165, 1165, 1165, 1165, 1165, 1165, 1165, 1165, 1165, 1165, 1165, 1165, 1165, 1165, 1165, 1165, 1165, 1165, 1165, 1165
1121, 1121, 1121, 1121, 1121, 1121, 1121, 1121, 1121, 1121, 1121, 1121, 1121, 1121, 1121, 1121, 1121, 1121, 1121, 1121, 1103, 1028, 362, 363, 364, 365, 366, 367, 368, 369, 370, 371, 372, 373, 1028, 362, 363, 364, 365, 366, 367, 368, 369, 370, 371, 372, 373, 1028, 363, 364, 365, 366, 367, 368, 369, 370, 371, 372, 373, 1106, 1165, 1165, 1165, 1165, 1165, 1165, 1165, 1165, 1165, 1165, 1165, 1165, 1165, 1165, 1165, 1165, 1165, 1165, 1165, 1165
1121, 1121, 1121, 1121, 1121, 1121, 1121, 1121, 1121, 1121, 1121, 1121, 1121, 1121, 1121, 1121, 1121, 1121, 1121, 1121, 1103, 1028, 394, 395, 396, 397, 398, 399, 400, 401, 402, 403, 404, 405, 1028, 394, 395, 396, 397, 398, 399, 400, 401, 402, 403, 404, 405, 1028, 395, 396, 397, 398, 399, 400, 401, 402, 403, 404, 405, 1106, 1165, 1165, 1165, 1165, 1165, 1165, 1165, 1165, 1165, 1165, 1165, 1165, 1165, 1165, 1165, 1165, 1165, 1165, 1165, 1165
1121, 1121, 1121, 1121, 1121, 1121, 1121, 1121, 1121, 1121, 1121, 1121, 1121, 1121, 1121, 1121, 1121, 1121, 1121, 1121, 1103, 1028, 426, 427, 428, 429, 430, 431, 432, 433, 434, 435, 436, 437, 1028, 426, 427, 428, 429, 430, 431, 432, 433, 434, 435, 436, 437, 1028, 427, 428, 429, 430, 431, 432, 433, 434, 435, 436, 437, 1106, 1165, 1165, 1165, 1165, 1165, 1165, 1165, 1165, 1165, 1165, 1165, 1165, 1165, 1165, 1165, 1165, 1165, 1165, 1165, 1165
1121, 1121, 1121, 1121, 1121, 1121, 1121, 1121, 1121, 1121, 1121, 1121, 1121, 1121, 1121, 1121, 1121, 1121, 1121, 1121, 1103, 1028, 458, 459, 460, 461, 462, 463, 464, 465, 466, 467, 468, 469, 1028, 458, 459, 460, 461, 462, 463, 464, 465, 466, 467, 468, 469, 1028, 459, 460, 461, 462, 463, 464, 465, 466, 467, 468, 469, 1106, 1165, 1165, 1165, 1165, 1165, 1165, 1165, 1165, 1165, 1165, 1165, 1165, 1165, 1165, 1165, 1165, 1165, 1165, 1165, 1165
1121, 1121, 1121, 1121, 1121, 1121, 1121, 1121, 1121, 1121, 1121, 1121, 1121, 1121, 1121, 1121, 1121, 1121, 1121, 1121, 1103, 1028, 1028, 1028, 1028, 1028, 1028, 1028, 1028, 1028, 1028, 1028, 1028, 1028, 1028, 1028, 1028, 176, 434, 1028, 1028, 1028, 1028, 1028, 1028, 1028, 1028, 1028, 1028, 1028, 1028, 1028, 1028, 1028, 1028, 1028, 1028, 1028, 434, 1106, 1165, 1165, 1165, 1165, 1165, 1165, 1165, 1165, 1165, 1165, 1165, 1165, 1165, 1165, 1165, 1165, 1165, 1165, 1165, 1165
1121, 1121, 1121, 1121, 1121, 1121, 1121, 1121, 1121, 1121, 1121, 1121, 1121, 1121, 1121, 1121, 1121, 1121, 1121, 1121, 1103, 1028, 106, 107, 108, 109, 110, 111, 112, 113, 114, 115, 116, 117, 1028, 106, 107, 108, 109, 110, 111, 112, 113, 114, 115, 116, 117, 1028, 107, 108, 109, 110, 111, 112, 113, 114, 115, 116, 117, 1106, 1165, 1165, 1165, 1165, 1165, 1165, 1165, 1165, 1165, 1165, 1165, 1165, 1165, 1165, 1165, 1165, 1165, 1165, 1165, 1165
1121, 1121, 1121, 1121, 1121, 1121, 1121, 1121, 1121, 1121, 1121, 1121, 1121, 1121, 1121, 1121, 1121, 1121, 1121, 1121, 1103, 1028, 138, 139, 140, 141, 142, 143, 144, 145, 146, 147, 148, 149, 1028, 138, 139, 140, 141, 142, 143, 144, 145, 146, 147, 148, 149, 1028, 139, 140, 141, 142, 143, 144, 145, 146, 147, 148, 149, 1106, 1165, 1165, 1165, 1165, 1165, 1165, 1165, 1165, 1165, 1165, 1165, 1165, 1165, 1165, 1165, 1165, 1165, 1165, 1165, 1165
1121, 1121, 1121, 1121, 1121, 1121, 1121, 1121, 1121, 1121, 1121, 1121, 1121, 1121, 1121, 1121, 1121, 1121, 1121, 1121, 1103, 1028, 170, 171, 172, 173, 174, 175, 176, 177, 178, 179, 180, 181, 1028, 170, 171, 172, 173, 174, 175, 176, 177, 178, 179, 180, 181, 1028, 171, 172, 173, 174, 175, 176, 177, 178, 179, 180, 181, 1106, 1165, 1165, 1165, 1165, 1165, 1165, 1165, 1165, 1165, 1165, 1165, 1165, 1165, 1165, 1165, 1165, 1165, 1165, 1165, 1165
1121, 1121, 1121, 1121, 1121, 1121, 1121, 1121, 1121, 1121, 1121, 1121, 1121, 1121, 1121, 1121, 1121, 1121, 1121, 1121, 1103, 1028, 202, 203, 204, 205, 206, 207, 208, 209, 210, 211, 212, 213, 1028, 202, 203, 204, 205, 206, 207, 208, 209, 210, 211, 212, 213, 1028, 203, 204, 205, 206, 207, 208, 209, 210, 211, 212, 213, 1106, 1165, 1165, 1165, 1165, 1165, 1165, 1165, 1165, 1165, 1165, 1165, 1165, 1165, 1165, 1165, 1165, 1165, 1165, 1165, 1165
1121, 1121, 1121, 1121, 1121, 1121, 1121, 1121, 1121, 1121, 1121, 1121, 1121, 1121, 1121, 1121, 1121, 1121, 1121, 1121, 1103, 1028, 234, 235, 236, 237, 238, 239, 240, 241, 242, 243, 244, 245, 1028, 234, 235, 236, 237, 238, 239, 240, 241, 242, 243, 244, 245, 1028, 235, 236, 237, 238, 239, 240, 241, 242, 243, 244, 245, 1106, 1165, 1165, 1165, 1165, 1165, 1165, 1165, 1165, 1165, 1165, 1165, 1165, 1165, 1165, 1165, 1165, 1165, 1165, 1165, 1165
1121, 1121, 1121, 1121, 1121, 1121, 1121, 1121, 1121, 1121, 1121, 1121, 1121, 1121, 1121, 1121, 1121, 1121, 1121, 1121, 1103, 1028, 266, 267, 268, 269, 270, 271, 272, 273, 274, 275, 276, 277, 1028, 266, 267, 268, 269, 270, 271, 272, 273, 274, 275, 276, 277, 1028, 267, 268, 269, 270, 271, 272, 273, 274, 275, 276, 277, 1106, 1165, 1165, 1165, 1165, 1165, 1165, 1165, 1165, 1165, 1165, 1165, 1165, 1165, 1165, 1165, 1165, 1165, 1165, 1165, 1165
1121, 1121, 1121, 1121, 1121, 1121, 1121, 1121, 1121, 1121, 1121, 1121, 1121, 1121, 1121, 1121, 1121, 1121, 1121, 1121, 1103, 1028, 298, 299, 300, 301, 302, 303, 304, 305, 306, 307, 308, 309, 434, 298, 299, 300, 301, 302, 303, 304, 305, 306, 307, 308, 309, 1028, 299, 300, 301, 302, 303, 304, 305, 306, 307, 308, 309, 1106, 1165, 1165, 1165, 1165, 1165, 1165, 1165, 1165, 1165, 1165, 1165, 1165, 1165, 1165, 1165, 1165, 1165, 1165, 1165, 1165
1121, 1121, 1121, 1121, 1121, 1121, 1121, 1121, 1121, 1121, 1121, 1121, 1121, 1121, 1121, 1121, 1121, 1121, 1121, 1121, 1103, 1028, 330, 331, 332, 333, 334, 335, 336, 337, 338, 339, 340, 341, 434, 330, 331, 332, 333, 334, 335, 336, 337, 338, 339, 340, 341, 1028, 331, 332, 333, 334, 335, 336, 337, 338, 339, 340, 341, 1106, 1165, 1165, 1165, 1165, 1165, 1165, 1165, 1165, 1165, 1165, 1165, 1165, 1165, 1165, 1165, 1165, 1165, 1165, 1165, 1165
1121, 1121, 1121, 1121, 1121, 1121, 1121, 1121, 1121, 1121, 1121, 1121, 1121, 1121, 1121, 1121, 1121, 1121, 1121, 1121, 1103, 1028, 362, 363, 364, 365, 366, 367, 368, 369, 370, 371, 372, 373, 1028, 362, 363, 364, 365, 366, 367, 368, 369, 370, 371, 372, 373, 1028, 363, 364, 365, 366, 367, 368, 369, 370, 371, 372, 373, 1106, 1165, 1165, 1165, 1165, 1165, 1165, 1165, 1165, 1165, 1165, 1165, 1165, 1165, 1165, 1165, 1165, 1165, 1165, 1165, 1165
1121, 1121, 1121, 1121, 1121, 1121, 1121, 1121, 1121, 1121, 1121, 1121, 1121, 1121, 1121, 1121, 1121, 1121, 1121, 1121, 1103, 1028, 394, 395, 396, 397, 398, 399, 400, 401, 402, 403, 404, 405, 1028, 394, 395, 396, 397, 398, 399, 400, 401, 402, 403, 404, 405, 1028, 395, 396, 397, 398, 399, 400, 401, 402, 403, 404, 405, 1106, 1165, 1165, 1165, 1165, 1165, 1165, 1165, 1165, 1165, 1165, 1165, 1165, 1165, 1165, 1165, 1165, 1165, 1165, 1165, 1165
1121, 1121, 1121, 1121, 1121, 1121, 1121, 1121, 1121, 1121, 1121, 1121, 1121, 1121, 1121, 1121, 1121, 1121, 1121, 1121, 1103, 1028, 426, 427, 428, 429, 430, 431, 432, 433, 434, 435, 436, 437, 1028, 426, 427, 428, 429, 430, 431, 432, 433, 434, 435, 436, 437, 1028, 427, 428, 429, 430, 431, 432, 433, 434, 435, 436, 437, 1106, 1165, 1165, 1165, 1165, 1165, 1165, 1165, 1165, 1165, 1165, 1165, 1165, 1165, 1165, 1165, 1165, 1165, 1165, 1165, 1165
1121, 1121, 1121, 1121, 1121, 1121, 1121, 1121, 1121, 1121, 1121, 1121, 1121, 1121, 1121, 1121, 1121, 1121, 1121, 1121, 1103, 1028, 458, 459, 460, 461, 462, 463, 464, 465, 466, 467, 468, 469, 1028, 458, 459, 460, 461, 462, 463, 464, 465, 466, 467, 468, 469, 1028, 459, 460, 461, 462, 463, 464, 465, 466, 467, 468, 469, 1106, 1165, 1165, 1165, 1165, 1165, 1165, 1165, 1165, 1165, 1165, 1165, 1165, 1165, 1165, 1165, 1165, 1165, 1165, 1165, 1165
1121, 1121, 1121, 1121, 1121, 1121, 1121, 1121, 1121, 1121, 1121, 1121, 1121, 1121, 1121, 1121, 1121, 1121, 1121, 1121, 1103, 1028, 1028, 1028, 1028, 1028, 1028, 1028, 1028, 1028, 1028, 1028, 1028, 1028, 1028, 1028, 1028, 434, 434, 1028, 1028, 1028, 1028, 1028, 1028, 1028, 1028, 1028, 1028, 1028, 1028, 1028, 1028, 1028, 1028, 1028, 1028, 1028, 434, 1106, 1165, 1165, 1165, 1165, 1165, 1165, 1165, 1165, 1165, 1165, 1165, 1165, 1165, 1165, 1165, 1165, 1165, 1165, 1165, 1165
1121, 1121, 1121, 1121, 1121, 1121, 1121, 1121, 1121, 1121, 1121, 1121, 1121, 1121, 1121, 1121, 1121, 1121, 1121, 1121, 1103, 1028, 106, 107, 108, 109, 110, 111, 112, 113, 114, 115, 116, 117, 1028, 106, 107, 108, 109, 110, 111, 112, 113, 114, 115, 116, 117, 1028, 107, 108, 109, 110, 111, 112, 113, 114, 115, 116, 117, 1106, 1165, 1165, 1165, 1165, 1165, 1165, 1165, 1165, 1165, 1165, 1165, 1165, 1165, 1165, 1165, 1165, 1165, 1165, 1165, 1165
1121, 1121, 1121, 1121, 1121, 1121, 1121, 1121, 1121, 1121, 1121, 1121, 1121, 1121, 1121, 1121, 1121, 1121, 1121, 1121, 1103, 1028, 138, 139, 140, 141, 142, 143, 144, 145, 146, 147, 148, 149, 1028, 138, 139, 140, 141, 142, 143, 144, 145, 146, 147, 148, 149, 1028, 139, 140, 141, 142, 143, 144, 145, 146, 147, 148, 149, 1106, 1165, 1165, 1165, 1165, 1165, 1165, 1165, 1165, 1165, 1165, 1165, 1165, 1165, 1165, 1165, 1165, 1165, 1165, 1165, 1165
1121, 1121, 1121, 1121, 1121, 1121, 1121, 1121, 1121, 1121, 1121, 1121, 1121, 1121, 1121, 1121, 1121, 1121, 1121, 1121, 1103, 1028, 170, 171, 172, 173, 174, 175, 176, 177, 178, 179, 180, 181, 1028, 170, 171, 172, 173, 174, 175, 176, 177, 178, 179, 180, 181, 1028, 171, 172, 173, 174, 175, 176, 177, 178, 179, 180, 181, 1106, 1165, 1165, 1165, 1165, 1165, 1165, 1165, 1165, 1165, 1165, 1165, 1165, 1165, 1165, 1165, 1165, 1165, 1165, 1165, 1165
1121, 1121, 1121, 1121, 1121, 1121, 1121, 1121, 1121, 1121, 1121, 1121, 1121, 1121, 1121, 1121, 1121, 1121, 1121, 1121, 1103, 1028, 202, 203, 204, 205, 206, 207, 208, 209, 210, 211, 212, 213, 1028, 202, 203, 204, 205, 206, 207, 208, 209, 210, 211, 212, 213, 1028, 203, 204, 205, 206, 207, 208, 209, 210, 211, 212, 213, 1106, 1165, 1165, 1165, 1165, 1165, 1165, 1165, 1165, 1165, 1165, 1165, 1165, 1165, 1165, 1165, 1165, 1165, 1165, 1165, 1165
1121, 1121, 1121, 1121, 1121, 1121, 1121, 1121, 1121, 1121, 1121, 1121, 1121, 1121, 1121, 1121, 1121, 1121, 1121, 1121, 1103, 1028, 234, 235, 236, 237, 238, 239, 240, 241, 242, 243, 244, 245, 1028, 234, 235, 236, 237, 238, 239, 240, 241, 242, 243, 244, 245, 1028, 235, 236, 237, 238, 239, 240, 241, 242, 243, 244, 245, 1106, 1165, 1165, 1165, 1165, 1165, 1165, 1165, 1165, 1165, 1165, 1165, 1165, 1165, 1165, 1165, 1165, 1165, 1165, 1165, 1165
1121, 1121, 1121, 1121, 1121, 1121, 1121, 1121, 1121, 1121, 1121, 1121, 1121, 1121, 1121, 1121, 1121, 1121, 1121, 1121, 1103, 1028, 266, 267, 268, 269, 270, 271, 272, 273, 274, 275, 276, 277, 434, 266, 267, 268, 269, 270, 271, 272, 273, 274, 275, 276, 277, 434, 267, 268, 269, 270, 271, 272, 273, 274, 275, 276, 277, 1106, 1165, 1165, 1165, 1165, 1165, 1165, 1165, 1165, 1165, 1165, 1165, 1165, 1165, 1165, 1165, 1165, 1165, 1165, 1165, 1165
1121, 1121, 1121, 1121, 1121, 1121, 1121, 1121, 1121, 1121, 1121, 1121, 1121, 1121, 1121, 1121, 1121, 1121, 1121, 1121, 1103, 1028, 298, 299, 300, 301, 302, 303, 304, 305, 306, 307, 308, 309, 434, 298, 299, 300, 301, 302, 303, 304, 305, 306, 307, 308, 309, 434, 299, 300, 301, 302, 303, 304, 305, 306, 307, 308, 309, 1106, 1165, 1165, 1165, 1165, 1165, 1165, 1165, 1165, 1165, 1165, 1165, 1165, 1165, 1165, 1165, 1165, 1165, 1165, 1165, 1165
1121, 1121, 1121, 1121, 1121, 1121, 1121, 1121, 1121, 1121, 1121, 1121, 1121, 1121, 1121, 1121, 1121, 1121, 1121, 1121, 1103, 1028, 330, 331, 332, 333, 334, 335, 336, 337, 338, 339, 340, 341, 1028, 330, 331, 332, 333, 334, 335, 336, 337, 338, 339, 340, 341, 1028, 331, 332, 333, 334, 335, 336, 337, 338, 339, 340, 341, 1106, 1165, 1165, 1165, 1165, 1165, 1165, 1165, 1165, 1165, 1165, 1165, 1165, 1165, 1165, 1165, 1165, 1165, 1165, 1165, 1165
1121, 1121, 1121, 1121, 1121, 1121, 1121, 1121, 1121, 1121, 1121, 1121, 1121, 1121, 1121, 1121, 1121, 1121, 1121, 1121, 1103, 1028, 362, 363, 364, 365, 366, 367, 368, 369, 370, 371, 372, 373, 1028, 362, 363, 364, 365, 366, 367, 368, 369, 370, 371, 372, 373, 1028, 363, 364, 365, 366, 367, 368, 369, 370, 371, 372, 373, 1106, 1165, 1165, 1165, 1165, 1165, 1165, 1165, 1165, 1165, 1165, 1165, 1165, 1165, 1165, 1165, 1165, 1165, 1165, 1165, 1165
1121, 1121, 1121, 1121, 1121, 1121, 1121, 1121, 1121, 1121, 1121, 1121, 1121, 1121, 1121, 1121, 1121, 1121, 1121, 1121, 1103, 1028, 394, 395, 396, 397, 398, 399, 400, 401, 402, 403, 404, 405, 1028, 394, 395, 396, 397, 398, 399, 400, 401, 402, 403, 404, 405, 1028, 395, 396, 397, 398, 399, 400, 401, 402, 403, 404, 405, 1106, 1165, 1165, 1165, 1165, 1165, 1165, 1165, 1165, 1165, 1165, 1165, 1165, 1165, 1165, 1165, 1165, 1165, 1165, 1165, 1165
1121, 1121, 1121, 1121, 1121, 1121, 1121, 1121, 1121, 1121, 1121, 1121, 1121, 1121, 1121, 1121, 1121, 1121, 1121, 1121, 1103, 1028, 426, 427, 428, 429, 430, 431, 432, 433, 434, 435, 436, 437, 1028, 426, 427, 428, 429, 430, 431, 432, 433, 434, 435, 436, 437, 1028, 427, 428, 429, 430, 431, 432, 433, 434, 435, 436, 437, 1106, 1165, 1165, 1165, 1165, 1165, 1165, 1165, 1165, 1165, 1165, 1165, 1165, 1165, 1165, 1165, 1165, 1165, 1165, 1165, 1165
1121, 1121, 1121, 1121, 1121, 1121, 1121, 1121, 1121, 1121, 1121, 1121, 1121, 1121, 1121, 1121, 1121, 1121, 1121, 1121, 1103, 1028, 458, 459, 460, 461, 462, 463, 464, 465, 466, 467, 468, 469, 1028, 458, 459, 460, 461, 462, 463, 464, 465, 466, 467, 468, 469, 1028, 459, 460, 461, 462, 463, 464, 465, 466, 467, 468, 469, 1106, 1165, 1165, 1165, 1165, 1165, 1165, 1165, 1165, 1165, 1165, 1165, 1165, 1165, 1165, 1165, 1165, 1165, 1165, 1165, 1165
1121, 1121, 1121, 1121, 1121, 1121, 1121, 1121, 1121, 1121, 1121, 1121, 1121, 1121, 1121, 1121, 1121, 1121, 1121, 1121, 1103, 1028, 1028, 1028, 1028, 1028, 1028, 1028, 1028, 1028, 1028, 1028, 1028, 1028, 1028, 1028, 1028, 1028, 1028, 1028, 1028, 1028, 1028, 1028, 1028, 1028, 1028, 1028, 1028, 1028, 1028, 1028, 1028, 1028, 1028, 1028, 1028, 1028, 1028, 1106, 1165, 1165, 1165, 1165, 1165, 1165, 1165, 1165, 1165, 1165, 1165, 1165, 1165, 1165, 1165, 1165, 1165, 1165, 1165, 1165
1121, 1121, 1121, 1121, 1121, 1121, 1121, 1121, 1121, 1121, 1121, 1121, 1121, 1121, 1121, 1121, 1121, 1121, 1121, 1121, 1103, 1028, 1028, 1028, 1028, 1028, 1028, 1028, 1028, 1028, 1028, 1028, 1028, 1028, 1028, 1028, 1028, 1028, 1028, 1028, 1028, 1028, 1028, 1028, 1028, 1028, 1028, 1028, 1028, 1028, 1028, 1028, 1028, 1028, 1028, 1028, 1028, 1028, 1028, 1106, 1165, 1165, 1165, 1165, 1165, 1165, 1165, 1165, 1165, 1165, 1165, 1165, 1165, 1165, 1165, 1165, 1165, 1165, 1165, 1165
1121, 1121, 1121, 1121, 1121, 1121, 1121, 1121, 1121, 1121, 1121, 1121, 1121, 1121, 1121, 1121, 1121, 1121, 1121, 1121, 1103, 1028, 1028, 1028, 1028, 1028, 1028, 1028, 1028, 1028, 1028, 1028, 1028, 1028, 1028, 1028, 1028, 1028, 1028, 1028, 1028, 1028, 1028, 1028, 1028, 1028, 1028, 1028, 1028, 1028, 1028, 1028, 1028, 1028, 1028, 1028, 1028, 1028, 1028, 1106, 1165, 1165, 1165, 1165, 1165, 1165, 1165, 1165, 1165, 1165, 1165, 1165, 1165, 1165, 1165, 1165, 1165, 1165, 1165, 1165
1121, 1121, 1121, 1121, 1121, 1121, 1121, 1121, 1121, 1121, 1121, 1121, 1121, 1121, 1121, 1121, 1121, 1121, 1121, 1121, 1103, 1028, 1028, 1028, 1028, 1028, 1028, 1028, 1028, 1028, 1028, 1028, 1028, 1028, 1028, 1028, 1028, 1028, 1028, 1028, 1028, 1028, 1028, 1028, 1028, 1028, 1028, 1028, 1028, 1028, 1028, 1028, 1028, 1028, 1028, 1028, 1028, 1028, 1028, 1106, 1165, 1165, 1165, 1165, 1165, 1165, 1165, 1165, 1165, 1165, 1165, 1165, 1165, 1165, 1165, 1165, 1165, 1165, 1165, 1165
1121, 1121, 1121, 1121, 1121, 1121, 1121, 1121, 1121, 1121, 1121, 1121, 1121, 1121, 1121, 1121, 1121, 1121, 1121, 1121, 1103, 1028, 1028, 1028, 1028, 1028, 1028, 1028, 1028, 1028, 1028, 1028, 1028, 1028, 1028, 1028, 1028, 1028, 1028, 1028, 1028, 1028, 1028, 1028, 1028, 1028, 1028, 1028, 1028, 1028, 1028, 1028, 1028, 1028, 1028, 1028, 1028, 1028, 1028, 1106, 1165, 1165, 1165, 1165, 1165, 1165, 1165, 1165, 1165, 1165, 1165, 1165, 1165, 1165, 1165, 1165, 1165, 1165, 1165, 1165
1121, 1121, 1121, 1121, 1121, 1121, 1121, 1121, 1121, 1121, 1121, 1121, 1121, 1121, 1121, 1121, 1121, 1121, 1121, 1121, 1057, 1062, 1063, 1064, 1062, 1063, 1064, 1062, 1063, 1064, 1062, 1063, 1064, 1062, 1063, 1064, 1062, 1063, 1064, 1062, 1062, 1063, 1064, 1062, 1063, 1064, 1062, 1063, 1064, 1062, 1063, 1064, 1062, 1063, 1064, 1062, 1063, 1064, 1062, 1068, 1165, 1165, 1165, 1165, 1165, 1165, 1165, 1165, 1165, 1165, 1165, 1165, 1165, 1165, 1165, 1165, 1165, 1165, 1165, 1165
1121, 1121, 1121, 1121, 1121, 1121, 1121, 1121, 1121, 1121, 1121, 1121, 1121, 1121, 1121, 1121, 1121, 1121, 1121, 1121, 1167, 1168, 1169, 1167, 1168, 1169, 1167, 1168, 1169, 1167, 1168, 1169, 1167, 1168, 1169, 1167, 1168, 1169, 1167, 1168, 1169, 1167, 1168, 1169, 1167, 1168, 1169, 1167, 1168, 1169, 1167, 1168, 1169, 1167, 1168, 1169, 1167, 1168, 1169, 1167, 1168, 1169, 1167, 1168, 1169, 1165, 1165, 1165, 1165, 1165, 1165, 1165, 1165, 1165, 1165, 1165, 1165, 1165, 1165, 1165
1121, 1121, 1121, 1121, 1121, 1121, 1121, 1121, 1121, 1121, 1121, 1121, 1121, 1121, 1121, 1121, 1121, 1121, 1121, 1121, 1167, 1168, 1169, 1167, 1168, 1169, 1167, 1168, 1169, 1167, 1168, 1169, 1167, 1168, 1169, 1167, 1168, 1169, 1167, 1168, 1169, 1167, 1168, 1169, 1167, 1168, 1169, 1167, 1168, 1169, 1167, 1168, 1169, 1167, 1168, 1169, 1167, 1168, 1169, 1167, 1168, 1169, 1167, 1168, 1169, 1165, 1165, 1165, 1165, 1165, 1165, 1165, 1165, 1165, 1165, 1165, 1165, 1165, 1165, 1165
1121, 1121, 1121, 1121, 1121, 1121, 1121, 1121, 1121, 1121, 1121, 1121, 1121, 1121, 1121, 1121, 1121, 1121, 1121, 1121, 1167, 1168, 1169, 1167, 1168, 1169, 1167, 1168, 1169, 1167, 1168, 1169, 1167, 1168, 1169, 1167, 1168, 1169, 1167, 1168, 1169, 1167, 1168, 1169, 1167, 1168, 1169, 1167, 1168, 1169, 1167, 1168, 1169, 1167, 1168, 1169, 1167, 1168, 1169, 1167, 1168, 1169, 1167, 1168, 1169, 1165, 1165, 1165, 1165, 1165, 1165, 1165, 1165, 1165, 1165, 1165, 1165, 1165, 1165, 1165
1121, 1121, 1121, 1121, 1121, 1121, 1121, 1121, 1121, 1121, 1121, 1121, 1121, 1121, 1121, 1121, 1121, 1121, 1121, 1121, 1167, 1168, 1169, 1167, 1168, 1169, 1167, 1168, 1169, 1167, 1168, 1169, 1167, 1168, 1169, 1167, 1168, 1169, 1167, 1168, 1169, 1167, 1168, 1169, 1167, 1168, 1169, 1167, 1168, 1169, 1167, 1168, 1169, 1167, 1168, 1169, 1167, 1168, 1169, 1167, 1168, 1169, 1167, 1168, 1169, 1121, 1121, 1121, 1121, 1121, 1121, 1121, 1121, 1121, 1121, 1121, 1121, 1121, 1121, 1121
1121, 1121, 1121, 1121, 1121, 1121, 1121, 1121, 1121, 1121, 1121, 1121, 1121, 1121, 1121, 1121, 1121, 1121, 1121, 1121, 1121, 1121, 1121, 1121, 1121, 1121, 1121, 1121, 1121, 1121, 1121, 1121, 1121, 1121, 1121, 1121, 1121, 1121, 1121, 1121, 1121, 1121, 1121, 1121, 1121, 1121, 1121, 1121, 1121, 1121, 1121, 1121, 1121, 1121, 1121, 1121, 1121, 1121, 1121, 1121, 1121, 1121, 1121, 1121, 1121, 1121, 1121, 1121, 1121, 1121, 1121, 1121, 1121, 1121, 1121, 1121, 1121, 1121, 1121, 1121
