1121, 1121, 1121, 1121, 1121, 1121, 1121, 1121, 1121, 1121, 1121, 1121, 1121, 1121, 1121, 1121, 1121, 1121, 1121, 1121, 1121, 1121, 1121, 1121, 1121, 1121, 1121, 1121, 1121, 1121, 1121, 1121, 1121, 1121, 1121, 1121, 1121, 1121, 1121, 1121, 1121, 1121, 1121, 1121, 1121, 1121, 1121, 1121, 1121, 1121, 1121, 1121, 1121, 1121, 1121, 1121, 1121, 1121, 1121, 1121, 1121, 1121, 1121, 1121, 1121, 1121, 1121, 1121, 1121, 1121, 1121, 1121, 1121, 1121, 1121, 1121, 1121, 1121, 1121, 1121
1121, 1121, 1121, 1121, 1121, 1121, 1121, 1121, 1121, 1121, 1121, 1121, 1121, 1121, 1121, 1121, 1121, 1121, 1121, 1121, 1121, 1121, 1121, 1121, 1121, 1121, 1121, 1121, 1121, 1121, 1121, 1121, 1121, 1121, 1121, 1121, 1121, 1121, 1121, 1121, 1121, 1121, 1121, 1121, 1121, 1121, 1121, 1121, 1121, 1121, 1121, 1121, 1121, 1121, 1121, 1121, 1121, 1121, 1121, 1121, 1121, 1121, 1121, 1121, 1121, 1121, 1121, 1121, 1121, 1121, 1121, 1121, 1121, 1121, 1121, 1121, 1121, 1121, 1121, 1121
1121, 1121, 1121, 1121, 1121, 1121, 1121, 1121, 1121, 1121, 1121, 1121, 1121, 1121, 1121, 1121, 1121, 1121, 1121, 1121, 1121, 1121, 1121, 1121, 1121, 1121, 1121, 1121, 1121, 1121, 1121, 1121, 1121, 1121, 1121, 1121, 1121, 1121, 1121, 1121, 1121, 1121, 1121, 1121, 1121, 1121, 1121, 1121, 1121, 1121, 1121, 1121, 1121, 1121, 1121, 1121, 1121, 1121, 1121, 1121, 1121, 1121, 1121, 1121, 1121, 1121, 1121, 1121, 1121, 1121, 1121, 1121, 1121, 1121, 1121, 1121, 1121, 1121, 1121, 1121
1121, 1121, 1121, 1121, 1121, 1121, 1121, 1121, 1121, 1121, 1121, 1121, 1121, 1121, 1121, 1121, 1121, 1121, 1121, 1121, 1121, 1121, 1121, 1121, 1121, 1121, 1121, 1121, 1121, 1121, 1121, 1121, 1121, 1121, 1121, 1121, 1121, 1121, 1121, 1121, 1121, 1121, 1121, 1121, 1121, 1121, 1121, 1121, 1121, 1121, 1121, 1121, 1121, 1121, 1121, 1121, 1121, 1121, 1121, 1121, 1121, 1121, 1121, 1121, 1121, 1121, 1121, 1121, 1121, 1121, 1121, 1121, 1121, 1121, 1121, 1121, 1121, 1121, 1121, 1121
1121, 1121, 1121, 1121, 1121, 1121, 1121, 1121, 1121, 1121, 1121, 1121, 1121, 1121, 1121, 1121, 1121, 1121, 1121, 1121, 1121, 1121, 1121, 1121, 1121, 1121, 1121, 1121, 1121, 1121, 1121, 1121, 1121, 1121, 1121, 1121, 1121, 1121, 1121, 1121, 1121, 1121, 1121, 1121, 1121, 1121, 1121, 1121, 1121, 1121, 1121, 1121, 1121, 1121, 1121, 1121, 1121, 1121, 1121, 1121, 1121, 1121, 1121, 1121, 1121, 1121, 1121, 1121, 1121, 1121, 1121, 1121, 1121, 1121, 1121, 1121, 1121, 1121, 1121, 1121
1121, 1121, 1121, 1121, 1121, 1121, 1121, 1121, 1121, 1121, 1121, 1121, 1121, 1121, 1121, 1121, 1121, 1121, 1121, 1121, 1121, 1121, 1121, 1121, 1121, 1121, 1121, 1121, 1121, 1121, 1121, 1121, 1121, 1121, 1121, 1121, 1121, 1121, 1121, 1121, 1121, 1121, 1121, 1121, 1121, 1121, 1121, 1121, 1121, 1121, 1121, 1121, 1121, 1121, 1121, 1121, 1121, 1121, 1121, 1121, 1121, 1121, 1121, 1121, 1121, 1121, 1121, 1121, 1121, 1121, 1121, 1121, 1121, 1121, 1121, 1121, 1121, 1121, 1121, 1121
1121, 1121, 1121, 1121, 1121, 1121, 1121, 1121, 1121, 1121, 1121, 1121, 1121, 1121, 1121, 1121, 1121, 1121, 1121, 1121, 1121, 1121, 1121, 1121, 1121, 1121, 1121, 1121, 1121, 1121, 1121, 1121, 1121, 1121, 1121, 1121, 1121, 1121, 1121, 1121, 1121, 1121, 1121, 1121, 1121, 1121, 1121, 1121, 1121, 1121, 1121, 1121, 1121, 1121, 1121, 1121, 1121, 1121, 1121, 1121, 1121, 1121, 1121, 1121, 1121, 1121, 1121, 1121, 1121, 1121, 1121, 1121, 1121, 1121, 1121, 1121, 1121, 1121, 1121, 1121
1121, 1121, 1121, 1121, 1121, 1121, 1121, 1121, 1121, 1121, 1121, 1121, 1121, 1121, 1121, 1121, 1121, 1121, 1121, 1121, 1121, 1121, 1121, 1121, 1121, 1121, 1121, 1121, 1121, 1121, 1121, 1121, 1121, 1121, 1121, 1121, 1121, 1121, 1121, 1121, 1121, 1121, 1121, 1121, 1121, 1121, 1121, 1121, 1121, 1121, 1121, 1121, 1121, 1121, 1121, 1121, 1121, 1121, 1121, 1121, 1121, 1121, 1121, 1121, 1121, 1121, 1121, 1121, 1121, 1121, 1121, 1121, 1121, 1121, 1121, 1121, 1121, 1121, 1121, 1121
1121, 1121, 1121, 1121, 1121, 1121, 1121, 1121, 1121, 1121, 1121, 1121, 1121, 1121, 1121, 1121, 1121, 1121, 1121, 1089, 1094, 1095, 1096, 1097, 1094, 1095, 1096, 1097, 1094, 1095, 1096, 1097, 1094, 1095, 1096, 1097, 1094, 1095, 1096, 1097, 1094, 1095, 1096, 1097, 1094, 1095, 1096, 1097, 1094, 1095, 1096, 1097, 1094, 1095, 1096, 1097, 1094, 1095, 1096, 1097, 1094, 1095, 1100, 1121, 1121, 1121, 1121, 1121, 1121, 1121, 1121, 1121, 1121, 1121, 1121, 1121, 1121, 1121, 1121, 1121
1120, 1120, 1120, 1120, 1120, 1120, 1120, 1120, 1120, 1120, 1120, 1120, 1120, 1120, 1120, 1120, 1120, 1120, 1120, 1071, 147, 148, 149, 150, 1053, 0, 0, 0, 0, 0, 0, 0, 0, 0, 0, 0, 0, 1052, 1052, 232, 147, 0, 0, 0, 0, 0, 0, 0, 0, 0, 0, 0, 0, 0, 0, 0, 1053, 147, 148, 149, 150, 0, 1106, 1120, 1120, 1120, 1120, 1120, 1120, 1120, 1120, 1120, 1120, 1120, 1120, 1120, 1120, 1120, 1120, 1120
1120, 1120, 1120, 1120, 1120, 1120, 1120, 1120, 1120, 1120, 1120, 1120, 1120, 1120, 1120, 1120, 1120, 1120, 1120, 1103, 151, 179, 180, 181, 1053, 212, 213, 214, 215, 216, 217, 218, 219, 0, 0, 0, 0, 0, 0, 232, 147, 0, 0, 0, 172, 173, 172, 173, 174, 175, 176, 177, 178, 179, 0, 0, 1053, 151, 179, 180, 181, 0, 1138, 1120, 1120, 1120, 1120, 1120, 1120, 1120, 1120, 1120, 1120, 1120, 1120, 1120, 1120, 1120, 1120, 1120
1120, 1120, 1120, 1120, 1120, 1120, 1120, 1120, 1120, 1120, 1120, 1120, 1120, 1120, 1120, 1120, 1120, 1120, 1120, 1135, 182, 183, 211, 212, 1053, 244, 245, 246, 247, 248, 249, 250, 251, 0, 0, 0, 0, 0, 0, 0, 0, 0, 0, 0, 204, 205, 204, 205, 206, 207, 208, 209, 210, 211, 0, 0, 1053, 182, 183, 211, 212, 0, 1074, 1120, 1120, 1120, 1120, 1120, 1120, 1120, 1120, 1120, 1120, 1120, 1120, 1120, 1120, 1120, 1120, 1120
1120, 1120, 1120, 1120, 1120, 1120, 1120, 1120, 1120, 1120, 1120, 1120, 1120, 1120, 1120, 1120, 1120, 1120, 1120, 1071, 213, 214, 215, 243, 1053, 276, 277, 278, 279, 280, 281, 282, 283, 0, 0, 0, 0, 0, 0, 0, 0, 0, 0, 0, 236, 237, 236, 237, 238, 239, 240, 241, 242, 243, 0, 0, 1053, 213, 147, 148, 149, 150, 1106, 1120, 1120, 1120, 1120, 1120, 1120, 1120, 1120, 1120, 1120, 1120, 1120, 1120, 1120, 1120, 1120, 1120
1120, 1120, 1120, 1120, 1120, 1120, 1120, 1120, 1120, 1120, 1120, 1120, 1120, 1120, 1120, 1120, 1120, 1120, 1120, 1103, 244, 245, 246, 247, 1053, 308, 309, 310, 311, 212, 213, 214, 215, 216, 217, 218, 219, 0, 0, 0, 0, 0, 0, 0, 268, 269, 268, 269, 270, 271, 272, 273, 274, 275, 0, 0, 1053, 244, 151, 179, 180, 181, 1138, 1120, 1120, 1120, 1120, 1120, 1120, 1120, 1120, 1120, 1120, 1120, 1120, 1120, 1120, 1120, 1120, 1120
1120, 1120, 1120, 1120, 1120, 1120, 1120, 1120, 1120, 1120, 1120, 1120, 1120, 1120, 1120, 1120, 1120, 1120, 1120, 1135, 275, 276, 277, 278, 1053, 340, 341, 342, 343, 244, 245, 246, 247, 248, 249, 212, 213, 214, 215, 216, 217, 218, 219, 0, 300, 301, 300, 301, 302, 303, 304, 305, 306, 307, 0, 0, 1053, 275, 182, 183, 211, 212, 1074, 1120, 1120, 1120, 1120, 1120, 1120, 1120, 1120, 1120, 1120, 1120, 1120, 1120, 1120, 1120, 1120, 1120
1120, 1120, 1120, 1120, 1120, 1120, 1120, 1120, 1120, 1120, 1120, 1120, 1120, 1120, 1120, 1120, 1120, 1120, 1120, 1071, 279, 147, 148, 149, 1053, 372, 373, 374, 375, 276, 277, 278, 279, 280, 281, 244, 245, 246, 247, 248, 249, 250, 251, 0, 332, 333, 332, 333, 334, 335, 336, 337, 338, 339, 0, 0, 1053, 279, 213, 214, 215, 243, 1106, 1120, 1120, 1120, 1120, 1120, 1120, 1120, 1120, 1120, 1120, 1120, 1120, 1120, 1120, 1120, 1120, 1120
1120, 1120, 1120, 1120, 1120, 1120, 1120, 1120, 1120, 1120, 1120, 1120, 1120, 1120, 1120, 1120, 1120, 1120, 1120, 1103, 150, 151, 179, 180, 1053, 404, 405, 406, 407, 308, 309, 310, 311, 312, 313, 276, 277, 278, 279, 280, 281, 282, 283, 0, 364, 365, 364, 365, 366, 367, 368, 369, 370, 371, 0, 0, 1053, 150, 244, 245, 246, 247, 1138, 1120, 1120, 1120, 1120, 1120, 1120, 1120, 1120, 1120, 1120, 1120, 1120, 1120, 1120, 1120, 1120, 1120
1120, 1120, 1120, 1120, 1120, 1120, 1120, 1120, 1120, 1120, 1120, 1120, 1120, 1120, 1120, 1120, 1120, 1120, 1120, 1071, 181, 182, 183, 211, 1053, 436, 437, 438, 439, 340, 341, 342, 343, 344, 345, 308, 309, 310, 311, 312, 313, 314, 315, 0, 396, 397, 396, 397, 398, 399, 400, 401, 402, 403, 0, 0, 1053, 181, 275, 276, 277, 278, 1074, 1120, 1120, 1120, 1120, 1120, 1120, 1120, 1120, 1120, 1120, 1120, 1120, 1120, 1120, 1120, 1120, 1120
1120, 1120, 1120, 1120, 1120, 1120, 1120, 1120, 1120, 1120, 1120, 1120, 1120, 1120, 1120, 1120, 1120, 1120, 1120, 1103, 212, 213, 214, 215, 1053, 0, 0, 0, 0, 372, 373, 374, 375, 376, 377, 340, 341, 342, 343, 344, 345, 346, 347, 0, 308, 309, 310, 311, 312, 313, 314, 315, 0, 0, 0, 0, 1053, 212, 279, 147, 148, 149, 1106, 1120, 1120, 1120, 1120, 1120, 1120, 1120, 1120, 1120, 1120, 1120, 1120, 1120, 1120, 1120, 1120, 1120
1120, 1120, 1120, 1120, 1120, 1120, 1120, 1120, 1120, 1120, 1120, 1120, 1120, 1120, 1120, 1120, 1120, 1120, 1120, 1135, 243, 244, 245, 246, 1053, 0, 0, 0, 0, 404, 405, 406, 407, 408, 409, 372, 373, 374, 375, 376, 377, 378, 379, 0, 340, 341, 342, 343, 344, 345, 346, 347, 0, 0, 0, 0, 1053, 243, 150, 151, 179, 180, 1138, 1120, 1120, 1120, 1120, 1120, 1120, 1120, 1120, 1120, 1120, 1120, 1120, 1120, 1120, 1120, 1120, 1120
1120, 1120, 1120, 1120, 1120, 1120, 1120, 1120, 1120, 1120, 1120, 1120, 1120, 1120, 1120, 1120, 1120, 1120, 1120, 1071, 247, 275, 276, 277, 1053, 0, 0, 0, 0, 436, 437, 438, 439, 440, 441, 404, 405, 406, 407, 408, 409, 410, 411, 0, 372, 373, 374, 375, 376, 377, 378, 379, 0, 0, 0, 0, 1053, 247, 181, 182, 183, 211, 1074, 1120, 1120, 1120, 1120, 1120, 1120, 1120, 1120, 1120, 1120, 1120, 1120, 1120, 1120, 1120, 1120, 1120
1120, 1120, 1120, 1120, 1120, 1120, 1120, 1120, 1120, 1120, 1120, 1120, 1120, 1120, 1120, 1120, 1120, 1120, 1120, 1103, 278, 279, 147, 148, 1053, 0, 0, 0, 0, 0, 0, 0, 0, 0, 0, 436, 437, 438, 439, 440, 441, 442, 443, 0, 404, 405, 406, 407, 408, 409, 410, 411, 0, 0, 0, 0, 1053, 278, 212, 213, 214, 215, 1106, 1120, 1120, 1120, 1120, 1120, 1120, 1120, 1120, 1120, 1120, 1120, 1120, 1120, 1120, 1120, 1120, 1120
1120, 1120, 1120, 1120, 1120, 1120, 1120, 1120, 1120, 1120, 1120, 1120, 1120, 1120, 1120, 1120, 1120, 1120, 1120, 1135, 149, 150, 151, 179, 1053, 0, 0, 0, 0, 0, 0, 0, 0, 0, 0, 0, 212, 213, 214, 215, 216, 217, 218, 219, 436, 437, 438, 439, 440, 441, 442, 443, 0, 0, 0, 0, 1053, 149, 243, 244, 245, 246, 1138, 1120, 1120, 1120, 1120, 1120, 1120, 1120, 1120, 1120, 1120, 1120, 1120, 1120, 1120, 1120, 1120, 1120
1120, 1120, 1120, 1120, 1120, 1120, 1120, 1120, 1120, 1120, 1120, 1120, 1120, 1120, 1120, 1120, 1120, 1120, 1120, 1071, 180, 181, 182, 183, 1053, 0, 0, 0, 0, 0, 172, 173, 174, 175, 176, 177, 178, 179, 246, 247, 248, 249, 250, 251, 0, 0, 0, 0, 0, 0, 0, 0, 0, 0, 0, 0, 1053, 180, 247, 275, 276, 277, 1074, 1120, 1120, 1120, 1120, 1120, 1120, 1120, 1120, 1120, 1120, 1120, 1120, 1120, 1120, 1120, 1120, 1120
1120, 1120, 1120, 1120, 1120, 1120, 1120, 1120, 1120, 1120, 1120, 1120, 1120, 1120, 1120, 1120, 1120, 1120, 1120, 1103, 211, 212, 213, 214, 1053, 0, 0, 0, 0, 0, 204, 205, 206, 207, 208, 209, 210, 211, 278, 279, 280, 281, 282, 283, 0, 0, 0, 212, 213, 214, 215, 216, 217, 218, 219, 0, 1053, 211, 278, 279, 147, 148, 1106, 1120, 1120, 1120, 1120, 1120, 1120, 1120, 1120, 1120, 1120, 1120, 1120, 1120, 1120, 1120, 1120, 1120
1120, 1120, 1120, 1120, 1120, 1120, 1120, 1120, 1120, 1120, 1120, 1120, 1120, 1120, 1120, 1120, 1120, 1120, 1120, 1135, 215, 243, 244, 245, 1053, 0, 0, 0, 0, 0, 236, 237, 238, 239, 240, 241, 242, 243, 310, 311, 312, 313, 314, 315, 182, 183, 214, 244, 245, 246, 247, 248, 249, 250, 251, 0, 1053, 215, 149, 150, 151, 179, 1138, 1120, 1120, 1120, 1120, 1120, 1120, 1120, 1120, 1120, 1120, 1120, 1120, 1120, 1120, 1120, 1120, 1120
1120, 1120, 1120, 1120, 1120, 1120, 1120, 1120, 1120, 1120, 1120, 1120, 1120, 1120, 1120, 1139, 1139, 1139, 1139, 1071, 246, 247, 275, 276, 1053, 0, 0, 0, 0, 0, 268, 269, 270, 271, 272, 273, 274, 275, 342, 343, 344, 345, 346, 347, 182, 183, 214, 276, 277, 278, 279, 280, 281, 282, 283, 0, 1053, 246, 180, 181, 182, 183, 1074, 1120, 1120, 1120, 1120, 1120, 1120, 1120, 1120, 1120, 1120, 1120, 1120, 1120, 1120, 1120, 1120, 1120
1120, 1120, 1120, 1120, 1120, 1120, 1120, 1120, 1120, 1120, 1120, 1120, 1120, 1120, 1120, 1139, 1139, 1139, 1139, 1103, 277, 278, 279, 147, 1053, 0, 0, 0, 0, 0, 300, 301, 302, 303, 304, 305, 306, 307, 374, 375, 376, 377, 378, 379, 218, 219, 214, 308, 309, 310, 311, 312, 313, 314, 315, 333, 1053, 277, 211, 212, 213, 214, 1106, 1120, 1120, 1120, 1120, 1120, 1120, 1120, 1120, 1120, 1120, 1120, 1120, 1120, 1120, 1120, 1120, 1120
1120, 1120, 1120, 1120, 1120, 1120, 1120, 1120, 1120, 1120, 1120, 1120, 1120, 1120, 1120, 1139, 1139, 1139, 1139, 1135, 147, 148, 149, 150, 1053, 212, 213, 214, 215, 216, 332, 333, 334, 335, 336, 337, 338, 339, 406, 407, 408, 409, 410, 411, 250, 251, 214, 340, 212, 213, 214, 215, 216, 217, 218, 219, 1053, 148, 215, 243, 244, 245, 1138, 1120, 1120, 1120, 1120, 1120, 1120, 1120, 1120, 1120, 1120, 1120, 1120, 1120, 1120, 1120, 1120, 1120
1120, 1120, 1120, 1120, 1120, 1120, 1120, 1120, 1120, 1120, 1120, 1120, 1120, 1120, 1120, 1139, 1139, 1139, 1139, 1071, 151, 179, 180, 181, 1053, 244, 245, 246, 247, 248, 364, 365, 366, 367, 368, 369, 370, 371, 438, 439, 440, 441, 442, 443, 282, 283, 214, 372, 244, 245, 246, 247, 248, 249, 250, 251, 1053, 179, 246, 247, 275, 276, 1074, 1120, 1120, 1120, 1120, 1120, 1120, 1120, 1120, 1120, 1120, 1120, 1120, 1120, 1120, 1120, 1120, 1120
1120, 1120, 1120, 1120, 1120, 1120, 1120, 1120, 1120, 1120, 1120, 1120, 1120, 1120, 1120, 1139, 1139, 1139, 1139, 1103, 182, 183, 211, 212, 1053, 276, 277, 278, 279, 280, 396, 397, 398, 399, 400, 401, 402, 403, 308, 309, 310, 311, 312, 313, 314, 315, 214, 404, 276, 277, 278, 279, 280, 281, 282, 283, 1053, 183, 277, 278, 279, 147, 1106, 1120, 1120, 1120, 1120, 1120, 1120, 1120, 1120, 1120, 1120, 1167, 1167, 1167, 1167, 1120, 1120, 1120
1120, 1120, 1120, 1120, 1120, 1120, 1120, 1120, 1120, 1120, 1120, 1120, 1120, 1120, 1120, 1139, 1139, 1139, 1139, 1135, 213, 214, 215, 243, 1053, 308, 309, 310, 311, 312, 313, 314, 315, 315, 172, 173, 174, 175, 176, 177, 178, 179, 344, 345, 346, 347, 214, 436, 308, 309, 310, 311, 312, 313, 314, 315, 1053, 214, 148, 149, 150, 151, 1138, 1120, 1120, 1120, 1120, 1120, 1120, 1120, 1120, 1120, 1120, 1167, 1167, 1167, 1167, 1167, 1167, 1167
1120, 1120, 1120, 1120, 1120, 1120, 1120, 1120, 1120, 1120, 1120, 1120, 1120, 1120, 1120, 1139, 1139, 1139, 1139, 1071, 244, 245, 246, 247, 1053, 340, 341, 342, 343, 344, 345, 346, 347, 347, 204, 205, 206, 207, 208, 209, 210, 211, 376, 377, 378, 379, 214, 372, 340, 341, 342, 343, 344, 345, 346, 347, 1053, 245, 179, 180, 181, 182, 1074, 1120, 1120, 1120, 1120, 1120, 1120, 1120, 1120, 1120, 1120, 1167, 1167, 1167, 1167, 1167, 1167, 1167
1120, 1120, 1120, 1120, 1120, 1120, 1120, 1120, 1120, 1120, 1120, 1120, 1120, 1120, 1120, 1139, 1139, 1139, 1139, 1103, 275, 276, 277, 278, 1053, 372, 373, 374, 375, 376, 377, 378, 379, 379, 236, 237, 238, 239, 240, 241, 242, 243, 408, 409, 410, 411, 182, 404, 372, 373, 374, 375, 376, 377, 378, 379, 1053, 276, 183, 211, 212, 213, 1106, 1120, 1120, 1120, 1120, 1120, 1120, 1120, 1120, 1120, 1120, 1167, 1167, 1167, 1167, 1167, 1167, 1167
1120, 1120, 1120, 1120, 1120, 1120, 1120, 1120, 1120, 1120, 1120, 1120, 1120, 1120, 1120, 1139, 1139, 1139, 1139, 1135, 279, 147, 148, 149, 1053, 404, 405, 406, 407, 212, 213, 214, 215, 216, 268, 269, 270, 271, 272, 273, 274, 275, 440, 441, 442, 443, 182, 436, 404, 405, 406, 407, 408, 409, 410, 411, 1053, 147, 214, 215, 243, 244, 1138, 1120, 1120, 1120, 1120, 1120, 1120, 1120, 1120, 1120, 1120, 1120, 1167, 1167, 1167, 1167, 1167, 1167
1120, 1120, 1120, 1120, 1120, 1120, 1120, 1120, 1120, 1120, 1120, 1120, 1120, 1120, 1120, 1139, 1139, 1139, 1139, 1103, 150, 151, 179, 180, 1053, 436, 437, 438, 172, 173, 174, 175, 176, 177, 178, 179, 302, 303, 304, 305, 306, 307, 0, 0, 0, 0, 0, 0, 436, 437, 438, 439, 440, 441, 442, 443, 1053, 151, 245, 246, 247, 275, 1106, 1120, 1120, 1120, 1120, 1120, 1120, 1120, 1120, 1120, 1120, 1120, 1167, 1167, 1167, 1167, 1167, 1167
1167, 1167, 1167, 1167, 1167, 1167, 1167, 1167, 1167, 1167, 1167, 1167, 1167, 1167, 1167, 1139, 1139, 1139, 1139, 1071, 181, 182, 183, 211, 1053, 0, 0, 0, 204, 205, 206, 207, 208, 209, 210, 211, 334, 335, 336, 337, 338, 339, 0, 0, 0, 0, 0, 0, 212, 213, 214, 215, 216, 217, 218, 219, 1053, 182, 276, 277, 278, 279, 1106, 1167, 1167, 1167, 1167, 1167, 1167, 1167, 1167, 1120, 1167, 1167, 1167, 1167, 1167, 1167, 1167, 1167
1167, 1167, 1167, 1167, 1167, 1167, 1167, 1167, 1167, 1167, 1167, 1167, 1167, 1167, 1167, 1139, 1139, 1139, 1139, 1071, 212, 213, 214, 215, 1053, 0, 0, 0, 236, 237, 238, 239, 240, 241, 242, 243, 366, 367, 368, 369, 370, 371, 0, 0, 0, 0, 0, 0, 244, 245, 246, 247, 248, 249, 250, 251, 1053, 213, 147, 148, 149, 150, 1106, 1167, 1167, 1167, 1167, 1167, 1167, 1167, 1167, 1167, 1167, 1167, 1167, 1167, 1167, 1167, 1167, 1167
1167, 1167, 1167, 1167, 1167, 1167, 1167, 1167, 1167, 1167, 1167, 1167, 1167, 1167, 1167, 1139, 1139, 1139, 1139, 1071, 243, 244, 245, 246, 1053, 0, 0, 0, 268, 269, 270, 271, 272, 273, 274, 275, 398, 399, 400, 401, 402, 403, 217, 218, 219, 0, 0, 0, 276, 277, 278, 279, 280, 281, 282, 283, 1053, 244, 151, 179, 180, 181, 1106, 1167, 1167, 1167, 1167, 1167, 1167, 1167, 1167, 1167, 1167, 1167, 1167, 1167, 1167, 1167, 1167, 1167
1167, 1167, 1167, 1167, 1167, 1167, 1167, 1167, 1167, 1167, 1167, 1167, 1167, 1167, 1167, 1139, 1139, 1139, 1139, 1071, 247, 275, 276, 277, 1053, 0, 0, 0, 300, 301, 302, 303, 304, 305, 306, 307, 379, 244, 245, 246, 247, 248, 249, 250, 251, 0, 0, 0, 308, 309, 310, 311, 312, 313, 314, 315, 1053, 0, 182, 183, 211, 212, 1106, 1167, 1167, 1167, 1167, 1167, 1167, 1167, 1167, 1167, 1167, 1167, 1167, 1167, 1167, 1167, 1167, 1167
1120, 1120, 1120, 1120, 1120, 1120, 1120, 1120, 1120, 1120, 1120, 1120, 1120, 1120, 1120, 1139, 1139, 1139, 1139, 1103, 278, 279, 147, 148, 1053, 0, 0, 0, 332, 333, 334, 335, 336, 337, 338, 339, 411, 276, 277, 278, 279, 280, 281, 282, 283, 0, 0, 0, 340, 341, 342, 343, 344, 345, 346, 347, 1053, 0, 213, 214, 215, 243, 1074, 1121, 1121, 1167, 1167, 1167, 1167, 1121, 1167, 1167, 1167, 1167, 1121, 1167, 1167, 1167, 1167, 1167
1120, 1120, 1120, 1120, 1120, 1120, 1120, 1120, 1120, 1120, 1120, 1120, 1120, 1120, 1120, 1139, 1139, 1139, 1139, 1135, 149, 150, 151, 179, 1053, 0, 0, 0, 364, 365, 366, 367, 368, 369, 370, 371, 443, 216, 217, 218, 219, 312, 313, 314, 315, 0, 0, 0, 372, 373, 374, 375, 376, 377, 378, 379, 1053, 0, 244, 245, 246, 247, 1106, 1120, 1120, 1120, 1120, 1120, 1120, 1120, 1120, 1120, 1120, 1120, 1120, 1167, 1167, 1167, 1167, 1120
1120, 1120, 1120, 1120, 1120, 1120, 1120, 1120, 1120, 1120, 1120, 1120, 1120, 1120, 1120, 1139, 1139, 1139, 1139, 1071, 180, 181, 182, 183, 1053, 172, 173, 174, 175, 176, 177, 178, 179, 401, 402, 403, 251, 248, 249, 250, 251, 344, 345, 346, 347, 0, 0, 0, 404, 405, 406, 407, 408, 409, 410, 411, 1053, 0, 0, 0, 0, 0, 1138, 1120, 1120, 1120, 1120, 1120, 1120, 1120, 1120, 1120, 1120, 1120, 1120, 1120, 1120, 1120, 1120, 1120
1120, 1120, 1120, 1120, 1120, 1120, 1120, 1120, 1120, 1120, 1120, 1120, 1120, 1120, 1120, 1139, 1139, 1139, 1139, 1103, 211, 212, 213, 214, 1053, 204, 205, 206, 207, 208, 209, 210, 211, 280, 281, 282, 283, 280, 281, 282, 283, 376, 377, 378, 379, 214, 215, 216, 217, 218, 219, 439, 440, 441, 442, 443, 1053, 0, 0, 0, 0, 0, 1074, 1120, 1120, 1120, 1120, 1120, 1120, 1120, 1120, 1120, 1120, 1120, 1120, 1120, 1120, 1120, 1120, 1120
1120, 1120, 1120, 1120, 1120, 1120, 1120, 1120, 1120, 1120, 1120, 1120, 1120, 1120, 1120, 1139, 1139, 1139, 1139, 1135, 215, 243, 244, 245, 1053, 236, 237, 238, 239, 240, 241, 242, 243, 312, 313, 314, 315, 312, 313, 314, 315, 408, 409, 410, 411, 246, 247, 248, 249, 250, 251, 0, 0, 0, 0, 0, 1053, 0, 0, 0, 0, 0, 1106, 1120, 1120, 1120, 1120, 1120, 1120, 1120, 1120, 1120, 1120, 1120, 1120, 1120, 1120, 1120, 1120, 1120
1120, 1120, 1120, 1120, 1120, 1120, 1120, 1120, 1120, 1120, 1120, 1120, 1120, 1120, 1120, 1139, 1139, 1139, 1139, 1071, 246, 247, 275, 276, 1053, 268, 269, 270, 271, 272, 273, 274, 275, 344, 345, 346, 347, 344, 345, 346, 347, 440, 441, 442, 443, 278, 279, 280, 281, 282, 283, 0, 0, 0, 0, 0, 1053, 147, 148, 149, 150, 151, 1138, 1120, 1120, 1120, 1120, 1120, 1120, 1120, 1120, 1120, 1120, 1120, 1120, 1120, 1120, 1120, 1120, 1120
1120, 1120, 1120, 1120, 1120, 1120, 1120, 1120, 1120, 1120, 1120, 1120, 1120, 1120, 1120, 1139, 1139, 1139, 1139, 1103, 277, 278, 279, 147, 1053, 300, 301, 302, 303, 304, 305, 306, 307, 376, 377, 378, 379, 376, 377, 378, 379, 0, 0, 308, 309, 310, 311, 312, 313, 314, 315, 0, 0, 0, 0, 0, 1053, 179, 180, 181, 182, 183, 1074, 1120, 1120, 1120, 1120, 1120, 1120, 1120, 1120, 1120, 1120, 1120, 1120, 1120, 1120, 1120, 1120, 1120
1120, 1120, 1120, 1120, 1120, 1120, 1120, 1120, 1120, 1120, 1120, 1120, 1120, 1120, 1120, 1139, 1139, 1139, 1139, 1135, 148, 149, 150, 151, 1053, 332, 333, 334, 335, 336, 337, 338, 339, 408, 409, 410, 411, 408, 409, 410, 411, 335, 336, 340, 341, 342, 343, 344, 345, 346, 347, 335, 336, 337, 338, 339, 1053, 211, 212, 213, 214, 215, 1106, 1120, 1120, 1120, 1120, 1120, 1120, 1120, 1120, 1120, 1120, 1120, 1120, 1120, 1120, 1120, 1120, 1120
1120, 1120, 1120, 1120, 1120, 1120, 1120, 1120, 1120, 1120, 1120, 1120, 1120, 1120, 1120, 1139, 1139, 1139, 1139, 1071, 179, 180, 181, 182, 1053, 364, 365, 366, 367, 368, 369, 370, 371, 440, 441, 442, 443, 440, 441, 442, 443, 338, 339, 372, 373, 374, 375, 376, 377, 378, 379, 0, 0, 0, 0, 0, 1053, 243, 244, 245, 246, 247, 1138, 1120, 1120, 1120, 1120, 1120, 1120, 1120, 1120, 1120, 1120, 1120, 1120, 1120, 1120, 1120, 1120, 1120
1120, 1120, 1120, 1120, 1120, 1120, 1120, 1120, 1120, 1120, 1120, 1120, 1120, 1120, 1120, 1139, 1139, 1139, 1139, 1103, 183, 211, 212, 213, 1053, 396, 397, 398, 399, 400, 401, 402, 403, 0, 0, 0, 0, 0, 0, 0, 0, 0, 0, 404, 405, 406, 407, 408, 409, 410, 411, 0, 0, 0, 0, 0, 1053, 147, 148, 149, 150, 151, 1074, 1120, 1120, 1120, 1120, 1120, 1120, 1120, 1120, 1120, 1120, 1120, 1120, 1120, 1120, 1120, 1120, 1120
1120, 1120, 1120, 1120, 1120, 1120, 1120, 1120, 1120, 1120, 1120, 1120, 1120, 1120, 1120, 1139, 1139, 1139, 1139, 1135, 214, 215, 243, 244, 1053, 0, 0, 0, 0, 0, 0, 0, 0, 0, 0, 0, 0, 0, 0, 0, 0, 0, 0, 436, 437, 438, 439, 440, 441, 442, 443, 0, 0, 0, 0, 0, 470, 179, 180, 181, 182, 183, 1106, 1120, 1120, 1120, 1120, 1120, 1120, 1120, 1120, 1120, 1120, 1120, 1120, 1120, 1120, 1120, 1120, 1120
1120, 1120, 1120, 1120, 1120, 1120, 1120, 1120, 1120, 1120, 1120, 1120, 1120, 1120, 1120, 1139, 1139, 1139, 1139, 1071, 245, 246, 247, 275, 1053, 0, 0, 0, 0, 0, 0, 0, 0, 0, 0, 0, 0, 0, 0, 0, 0, 0, 0, 0, 0, 0, 0, 0, 0, 0, 0, 0, 0, 0, 0, 0, 470, 211, 212, 213, 214, 215, 1138, 1120, 1120, 1120, 1120, 1120, 1120, 1120, 1120, 1120, 1120, 1120, 1120, 1120, 1120, 1120, 1120, 1120
1120, 1120, 1120, 1120, 1120, 1120, 1120, 1120, 1120, 1120, 1120, 1120, 1120, 1120, 1120, 1139, 1139, 1139, 1139, 1103, 276, 277, 278, 279, 1053, 1053, 1053, 1053, 1053, 1053, 1053, 1053, 1053, 1053, 1053, 1053, 1053, 470, 365, 1053, 1053, 1053, 1053, 1053, 1053, 1053, 1053, 1053, 1053, 1053, 1053, 1053, 1053, 1053, 1053, 1053, 1053, 243, 244, 245, 246, 247, 1074, 1120, 1120, 1120, 1120, 1120, 1120, 1120, 1120, 1120, 1120, 1120, 1120, 1120, 1120, 1120, 1120, 1120
1120, 1120, 1120, 1120, 1120, 1120, 1120, 1120, 1120, 1120, 1120, 1120, 1120, 1120, 1120, 1139, 1139, 1139, 1139, 1135, 147, 148, 149, 150, 0, 0, 0, 0, 0, 0, 0, 0, 0, 0, 0, 0, 0, 0, 0, 0, 0, 0, 0, 0, 0, 0, 0, 0, 0, 0, 0, 0, 0, 0, 147, 148, 149, 150, 151, 277, 278, 279, 1106, 1120, 1120, 1120, 1120, 1120, 1120, 1120, 1120, 1120, 1120, 1120, 1120, 1120, 1120, 1120, 1120, 1120
1120, 1120, 1120, 1120, 1120, 1120, 1120, 1120, 1120, 1120, 1120, 1120, 1120, 1120, 1120, 1139, 1139, 1139, 1139, 1071, 151, 179, 180, 181, 0, 0, 0, 0, 147, 148, 149, 150, 151, 0, 0, 0, 147, 148, 149, 150, 151, 0, 147, 148, 149, 150, 151, 0, 147, 148, 149, 150, 151, 0, 179, 180, 181, 182, 183, 0, 0, 0, 1138, 1120, 1120, 1120, 1120, 1120, 1120, 1120, 1120, 1120, 1120, 1120, 1120, 1120, 1120, 1120, 1120, 1120
1120, 1120, 1120, 1120, 1120, 1120, 1120, 1120, 1120, 1120, 1120, 1120, 1120, 1120, 1120, 1139, 1139, 1139, 1139, 1103, 182, 183, 211, 212, 0, 0, 0, 0, 179, 180, 181, 182, 183, 0, 0, 0, 179, 180, 181, 182, 183, 0, 179, 180, 181, 182, 183, 0, 179, 180, 181, 182, 183, 0, 211, 212, 213, 214, 215, 0, 0, 0, 1074, 1120, 1120, 1120, 1120, 1120, 1120, 1120, 1120, 1120, 1120, 1120, 1120, 1120, 1120, 1120, 1120, 1120
1120, 1120, 1120, 1120, 1120, 1120, 1120, 1120, 1120, 1120, 1120, 1120, 1120, 1120, 1120, 1120, 1120, 1120, 1120, 1135, 213, 214, 215, 243, 0, 0, 0, 0, 211, 212, 213, 214, 215, 0, 0, 0, 211, 212, 213, 214, 215, 0, 211, 212, 213, 214, 215, 0, 211, 212, 213, 214, 215, 0, 243, 244, 245, 246, 247, 0, 0, 0, 1106, 1120, 1120, 1120, 1120, 1120, 1120, 1120, 1120, 1120, 1120, 1120, 1120, 1120, 1120, 1120, 1120, 1120
1120, 1120, 1120, 1120, 1120, 1120, 1120, 1120, 1120, 1120, 1120, 1120, 1120, 1120, 1120, 1120, 1120, 1120, 1120, 1071, 244, 245, 246, 247, 0, 0, 0, 0, 243, 244, 245, 246, 247, 0, 0, 0, 243, 244, 245, 246, 247, 0, 243, 244, 245, 246, 247, 0, 243, 244, 245, 246, 247, 0, 275, 276, 277, 278, 279, 0, 0, 0, 1138, 1120, 1120, 1120, 1120, 1120, 1120, 1120, 1120, 1120, 1120, 1120, 1120, 1120, 1120, 1120, 1120, 1120
1120, 1120, 1120, 1120, 1120, 1120, 1120, 1120, 1120, 1120, 1120, 1120, 1120, 1120, 1120, 1120, 1120, 1120, 1120, 1103, 0, 0, 0, 0, 0, 0, 0, 0, 275, 276, 277, 278, 279, 0, 0, 0, 275, 276, 277, 278, 279, 0, 275, 276, 277, 278, 279, 0, 275, 276, 277, 278, 279, 0, 0, 0, 0, 0, 0, 0, 0, 0, 1074, 1120, 1120, 1120, 1120, 1120, 1120, 1120, 1120, 1120, 1120, 1120, 1120, 1120, 1120, 1120, 1120, 1120
1120, 1120, 1120, 1120, 1120, 1120, 1120, 1120, 1120, 1120, 1120, 1120, 1120, 1120, 1120, 1120, 1120, 1120, 1120, 1057, 1063, 1064, 1065, 1066, 1063, 1064, 1065, 1066, 1063, 1064, 1065, 1066, 1063, 1064, 1065, 1066, 1063, 1064, 1065, 1066, 1063, 1064, 1065, 1066, 1063, 1064, 1065, 1066, 1063, 1064, 1065, 1066, 1063, 1064, 1065, 1066, 1063, 1064, 1065, 1066, 1063, 1064, 1068, 1120, 1120, 1120, 1120, 1120, 1120, 1120, 1120, 1120, 1120, 1120, 1120, 1120, 1120, 1120, 1120, 1120
